	pairID	ancestor	descendant	pfam	anc_seq_len	desc_seq_len	alignment_len	num_matches	num_ins	num_del
0	FW_pair0	FakeAnc0	FakeDesc0	SIMULPF00001	452	449	499	402	47	50
1	FW_pair1	FakeAnc1	FakeDesc1	SIMULPF00001	17	21	23	15	6	2
2	FW_pair2	FakeAnc2	FakeDesc2	SIMULPF00001	56	56	63	49	7	7
3	FW_pair3	FakeAnc3	FakeDesc3	SIMULPF00001	878	862	970	770	92	108
4	FW_pair4	FakeAnc4	FakeDesc4	SIMULPF00001	512	502	552	462	40	50
5	FW_pair5	FakeAnc5	FakeDesc5	SIMULPF00001	753	770	825	698	72	55
6	FW_pair6	FakeAnc6	FakeDesc6	SIMULPF00001	104	107	118	93	14	11
7	FW_pair7	FakeAnc7	FakeDesc7	SIMULPF00001	26	25	27	24	1	2
8	FW_pair8	FakeAnc8	FakeDesc8	SIMULPF00001	502	514	549	467	47	35
9	FW_pair9	FakeAnc9	FakeDesc9	SIMULPF00001	174	172	187	159	13	15
10	FW_pair10	FakeAnc10	FakeDesc10	SIMULPF00001	668	666	737	597	69	71
11	FW_pair11	FakeAnc11	FakeDesc11	SIMULPF00001	499	479	540	438	41	61
12	FW_pair12	FakeAnc12	FakeDesc12	SIMULPF00001	76	77	83	70	7	6
13	FW_pair13	FakeAnc13	FakeDesc13	SIMULPF00001	110	108	117	101	7	9
14	FW_pair14	FakeAnc14	FakeDesc14	SIMULPF00001	232	224	249	207	17	25
15	FW_pair15	FakeAnc15	FakeDesc15	SIMULPF00001	25	24	25	24	0	1
16	FW_pair16	FakeAnc16	FakeDesc16	SIMULPF00001	284	289	315	258	31	26
17	FW_pair17	FakeAnc17	FakeDesc17	SIMULPF00001	55	61	65	51	10	4
18	FW_pair18	FakeAnc18	FakeDesc18	SIMULPF00001	135	144	155	124	20	11
19	FW_pair19	FakeAnc19	FakeDesc19	SIMULPF00001	159	155	171	143	12	16
20	FW_pair20	FakeAnc20	FakeDesc20	SIMULPF00001	116	113	123	106	7	10
21	FW_pair21	FakeAnc21	FakeDesc21	SIMULPF00001	282	282	318	246	36	36
22	FW_pair22	FakeAnc22	FakeDesc22	SIMULPF00001	323	322	351	294	28	29
23	FW_pair23	FakeAnc23	FakeDesc23	SIMULPF00001	33	36	39	30	6	3
24	FW_pair24	FakeAnc24	FakeDesc24	SIMULPF00001	75	65	79	61	4	14
25	FW_pair25	FakeAnc25	FakeDesc25	SIMULPF00001	104	102	109	97	5	7
26	FW_pair26	FakeAnc26	FakeDesc26	SIMULPF00001	164	156	173	147	9	17
27	FW_pair27	FakeAnc27	FakeDesc27	SIMULPF00001	102	100	112	90	10	12
28	FW_pair28	FakeAnc28	FakeDesc28	SIMULPF00001	650	643	701	592	51	58
29	FW_pair29	FakeAnc29	FakeDesc29	SIMULPF00001	637	621	697	561	60	76
30	FW_pair30	FakeAnc30	FakeDesc30	SIMULPF00001	95	98	104	89	9	6
31	FW_pair31	FakeAnc31	FakeDesc31	SIMULPF00001	258	253	280	231	22	27
32	FW_pair32	FakeAnc32	FakeDesc32	SIMULPF00001	55	54	58	51	3	4
33	FW_pair33	FakeAnc33	FakeDesc33	SIMULPF00001	245	249	266	228	21	17
34	FW_pair34	FakeAnc34	FakeDesc34	SIMULPF00001	62	64	70	56	8	6
35	FW_pair35	FakeAnc35	FakeDesc35	SIMULPF00001	284	274	313	245	29	39
36	FW_pair36	FakeAnc36	FakeDesc36	SIMULPF00001	186	186	203	169	17	17
37	FW_pair37	FakeAnc37	FakeDesc37	SIMULPF00001	27	34	35	26	8	1
38	FW_pair38	FakeAnc38	FakeDesc38	SIMULPF00001	185	185	197	173	12	12
39	FW_pair39	FakeAnc39	FakeDesc39	SIMULPF00001	370	372	410	332	40	38
40	FW_pair40	FakeAnc40	FakeDesc40	SIMULPF00001	5	6	6	5	1	0
41	FW_pair41	FakeAnc41	FakeDesc41	SIMULPF00001	500	499	545	454	45	46
42	FW_pair42	FakeAnc42	FakeDesc42	SIMULPF00001	26	25	30	21	4	5
43	FW_pair43	FakeAnc43	FakeDesc43	SIMULPF00001	853	821	908	766	55	87
44	FW_pair44	FakeAnc44	FakeDesc44	SIMULPF00001	144	132	155	121	11	23
45	FW_pair45	FakeAnc45	FakeDesc45	SIMULPF00001	280	273	306	247	26	33
46	FW_pair46	FakeAnc46	FakeDesc46	SIMULPF00001	131	131	151	111	20	20
47	FW_pair47	FakeAnc47	FakeDesc47	SIMULPF00001	59	54	63	50	4	9
48	FW_pair48	FakeAnc48	FakeDesc48	SIMULPF00001	447	443	480	410	33	37
49	FW_pair49	FakeAnc49	FakeDesc49	SIMULPF00001	79	68	79	68	0	11
50	FW_pair50	FakeAnc50	FakeDesc50	SIMULPF00001	279	285	309	255	30	24
51	FW_pair51	FakeAnc51	FakeDesc51	SIMULPF00001	280	272	291	261	11	19
52	FW_pair52	FakeAnc52	FakeDesc52	SIMULPF00001	11	12	12	11	1	0
53	FW_pair53	FakeAnc53	FakeDesc53	SIMULPF00001	27	28	29	26	2	1
54	FW_pair54	FakeAnc54	FakeDesc54	SIMULPF00001	198	204	221	181	23	17
55	FW_pair55	FakeAnc55	FakeDesc55	SIMULPF00001	66	73	75	64	9	2
56	FW_pair56	FakeAnc56	FakeDesc56	SIMULPF00001	14	14	14	14	0	0
57	FW_pair57	FakeAnc57	FakeDesc57	SIMULPF00001	114	120	128	106	14	8
58	FW_pair58	FakeAnc58	FakeDesc58	SIMULPF00001	104	97	108	93	4	11
59	FW_pair59	FakeAnc59	FakeDesc59	SIMULPF00001	308	317	346	279	38	29
60	FW_pair60	FakeAnc60	FakeDesc60	SIMULPF00001	232	250	262	220	30	12
61	FW_pair61	FakeAnc61	FakeDesc61	SIMULPF00001	182	188	206	164	24	18
62	FW_pair62	FakeAnc62	FakeDesc62	SIMULPF00001	106	96	109	93	3	13
63	FW_pair63	FakeAnc63	FakeDesc63	SIMULPF00001	36	33	37	32	1	4
64	FW_pair64	FakeAnc64	FakeDesc64	SIMULPF00001	49	48	54	43	5	6
65	FW_pair65	FakeAnc65	FakeDesc65	SIMULPF00001	812	810	891	731	79	81
66	FW_pair66	FakeAnc66	FakeDesc66	SIMULPF00001	102	110	120	92	18	10
67	FW_pair67	FakeAnc67	FakeDesc67	SIMULPF00001	65	68	72	61	7	4
68	FW_pair68	FakeAnc68	FakeDesc68	SIMULPF00001	9	12	12	9	3	0
69	FW_pair69	FakeAnc69	FakeDesc69	SIMULPF00001	286	289	315	260	29	26
70	FW_pair70	FakeAnc70	FakeDesc70	SIMULPF00001	238	244	262	220	24	18
71	FW_pair71	FakeAnc71	FakeDesc71	SIMULPF00001	428	423	469	382	41	46
72	FW_pair72	FakeAnc72	FakeDesc72	SIMULPF00001	77	82	85	74	8	3
73	FW_pair73	FakeAnc73	FakeDesc73	SIMULPF00001	570	597	631	536	61	34
74	FW_pair74	FakeAnc74	FakeDesc74	SIMULPF00001	137	141	151	127	14	10
75	FW_pair75	FakeAnc75	FakeDesc75	SIMULPF00001	70	71	78	63	8	7
76	FW_pair76	FakeAnc76	FakeDesc76	SIMULPF00001	160	162	178	144	18	16
77	FW_pair77	FakeAnc77	FakeDesc77	SIMULPF00001	100	101	109	92	9	8
78	FW_pair78	FakeAnc78	FakeDesc78	SIMULPF00001	653	649	698	604	45	49
79	FW_pair79	FakeAnc79	FakeDesc79	SIMULPF00001	83	85	89	79	6	4
80	FW_pair80	FakeAnc80	FakeDesc80	SIMULPF00001	381	380	414	347	33	34
81	FW_pair81	FakeAnc81	FakeDesc81	SIMULPF00001	139	134	150	123	11	16
82	FW_pair82	FakeAnc82	FakeDesc82	SIMULPF00001	519	549	578	490	59	29
83	FW_pair83	FakeAnc83	FakeDesc83	SIMULPF00001	275	264	296	243	21	32
84	FW_pair84	FakeAnc84	FakeDesc84	SIMULPF00001	231	232	254	209	23	22
85	FW_pair85	FakeAnc85	FakeDesc85	SIMULPF00001	504	511	559	456	55	48
86	FW_pair86	FakeAnc86	FakeDesc86	SIMULPF00001	293	297	323	267	30	26
87	FW_pair87	FakeAnc87	FakeDesc87	SIMULPF00001	367	381	404	344	37	23
88	FW_pair88	FakeAnc88	FakeDesc88	SIMULPF00001	149	163	172	140	23	9
89	FW_pair89	FakeAnc89	FakeDesc89	SIMULPF00001	150	160	172	138	22	12
90	FW_pair90	FakeAnc90	FakeDesc90	SIMULPF00001	348	349	383	314	35	34
91	FW_pair91	FakeAnc91	FakeDesc91	SIMULPF00001	276	268	291	253	15	23
92	FW_pair92	FakeAnc92	FakeDesc92	SIMULPF00001	269	264	298	235	29	34
93	FW_pair93	FakeAnc93	FakeDesc93	SIMULPF00001	125	127	138	114	13	11
94	FW_pair94	FakeAnc94	FakeDesc94	SIMULPF00001	12	12	12	12	0	0
95	FW_pair95	FakeAnc95	FakeDesc95	SIMULPF00001	68	68	72	64	4	4
96	FW_pair96	FakeAnc96	FakeDesc96	SIMULPF00001	330	342	372	300	42	30
97	FW_pair97	FakeAnc97	FakeDesc97	SIMULPF00001	124	126	137	113	13	11
98	FW_pair98	FakeAnc98	FakeDesc98	SIMULPF00001	370	375	413	332	43	38
99	FW_pair99	FakeAnc99	FakeDesc99	SIMULPF00001	412	415	446	381	34	31
100	FW_pair100	FakeAnc100	FakeDesc100	SIMULPF00001	299	303	330	272	31	27
101	FW_pair101	FakeAnc101	FakeDesc101	SIMULPF00001	152	159	172	139	20	13
102	FW_pair102	FakeAnc102	FakeDesc102	SIMULPF00001	27	28	30	25	3	2
103	FW_pair103	FakeAnc103	FakeDesc103	SIMULPF00001	254	255	274	235	20	19
104	FW_pair104	FakeAnc104	FakeDesc104	SIMULPF00001	378	366	407	337	29	41
105	FW_pair105	FakeAnc105	FakeDesc105	SIMULPF00001	52	55	60	47	8	5
106	FW_pair106	FakeAnc106	FakeDesc106	SIMULPF00001	108	105	116	97	8	11
107	FW_pair107	FakeAnc107	FakeDesc107	SIMULPF00001	104	101	111	94	7	10
108	FW_pair108	FakeAnc108	FakeDesc108	SIMULPF00001	151	145	166	130	15	21
109	FW_pair109	FakeAnc109	FakeDesc109	SIMULPF00001	214	205	230	189	16	25
110	FW_pair110	FakeAnc110	FakeDesc110	SIMULPF00001	563	555	605	513	42	50
111	FW_pair111	FakeAnc111	FakeDesc111	SIMULPF00001	375	356	399	332	24	43
112	FW_pair112	FakeAnc112	FakeDesc112	SIMULPF00001	235	246	258	223	23	12
113	FW_pair113	FakeAnc113	FakeDesc113	SIMULPF00001	157	164	182	139	25	18
114	FW_pair114	FakeAnc114	FakeDesc114	SIMULPF00001	106	95	111	90	5	16
115	FW_pair115	FakeAnc115	FakeDesc115	SIMULPF00001	227	224	252	199	25	28
116	FW_pair116	FakeAnc116	FakeDesc116	SIMULPF00001	235	224	252	207	17	28
117	FW_pair117	FakeAnc117	FakeDesc117	SIMULPF00001	140	159	169	130	29	10
118	FW_pair118	FakeAnc118	FakeDesc118	SIMULPF00001	922	910	991	841	69	81
119	FW_pair119	FakeAnc119	FakeDesc119	SIMULPF00001	123	128	134	117	11	6
120	FW_pair120	FakeAnc120	FakeDesc120	SIMULPF00001	401	401	439	363	38	38
121	FW_pair121	FakeAnc121	FakeDesc121	SIMULPF00001	256	246	274	228	18	28
122	FW_pair122	FakeAnc122	FakeDesc122	SIMULPF00001	120	117	128	109	8	11
123	FW_pair123	FakeAnc123	FakeDesc123	SIMULPF00001	399	381	428	352	29	47
124	FW_pair124	FakeAnc124	FakeDesc124	SIMULPF00001	62	65	68	59	6	3
125	FW_pair125	FakeAnc125	FakeDesc125	SIMULPF00001	773	759	842	690	69	83
126	FW_pair126	FakeAnc126	FakeDesc126	SIMULPF00001	361	367	396	332	35	29
127	FW_pair127	FakeAnc127	FakeDesc127	SIMULPF00001	82	78	90	70	8	12
128	FW_pair128	FakeAnc128	FakeDesc128	SIMULPF00001	221	217	242	196	21	25
129	FW_pair129	FakeAnc129	FakeDesc129	SIMULPF00001	379	379	412	346	33	33
130	FW_pair130	FakeAnc130	FakeDesc130	SIMULPF00001	352	357	385	324	33	28
131	FW_pair131	FakeAnc131	FakeDesc131	SIMULPF00001	88	96	104	80	16	8
132	FW_pair132	FakeAnc132	FakeDesc132	SIMULPF00001	323	320	349	294	26	29
133	FW_pair133	FakeAnc133	FakeDesc133	SIMULPF00001	168	173	189	152	21	16
134	FW_pair134	FakeAnc134	FakeDesc134	SIMULPF00001	68	72	74	66	6	2
135	FW_pair135	FakeAnc135	FakeDesc135	SIMULPF00001	85	85	97	73	12	12
136	FW_pair136	FakeAnc136	FakeDesc136	SIMULPF00001	271	267	291	247	20	24
137	FW_pair137	FakeAnc137	FakeDesc137	SIMULPF00001	135	143	148	130	13	5
138	FW_pair138	FakeAnc138	FakeDesc138	SIMULPF00001	56	49	59	46	3	10
139	FW_pair139	FakeAnc139	FakeDesc139	SIMULPF00001	482	480	532	430	50	52
140	FW_pair140	FakeAnc140	FakeDesc140	SIMULPF00001	240	243	260	223	20	17
141	FW_pair141	FakeAnc141	FakeDesc141	SIMULPF00001	453	447	490	410	37	43
142	FW_pair142	FakeAnc142	FakeDesc142	SIMULPF00001	1	1	1	1	0	0
143	FW_pair143	FakeAnc143	FakeDesc143	SIMULPF00001	220	217	239	198	19	22
144	FW_pair144	FakeAnc144	FakeDesc144	SIMULPF00001	207	208	225	190	18	17
145	FW_pair145	FakeAnc145	FakeDesc145	SIMULPF00001	265	266	289	242	24	23
146	FW_pair146	FakeAnc146	FakeDesc146	SIMULPF00001	186	194	208	172	22	14
147	FW_pair147	FakeAnc147	FakeDesc147	SIMULPF00001	287	288	320	255	33	32
148	FW_pair148	FakeAnc148	FakeDesc148	SIMULPF00001	359	363	394	328	35	31
149	FW_pair149	FakeAnc149	FakeDesc149	SIMULPF00001	73	70	79	64	6	9
150	FW_pair150	FakeAnc150	FakeDesc150	SIMULPF00001	281	272	299	254	18	27
151	FW_pair151	FakeAnc151	FakeDesc151	SIMULPF00001	10	11	12	9	2	1
152	FW_pair152	FakeAnc152	FakeDesc152	SIMULPF00001	42	45	48	39	6	3
153	FW_pair153	FakeAnc153	FakeDesc153	SIMULPF00001	146	144	157	133	11	13
154	FW_pair154	FakeAnc154	FakeDesc154	SIMULPF00001	135	133	150	118	15	17
155	FW_pair155	FakeAnc155	FakeDesc155	SIMULPF00001	215	225	242	198	27	17
156	FW_pair156	FakeAnc156	FakeDesc156	SIMULPF00001	105	108	117	96	12	9
157	FW_pair157	FakeAnc157	FakeDesc157	SIMULPF00001	14	16	16	14	2	0
158	FW_pair158	FakeAnc158	FakeDesc158	SIMULPF00001	223	232	246	209	23	14
159	FW_pair159	FakeAnc159	FakeDesc159	SIMULPF00001	115	116	128	103	13	12
160	FW_pair160	FakeAnc160	FakeDesc160	SIMULPF00001	159	139	167	131	8	28
161	FW_pair161	FakeAnc161	FakeDesc161	SIMULPF00001	210	212	228	194	18	16
162	FW_pair162	FakeAnc162	FakeDesc162	SIMULPF00001	171	168	183	156	12	15
163	FW_pair163	FakeAnc163	FakeDesc163	SIMULPF00001	7	6	7	6	0	1
164	FW_pair164	FakeAnc164	FakeDesc164	SIMULPF00001	5	6	6	5	1	0
165	FW_pair165	FakeAnc165	FakeDesc165	SIMULPF00001	462	472	497	437	35	25
166	FW_pair166	FakeAnc166	FakeDesc166	SIMULPF00001	276	277	310	243	34	33
167	FW_pair167	FakeAnc167	FakeDesc167	SIMULPF00001	450	449	484	415	34	35
168	FW_pair168	FakeAnc168	FakeDesc168	SIMULPF00001	129	124	138	115	9	14
169	FW_pair169	FakeAnc169	FakeDesc169	SIMULPF00001	313	322	348	287	35	26
170	FW_pair170	FakeAnc170	FakeDesc170	SIMULPF00001	76	75	82	69	6	7
171	FW_pair171	FakeAnc171	FakeDesc171	SIMULPF00001	48	46	49	45	1	3
172	FW_pair172	FakeAnc172	FakeDesc172	SIMULPF00001	7	6	8	5	1	2
173	FW_pair173	FakeAnc173	FakeDesc173	SIMULPF00001	751	723	800	674	49	77
174	FW_pair174	FakeAnc174	FakeDesc174	SIMULPF00001	214	223	234	203	20	11
175	FW_pair175	FakeAnc175	FakeDesc175	SIMULPF00001	80	74	82	72	2	8
176	FW_pair176	FakeAnc176	FakeDesc176	SIMULPF00001	440	445	481	404	41	36
177	FW_pair177	FakeAnc177	FakeDesc177	SIMULPF00001	172	177	189	160	17	12
178	FW_pair178	FakeAnc178	FakeDesc178	SIMULPF00001	66	60	70	56	4	10
179	FW_pair179	FakeAnc179	FakeDesc179	SIMULPF00001	584	577	625	536	41	48
180	FW_pair180	FakeAnc180	FakeDesc180	SIMULPF00001	503	520	573	450	70	53
181	FW_pair181	FakeAnc181	FakeDesc181	SIMULPF00001	412	399	443	368	31	44
182	FW_pair182	FakeAnc182	FakeDesc182	SIMULPF00001	83	85	90	78	7	5
183	FW_pair183	FakeAnc183	FakeDesc183	SIMULPF00001	131	142	149	124	18	7
184	FW_pair184	FakeAnc184	FakeDesc184	SIMULPF00001	154	144	166	132	12	22
185	FW_pair185	FakeAnc185	FakeDesc185	SIMULPF00001	132	150	159	123	27	9
186	FW_pair186	FakeAnc186	FakeDesc186	SIMULPF00001	852	826	933	745	81	107
187	FW_pair187	FakeAnc187	FakeDesc187	SIMULPF00001	140	133	146	127	6	13
188	FW_pair188	FakeAnc188	FakeDesc188	SIMULPF00001	278	266	296	248	18	30
189	FW_pair189	FakeAnc189	FakeDesc189	SIMULPF00001	10	10	10	10	0	0
190	FW_pair190	FakeAnc190	FakeDesc190	SIMULPF00001	171	175	186	160	15	11
191	FW_pair191	FakeAnc191	FakeDesc191	SIMULPF00001	366	375	396	345	30	21
192	FW_pair192	FakeAnc192	FakeDesc192	SIMULPF00001	1	2	2	1	1	0
193	FW_pair193	FakeAnc193	FakeDesc193	SIMULPF00001	41	40	43	38	2	3
194	FW_pair194	FakeAnc194	FakeDesc194	SIMULPF00001	184	186	211	159	27	25
195	FW_pair195	FakeAnc195	FakeDesc195	SIMULPF00001	285	295	312	268	27	17
196	FW_pair196	FakeAnc196	FakeDesc196	SIMULPF00001	129	135	146	118	17	11
197	FW_pair197	FakeAnc197	FakeDesc197	SIMULPF00001	242	240	263	219	21	23
198	FW_pair198	FakeAnc198	FakeDesc198	SIMULPF00001	141	157	164	134	23	7
199	FW_pair199	FakeAnc199	FakeDesc199	SIMULPF00001	513	501	546	468	33	45
200	FW_pair200	FakeAnc200	FakeDesc200	SIMULPF00001	181	192	206	167	25	14
201	FW_pair201	FakeAnc201	FakeDesc201	SIMULPF00001	16	16	17	15	1	1
202	FW_pair202	FakeAnc202	FakeDesc202	SIMULPF00001	76	73	84	65	8	11
203	FW_pair203	FakeAnc203	FakeDesc203	SIMULPF00001	53	45	57	41	4	12
204	FW_pair204	FakeAnc204	FakeDesc204	SIMULPF00001	97	97	106	88	9	9
205	FW_pair205	FakeAnc205	FakeDesc205	SIMULPF00001	134	138	147	125	13	9
206	FW_pair206	FakeAnc206	FakeDesc206	SIMULPF00001	16	15	16	15	0	1
207	FW_pair207	FakeAnc207	FakeDesc207	SIMULPF00001	324	334	360	298	36	26
208	FW_pair208	FakeAnc208	FakeDesc208	SIMULPF00001	283	286	303	266	20	17
209	FW_pair209	FakeAnc209	FakeDesc209	SIMULPF00001	35	34	37	32	2	3
210	FW_pair210	FakeAnc210	FakeDesc210	SIMULPF00001	5	7	7	5	2	0
211	FW_pair211	FakeAnc211	FakeDesc211	SIMULPF00001	140	140	150	130	10	10
212	FW_pair212	FakeAnc212	FakeDesc212	SIMULPF00001	58	50	59	49	1	9
213	FW_pair213	FakeAnc213	FakeDesc213	SIMULPF00001	161	174	183	152	22	9
214	FW_pair214	FakeAnc214	FakeDesc214	SIMULPF00001	72	66	76	62	4	10
215	FW_pair215	FakeAnc215	FakeDesc215	SIMULPF00001	60	66	71	55	11	5
216	FW_pair216	FakeAnc216	FakeDesc216	SIMULPF00001	315	298	337	276	22	39
217	FW_pair217	FakeAnc217	FakeDesc217	SIMULPF00001	150	147	166	131	16	19
218	FW_pair218	FakeAnc218	FakeDesc218	SIMULPF00001	79	85	92	72	13	7
219	FW_pair219	FakeAnc219	FakeDesc219	SIMULPF00001	215	214	234	195	19	20
220	FW_pair220	FakeAnc220	FakeDesc220	SIMULPF00001	8	8	9	7	1	1
221	FW_pair221	FakeAnc221	FakeDesc221	SIMULPF00001	840	863	928	775	88	65
222	FW_pair222	FakeAnc222	FakeDesc222	SIMULPF00001	105	107	118	94	13	11
223	FW_pair223	FakeAnc223	FakeDesc223	SIMULPF00001	402	403	451	354	49	48
224	FW_pair224	FakeAnc224	FakeDesc224	SIMULPF00001	354	350	385	319	31	35
225	FW_pair225	FakeAnc225	FakeDesc225	SIMULPF00001	75	75	78	72	3	3
226	FW_pair226	FakeAnc226	FakeDesc226	SIMULPF00001	164	156	173	147	9	17
227	FW_pair227	FakeAnc227	FakeDesc227	SIMULPF00001	239	238	258	219	19	20
228	FW_pair228	FakeAnc228	FakeDesc228	SIMULPF00001	62	62	69	55	7	7
229	FW_pair229	FakeAnc229	FakeDesc229	SIMULPF00001	110	116	125	101	15	9
230	FW_pair230	FakeAnc230	FakeDesc230	SIMULPF00001	281	269	299	251	18	30
231	FW_pair231	FakeAnc231	FakeDesc231	SIMULPF00001	102	109	115	96	13	6
232	FW_pair232	FakeAnc232	FakeDesc232	SIMULPF00001	532	545	591	486	59	46
233	FW_pair233	FakeAnc233	FakeDesc233	SIMULPF00001	108	107	125	90	17	18
234	FW_pair234	FakeAnc234	FakeDesc234	SIMULPF00001	285	294	327	252	42	33
235	FW_pair235	FakeAnc235	FakeDesc235	SIMULPF00001	359	332	383	308	24	51
236	FW_pair236	FakeAnc236	FakeDesc236	SIMULPF00001	149	140	158	131	9	18
237	FW_pair237	FakeAnc237	FakeDesc237	SIMULPF00001	632	620	677	575	45	57
238	FW_pair238	FakeAnc238	FakeDesc238	SIMULPF00001	86	101	108	79	22	7
239	FW_pair239	FakeAnc239	FakeDesc239	SIMULPF00001	774	762	838	698	64	76
240	FW_pair240	FakeAnc240	FakeDesc240	SIMULPF00001	132	127	140	119	8	13
241	FW_pair241	FakeAnc241	FakeDesc241	SIMULPF00001	113	101	120	94	7	19
242	FW_pair242	FakeAnc242	FakeDesc242	SIMULPF00001	309	315	345	279	36	30
243	FW_pair243	FakeAnc243	FakeDesc243	SIMULPF00001	29	31	34	26	5	3
244	FW_pair244	FakeAnc244	FakeDesc244	SIMULPF00001	88	88	101	75	13	13
245	FW_pair245	FakeAnc245	FakeDesc245	SIMULPF00001	138	144	152	130	14	8
246	FW_pair246	FakeAnc246	FakeDesc246	SIMULPF00001	38	43	45	36	7	2
247	FW_pair247	FakeAnc247	FakeDesc247	SIMULPF00001	205	194	228	171	23	34
248	FW_pair248	FakeAnc248	FakeDesc248	SIMULPF00001	39	42	45	36	6	3
249	FW_pair249	FakeAnc249	FakeDesc249	SIMULPF00001	339	342	373	308	34	31
250	FW_pair250	FakeAnc250	FakeDesc250	SIMULPF00001	468	472	509	431	41	37
251	FW_pair251	FakeAnc251	FakeDesc251	SIMULPF00001	129	127	139	117	10	12
252	FW_pair252	FakeAnc252	FakeDesc252	SIMULPF00001	389	377	417	349	28	40
253	FW_pair253	FakeAnc253	FakeDesc253	SIMULPF00001	268	260	290	238	22	30
254	FW_pair254	FakeAnc254	FakeDesc254	SIMULPF00001	89	89	99	79	10	10
255	FW_pair255	FakeAnc255	FakeDesc255	SIMULPF00001	173	181	190	164	17	9
256	FW_pair256	FakeAnc256	FakeDesc256	SIMULPF00001	696	705	763	638	67	58
257	FW_pair257	FakeAnc257	FakeDesc257	SIMULPF00001	33	34	35	32	2	1
258	FW_pair258	FakeAnc258	FakeDesc258	SIMULPF00001	56	54	56	54	0	2
259	FW_pair259	FakeAnc259	FakeDesc259	SIMULPF00001	281	271	312	240	31	41
260	FW_pair260	FakeAnc260	FakeDesc260	SIMULPF00001	76	78	84	70	8	6
261	FW_pair261	FakeAnc261	FakeDesc261	SIMULPF00001	181	179	199	161	18	20
262	FW_pair262	FakeAnc262	FakeDesc262	SIMULPF00001	60	60	67	53	7	7
263	FW_pair263	FakeAnc263	FakeDesc263	SIMULPF00001	107	107	116	98	9	9
264	FW_pair264	FakeAnc264	FakeDesc264	SIMULPF00001	109	113	119	103	10	6
265	FW_pair265	FakeAnc265	FakeDesc265	SIMULPF00001	11	12	12	11	1	0
266	FW_pair266	FakeAnc266	FakeDesc266	SIMULPF00001	43	41	46	38	3	5
267	FW_pair267	FakeAnc267	FakeDesc267	SIMULPF00001	176	180	195	161	19	15
268	FW_pair268	FakeAnc268	FakeDesc268	SIMULPF00001	329	340	362	307	33	22
269	FW_pair269	FakeAnc269	FakeDesc269	SIMULPF00001	142	136	156	122	14	20
270	FW_pair270	FakeAnc270	FakeDesc270	SIMULPF00001	248	248	275	221	27	27
271	FW_pair271	FakeAnc271	FakeDesc271	SIMULPF00001	120	118	129	109	9	11
272	FW_pair272	FakeAnc272	FakeDesc272	SIMULPF00001	212	213	228	197	16	15
273	FW_pair273	FakeAnc273	FakeDesc273	SIMULPF00001	368	359	390	337	22	31
274	FW_pair274	FakeAnc274	FakeDesc274	SIMULPF00001	226	214	244	196	18	30
275	FW_pair275	FakeAnc275	FakeDesc275	SIMULPF00001	17	21	23	15	6	2
276	FW_pair276	FakeAnc276	FakeDesc276	SIMULPF00001	297	295	321	271	24	26
277	FW_pair277	FakeAnc277	FakeDesc277	SIMULPF00001	247	245	274	218	27	29
278	FW_pair278	FakeAnc278	FakeDesc278	SIMULPF00001	357	373	392	338	35	19
279	FW_pair279	FakeAnc279	FakeDesc279	SIMULPF00001	8	6	8	6	0	2
280	FW_pair280	FakeAnc280	FakeDesc280	SIMULPF00001	66	68	74	60	8	6
281	FW_pair281	FakeAnc281	FakeDesc281	SIMULPF00001	172	156	179	149	7	23
282	FW_pair282	FakeAnc282	FakeDesc282	SIMULPF00001	187	185	203	169	16	18
283	FW_pair283	FakeAnc283	FakeDesc283	SIMULPF00001	518	516	561	473	43	45
284	FW_pair284	FakeAnc284	FakeDesc284	SIMULPF00001	190	192	215	167	25	23
285	FW_pair285	FakeAnc285	FakeDesc285	SIMULPF00001	114	118	126	106	12	8
286	FW_pair286	FakeAnc286	FakeDesc286	SIMULPF00001	36	33	38	31	2	5
287	FW_pair287	FakeAnc287	FakeDesc287	SIMULPF00001	49	51	56	44	7	5
288	FW_pair288	FakeAnc288	FakeDesc288	SIMULPF00001	859	857	924	792	65	67
289	FW_pair289	FakeAnc289	FakeDesc289	SIMULPF00001	208	207	228	187	20	21
290	FW_pair290	FakeAnc290	FakeDesc290	SIMULPF00001	525	516	560	481	35	44
291	FW_pair291	FakeAnc291	FakeDesc291	SIMULPF00001	52	59	60	51	8	1
292	FW_pair292	FakeAnc292	FakeDesc292	SIMULPF00001	77	87	88	76	11	1
293	FW_pair293	FakeAnc293	FakeDesc293	SIMULPF00001	120	116	127	109	7	11
294	FW_pair294	FakeAnc294	FakeDesc294	SIMULPF00001	37	33	38	32	1	5
295	FW_pair295	FakeAnc295	FakeDesc295	SIMULPF00001	20	22	24	18	4	2
296	FW_pair296	FakeAnc296	FakeDesc296	SIMULPF00001	160	159	172	147	12	13
297	FW_pair297	FakeAnc297	FakeDesc297	SIMULPF00001	93	97	101	89	8	4
298	FW_pair298	FakeAnc298	FakeDesc298	SIMULPF00001	212	215	236	191	24	21
299	FW_pair299	FakeAnc299	FakeDesc299	SIMULPF00001	56	47	59	44	3	12
300	FW_pair300	FakeAnc300	FakeDesc300	SIMULPF00001	155	146	167	134	12	21
301	FW_pair301	FakeAnc301	FakeDesc301	SIMULPF00001	86	86	91	81	5	5
302	FW_pair302	FakeAnc302	FakeDesc302	SIMULPF00001	248	254	275	227	27	21
303	FW_pair303	FakeAnc303	FakeDesc303	SIMULPF00001	80	86	92	74	12	6
304	FW_pair304	FakeAnc304	FakeDesc304	SIMULPF00001	236	246	265	217	29	19
305	FW_pair305	FakeAnc305	FakeDesc305	SIMULPF00001	405	392	440	357	35	48
306	FW_pair306	FakeAnc306	FakeDesc306	SIMULPF00001	161	172	185	148	24	13
307	FW_pair307	FakeAnc307	FakeDesc307	SIMULPF00001	111	114	121	104	10	7
308	FW_pair308	FakeAnc308	FakeDesc308	SIMULPF00001	13	15	15	13	2	0
309	FW_pair309	FakeAnc309	FakeDesc309	SIMULPF00001	95	91	100	86	5	9
310	FW_pair310	FakeAnc310	FakeDesc310	SIMULPF00001	26	29	31	24	5	2
311	FW_pair311	FakeAnc311	FakeDesc311	SIMULPF00001	642	646	708	580	66	62
312	FW_pair312	FakeAnc312	FakeDesc312	SIMULPF00001	15	15	17	13	2	2
313	FW_pair313	FakeAnc313	FakeDesc313	SIMULPF00001	494	491	545	440	51	54
314	FW_pair314	FakeAnc314	FakeDesc314	SIMULPF00001	236	233	255	214	19	22
315	FW_pair315	FakeAnc315	FakeDesc315	SIMULPF00001	377	391	423	345	46	32
316	FW_pair316	FakeAnc316	FakeDesc316	SIMULPF00001	219	233	245	207	26	12
317	FW_pair317	FakeAnc317	FakeDesc317	SIMULPF00001	257	276	297	236	40	21
318	FW_pair318	FakeAnc318	FakeDesc318	SIMULPF00001	29	26	30	25	1	4
319	FW_pair319	FakeAnc319	FakeDesc319	SIMULPF00001	24	24	25	23	1	1
320	FW_pair320	FakeAnc320	FakeDesc320	SIMULPF00001	7	7	7	7	0	0
321	FW_pair321	FakeAnc321	FakeDesc321	SIMULPF00001	84	88	96	76	12	8
322	FW_pair322	FakeAnc322	FakeDesc322	SIMULPF00001	56	59	64	51	8	5
323	FW_pair323	FakeAnc323	FakeDesc323	SIMULPF00001	203	193	223	173	20	30
324	FW_pair324	FakeAnc324	FakeDesc324	SIMULPF00001	874	867	956	785	82	89
325	FW_pair325	FakeAnc325	FakeDesc325	SIMULPF00001	284	294	316	262	32	22
326	FW_pair326	FakeAnc326	FakeDesc326	SIMULPF00001	66	71	76	61	10	5
327	FW_pair327	FakeAnc327	FakeDesc327	SIMULPF00001	24	20	24	20	0	4
328	FW_pair328	FakeAnc328	FakeDesc328	SIMULPF00001	118	118	123	113	5	5
329	FW_pair329	FakeAnc329	FakeDesc329	SIMULPF00001	245	248	270	223	25	22
330	FW_pair330	FakeAnc330	FakeDesc330	SIMULPF00001	90	93	99	84	9	6
331	FW_pair331	FakeAnc331	FakeDesc331	SIMULPF00001	270	270	297	243	27	27
332	FW_pair332	FakeAnc332	FakeDesc332	SIMULPF00001	327	333	361	299	34	28
333	FW_pair333	FakeAnc333	FakeDesc333	SIMULPF00001	170	162	184	148	14	22
334	FW_pair334	FakeAnc334	FakeDesc334	SIMULPF00001	321	328	359	290	38	31
335	FW_pair335	FakeAnc335	FakeDesc335	SIMULPF00001	489	473	530	432	41	57
336	FW_pair336	FakeAnc336	FakeDesc336	SIMULPF00001	79	76	84	71	5	8
337	FW_pair337	FakeAnc337	FakeDesc337	SIMULPF00001	342	344	373	313	31	29
338	FW_pair338	FakeAnc338	FakeDesc338	SIMULPF00001	709	737	791	655	82	54
339	FW_pair339	FakeAnc339	FakeDesc339	SIMULPF00001	140	124	150	114	10	26
340	FW_pair340	FakeAnc340	FakeDesc340	SIMULPF00001	204	202	219	187	15	17
341	FW_pair341	FakeAnc341	FakeDesc341	SIMULPF00001	168	169	181	156	13	12
342	FW_pair342	FakeAnc342	FakeDesc342	SIMULPF00001	144	146	154	136	10	8
343	FW_pair343	FakeAnc343	FakeDesc343	SIMULPF00001	38	37	43	32	5	6
344	FW_pair344	FakeAnc344	FakeDesc344	SIMULPF00001	37	41	43	35	6	2
345	FW_pair345	FakeAnc345	FakeDesc345	SIMULPF00001	118	113	133	98	15	20
346	FW_pair346	FakeAnc346	FakeDesc346	SIMULPF00001	134	149	152	131	18	3
347	FW_pair347	FakeAnc347	FakeDesc347	SIMULPF00001	221	217	236	202	15	19
348	FW_pair348	FakeAnc348	FakeDesc348	SIMULPF00001	269	293	309	253	40	16
349	FW_pair349	FakeAnc349	FakeDesc349	SIMULPF00001	215	223	236	202	21	13
350	FW_pair350	FakeAnc350	FakeDesc350	SIMULPF00001	2	2	2	2	0	0
351	FW_pair351	FakeAnc351	FakeDesc351	SIMULPF00001	67	61	70	58	3	9
352	FW_pair352	FakeAnc352	FakeDesc352	SIMULPF00001	359	359	400	318	41	41
353	FW_pair353	FakeAnc353	FakeDesc353	SIMULPF00001	71	68	74	65	3	6
354	FW_pair354	FakeAnc354	FakeDesc354	SIMULPF00001	44	51	56	39	12	5
355	FW_pair355	FakeAnc355	FakeDesc355	SIMULPF00001	172	168	186	154	14	18
356	FW_pair356	FakeAnc356	FakeDesc356	SIMULPF00001	124	127	137	114	13	10
357	FW_pair357	FakeAnc357	FakeDesc357	SIMULPF00001	203	201	224	180	21	23
358	FW_pair358	FakeAnc358	FakeDesc358	SIMULPF00001	120	122	134	108	14	12
359	FW_pair359	FakeAnc359	FakeDesc359	SIMULPF00001	25	23	29	19	4	6
360	FW_pair360	FakeAnc360	FakeDesc360	SIMULPF00001	111	117	127	101	16	10
361	FW_pair361	FakeAnc361	FakeDesc361	SIMULPF00001	10	10	11	9	1	1
362	FW_pair362	FakeAnc362	FakeDesc362	SIMULPF00001	423	423	459	387	36	36
363	FW_pair363	FakeAnc363	FakeDesc363	SIMULPF00001	146	154	169	131	23	15
364	FW_pair364	FakeAnc364	FakeDesc364	SIMULPF00001	747	760	832	675	85	72
365	FW_pair365	FakeAnc365	FakeDesc365	SIMULPF00001	212	213	228	197	16	15
366	FW_pair366	FakeAnc366	FakeDesc366	SIMULPF00001	367	373	408	332	41	35
367	FW_pair367	FakeAnc367	FakeDesc367	SIMULPF00001	623	635	696	562	73	61
368	FW_pair368	FakeAnc368	FakeDesc368	SIMULPF00001	190	177	205	162	15	28
369	FW_pair369	FakeAnc369	FakeDesc369	SIMULPF00001	757	744	827	674	70	83
370	FW_pair370	FakeAnc370	FakeDesc370	SIMULPF00001	32	29	33	28	1	4
371	FW_pair371	FakeAnc371	FakeDesc371	SIMULPF00001	457	447	508	396	51	61
372	FW_pair372	FakeAnc372	FakeDesc372	SIMULPF00001	314	312	342	284	28	30
373	FW_pair373	FakeAnc373	FakeDesc373	SIMULPF00001	55	54	60	49	5	6
374	FW_pair374	FakeAnc374	FakeDesc374	SIMULPF00001	136	145	154	127	18	9
375	FW_pair375	FakeAnc375	FakeDesc375	SIMULPF00001	404	391	437	358	33	46
376	FW_pair376	FakeAnc376	FakeDesc376	SIMULPF00001	179	171	193	157	14	22
377	FW_pair377	FakeAnc377	FakeDesc377	SIMULPF00001	343	336	368	311	25	32
378	FW_pair378	FakeAnc378	FakeDesc378	SIMULPF00001	390	367	410	347	20	43
379	FW_pair379	FakeAnc379	FakeDesc379	SIMULPF00001	413	414	454	373	41	40
380	FW_pair380	FakeAnc380	FakeDesc380	SIMULPF00001	112	108	123	97	11	15
381	FW_pair381	FakeAnc381	FakeDesc381	SIMULPF00001	158	154	167	145	9	13
382	FW_pair382	FakeAnc382	FakeDesc382	SIMULPF00001	239	248	266	221	27	18
383	FW_pair383	FakeAnc383	FakeDesc383	SIMULPF00001	31	29	32	28	1	3
384	FW_pair384	FakeAnc384	FakeDesc384	SIMULPF00001	751	760	824	687	73	64
385	FW_pair385	FakeAnc385	FakeDesc385	SIMULPF00001	54	59	63	50	9	4
386	FW_pair386	FakeAnc386	FakeDesc386	SIMULPF00001	16	18	20	14	4	2
387	FW_pair387	FakeAnc387	FakeDesc387	SIMULPF00001	274	272	293	253	19	21
388	FW_pair388	FakeAnc388	FakeDesc388	SIMULPF00001	654	652	712	594	58	60
389	FW_pair389	FakeAnc389	FakeDesc389	SIMULPF00001	571	560	623	508	52	63
390	FW_pair390	FakeAnc390	FakeDesc390	SIMULPF00001	391	385	422	354	31	37
391	FW_pair391	FakeAnc391	FakeDesc391	SIMULPF00001	167	164	185	146	18	21
392	FW_pair392	FakeAnc392	FakeDesc392	SIMULPF00001	278	280	302	256	24	22
393	FW_pair393	FakeAnc393	FakeDesc393	SIMULPF00001	165	162	180	147	15	18
394	FW_pair394	FakeAnc394	FakeDesc394	SIMULPF00001	479	478	533	424	54	55
395	FW_pair395	FakeAnc395	FakeDesc395	SIMULPF00001	35	39	42	32	7	3
396	FW_pair396	FakeAnc396	FakeDesc396	SIMULPF00001	248	246	272	222	24	26
397	FW_pair397	FakeAnc397	FakeDesc397	SIMULPF00001	109	106	118	97	9	12
398	FW_pair398	FakeAnc398	FakeDesc398	SIMULPF00001	109	106	117	98	8	11
399	FW_pair399	FakeAnc399	FakeDesc399	SIMULPF00001	698	711	759	650	61	48
400	FW_pair400	FakeAnc400	FakeDesc400	SIMULPF00001	104	114	122	96	18	8
401	FW_pair401	FakeAnc401	FakeDesc401	SIMULPF00001	91	90	95	86	4	5
402	FW_pair402	FakeAnc402	FakeDesc402	SIMULPF00001	155	143	161	137	6	18
403	FW_pair403	FakeAnc403	FakeDesc403	SIMULPF00001	330	337	361	306	31	24
404	FW_pair404	FakeAnc404	FakeDesc404	SIMULPF00001	34	29	37	26	3	8
405	FW_pair405	FakeAnc405	FakeDesc405	SIMULPF00001	90	86	99	77	9	13
406	FW_pair406	FakeAnc406	FakeDesc406	SIMULPF00001	43	45	47	41	4	2
407	FW_pair407	FakeAnc407	FakeDesc407	SIMULPF00001	18	20	20	18	2	0
408	FW_pair408	FakeAnc408	FakeDesc408	SIMULPF00001	425	428	468	385	43	40
409	FW_pair409	FakeAnc409	FakeDesc409	SIMULPF00001	655	653	717	591	62	64
410	FW_pair410	FakeAnc410	FakeDesc410	SIMULPF00001	65	62	69	58	4	7
411	FW_pair411	FakeAnc411	FakeDesc411	SIMULPF00001	28	29	30	27	2	1
412	FW_pair412	FakeAnc412	FakeDesc412	SIMULPF00001	203	205	222	186	19	17
413	FW_pair413	FakeAnc413	FakeDesc413	SIMULPF00001	346	335	373	308	27	38
414	FW_pair414	FakeAnc414	FakeDesc414	SIMULPF00001	3	3	3	3	0	0
415	FW_pair415	FakeAnc415	FakeDesc415	SIMULPF00001	28	26	28	26	0	2
416	FW_pair416	FakeAnc416	FakeDesc416	SIMULPF00001	200	203	216	187	16	13
417	FW_pair417	FakeAnc417	FakeDesc417	SIMULPF00001	456	462	502	416	46	40
418	FW_pair418	FakeAnc418	FakeDesc418	SIMULPF00001	218	237	250	205	32	13
419	FW_pair419	FakeAnc419	FakeDesc419	SIMULPF00001	68	73	77	64	9	4
420	FW_pair420	FakeAnc420	FakeDesc420	SIMULPF00001	181	192	203	170	22	11
421	FW_pair421	FakeAnc421	FakeDesc421	SIMULPF00001	3	3	3	3	0	0
422	FW_pair422	FakeAnc422	FakeDesc422	SIMULPF00001	272	273	288	257	16	15
423	FW_pair423	FakeAnc423	FakeDesc423	SIMULPF00001	130	128	138	120	8	10
424	FW_pair424	FakeAnc424	FakeDesc424	SIMULPF00001	123	121	129	115	6	8
425	FW_pair425	FakeAnc425	FakeDesc425	SIMULPF00001	238	236	256	218	18	20
426	FW_pair426	FakeAnc426	FakeDesc426	SIMULPF00001	225	218	247	196	22	29
427	FW_pair427	FakeAnc427	FakeDesc427	SIMULPF00001	537	550	607	480	70	57
428	FW_pair428	FakeAnc428	FakeDesc428	SIMULPF00001	137	132	144	125	7	12
429	FW_pair429	FakeAnc429	FakeDesc429	SIMULPF00001	38	38	40	36	2	2
430	FW_pair430	FakeAnc430	FakeDesc430	SIMULPF00001	602	612	659	555	57	47
431	FW_pair431	FakeAnc431	FakeDesc431	SIMULPF00001	166	148	172	142	6	24
432	FW_pair432	FakeAnc432	FakeDesc432	SIMULPF00001	221	218	242	197	21	24
433	FW_pair433	FakeAnc433	FakeDesc433	SIMULPF00001	85	99	105	79	20	6
434	FW_pair434	FakeAnc434	FakeDesc434	SIMULPF00001	241	242	259	224	18	17
435	FW_pair435	FakeAnc435	FakeDesc435	SIMULPF00001	32	30	34	28	2	4
436	FW_pair436	FakeAnc436	FakeDesc436	SIMULPF00001	22	25	25	22	3	0
437	FW_pair437	FakeAnc437	FakeDesc437	SIMULPF00001	437	441	476	402	39	35
438	FW_pair438	FakeAnc438	FakeDesc438	SIMULPF00001	49	47	51	45	2	4
439	FW_pair439	FakeAnc439	FakeDesc439	SIMULPF00001	408	414	448	374	40	34
440	FW_pair440	FakeAnc440	FakeDesc440	SIMULPF00001	85	87	96	76	11	9
441	FW_pair441	FakeAnc441	FakeDesc441	SIMULPF00001	194	187	213	168	19	26
442	FW_pair442	FakeAnc442	FakeDesc442	SIMULPF00001	52	50	53	49	1	3
443	FW_pair443	FakeAnc443	FakeDesc443	SIMULPF00001	50	49	54	45	4	5
444	FW_pair444	FakeAnc444	FakeDesc444	SIMULPF00001	174	175	193	156	19	18
445	FW_pair445	FakeAnc445	FakeDesc445	SIMULPF00001	225	243	260	208	35	17
446	FW_pair446	FakeAnc446	FakeDesc446	SIMULPF00001	634	630	695	569	61	65
447	FW_pair447	FakeAnc447	FakeDesc447	SIMULPF00001	156	158	169	145	13	11
448	FW_pair448	FakeAnc448	FakeDesc448	SIMULPF00001	114	106	121	99	7	15
449	FW_pair449	FakeAnc449	FakeDesc449	SIMULPF00001	200	205	223	182	23	18
450	FW_pair450	FakeAnc450	FakeDesc450	SIMULPF00001	125	125	135	115	10	10
451	FW_pair451	FakeAnc451	FakeDesc451	SIMULPF00001	72	64	75	61	3	11
452	FW_pair452	FakeAnc452	FakeDesc452	SIMULPF00001	338	347	373	312	35	26
453	FW_pair453	FakeAnc453	FakeDesc453	SIMULPF00001	319	308	345	282	26	37
454	FW_pair454	FakeAnc454	FakeDesc454	SIMULPF00001	510	496	545	461	35	49
455	FW_pair455	FakeAnc455	FakeDesc455	SIMULPF00001	124	111	130	105	6	19
456	FW_pair456	FakeAnc456	FakeDesc456	SIMULPF00001	327	322	361	288	34	39
457	FW_pair457	FakeAnc457	FakeDesc457	SIMULPF00001	216	207	238	185	22	31
458	FW_pair458	FakeAnc458	FakeDesc458	SIMULPF00001	54	52	56	50	2	4
459	FW_pair459	FakeAnc459	FakeDesc459	SIMULPF00001	5	4	5	4	0	1
460	FW_pair460	FakeAnc460	FakeDesc460	SIMULPF00001	57	61	67	51	10	6
461	FW_pair461	FakeAnc461	FakeDesc461	SIMULPF00001	36	37	39	34	3	2
462	FW_pair462	FakeAnc462	FakeDesc462	SIMULPF00001	125	116	133	108	8	17
463	FW_pair463	FakeAnc463	FakeDesc463	SIMULPF00001	262	266	286	242	24	20
464	FW_pair464	FakeAnc464	FakeDesc464	SIMULPF00001	49	48	52	45	3	4
465	FW_pair465	FakeAnc465	FakeDesc465	SIMULPF00001	24	26	26	24	2	0
466	FW_pair466	FakeAnc466	FakeDesc466	SIMULPF00001	102	99	108	93	6	9
467	FW_pair467	FakeAnc467	FakeDesc467	SIMULPF00001	199	195	211	183	12	16
468	FW_pair468	FakeAnc468	FakeDesc468	SIMULPF00001	48	51	54	45	6	3
469	FW_pair469	FakeAnc469	FakeDesc469	SIMULPF00001	285	286	318	253	33	32
470	FW_pair470	FakeAnc470	FakeDesc470	SIMULPF00001	57	56	59	54	2	3
471	FW_pair471	FakeAnc471	FakeDesc471	SIMULPF00001	760	778	850	688	90	72
472	FW_pair472	FakeAnc472	FakeDesc472	SIMULPF00001	767	759	836	690	69	77
473	FW_pair473	FakeAnc473	FakeDesc473	SIMULPF00001	101	98	110	89	9	12
474	FW_pair474	FakeAnc474	FakeDesc474	SIMULPF00001	11	15	16	10	5	1
475	FW_pair475	FakeAnc475	FakeDesc475	SIMULPF00001	97	103	110	90	13	7
476	FW_pair476	FakeAnc476	FakeDesc476	SIMULPF00001	522	539	584	477	62	45
477	FW_pair477	FakeAnc477	FakeDesc477	SIMULPF00001	124	134	145	113	21	11
478	FW_pair478	FakeAnc478	FakeDesc478	SIMULPF00001	810	833	902	741	92	69
479	FW_pair479	FakeAnc479	FakeDesc479	SIMULPF00001	917	919	996	840	79	77
480	FW_pair480	FakeAnc480	FakeDesc480	SIMULPF00001	241	232	258	215	17	26
481	FW_pair481	FakeAnc481	FakeDesc481	SIMULPF00001	610	580	652	538	42	72
482	FW_pair482	FakeAnc482	FakeDesc482	SIMULPF00001	84	85	91	78	7	6
483	FW_pair483	FakeAnc483	FakeDesc483	SIMULPF00001	308	300	328	280	20	28
484	FW_pair484	FakeAnc484	FakeDesc484	SIMULPF00001	289	287	309	267	20	22
485	FW_pair485	FakeAnc485	FakeDesc485	SIMULPF00001	553	539	599	493	46	60
486	FW_pair486	FakeAnc486	FakeDesc486	SIMULPF00001	34	34	35	33	1	1
487	FW_pair487	FakeAnc487	FakeDesc487	SIMULPF00001	183	184	200	167	17	16
488	FW_pair488	FakeAnc488	FakeDesc488	SIMULPF00001	173	174	189	158	16	15
489	FW_pair489	FakeAnc489	FakeDesc489	SIMULPF00001	54	54	56	52	2	2
490	FW_pair490	FakeAnc490	FakeDesc490	SIMULPF00001	14	13	16	11	2	3
491	FW_pair491	FakeAnc491	FakeDesc491	SIMULPF00001	8	8	8	8	0	0
492	FW_pair492	FakeAnc492	FakeDesc492	SIMULPF00001	94	102	108	88	14	6
493	FW_pair493	FakeAnc493	FakeDesc493	SIMULPF00001	423	427	468	382	45	41
494	FW_pair494	FakeAnc494	FakeDesc494	SIMULPF00001	826	811	894	743	68	83
495	FW_pair495	FakeAnc495	FakeDesc495	SIMULPF00001	117	128	132	113	15	4
496	FW_pair496	FakeAnc496	FakeDesc496	SIMULPF00001	280	282	312	250	32	30
497	FW_pair497	FakeAnc497	FakeDesc497	SIMULPF00001	195	183	209	169	14	26
498	FW_pair498	FakeAnc498	FakeDesc498	SIMULPF00001	7	8	8	7	1	0
499	FW_pair499	FakeAnc499	FakeDesc499	SIMULPF00001	71	63	74	60	3	11
500	FW_pair500	FakeAnc500	FakeDesc500	SIMULPF00001	93	97	100	90	7	3
501	FW_pair501	FakeAnc501	FakeDesc501	SIMULPF00001	94	93	101	86	7	8
502	FW_pair502	FakeAnc502	FakeDesc502	SIMULPF00001	603	589	650	542	47	61
503	FW_pair503	FakeAnc503	FakeDesc503	SIMULPF00001	670	672	738	604	68	66
504	FW_pair504	FakeAnc504	FakeDesc504	SIMULPF00001	147	153	159	141	12	6
505	FW_pair505	FakeAnc505	FakeDesc505	SIMULPF00001	233	237	256	214	23	19
506	FW_pair506	FakeAnc506	FakeDesc506	SIMULPF00001	143	147	158	132	15	11
507	FW_pair507	FakeAnc507	FakeDesc507	SIMULPF00001	224	219	244	199	20	25
508	FW_pair508	FakeAnc508	FakeDesc508	SIMULPF00001	237	244	262	219	25	18
509	FW_pair509	FakeAnc509	FakeDesc509	SIMULPF00001	516	509	562	463	46	53
510	FW_pair510	FakeAnc510	FakeDesc510	SIMULPF00001	284	285	310	259	26	25
511	FW_pair511	FakeAnc511	FakeDesc511	SIMULPF00001	498	496	540	454	42	44
512	FW_pair512	FakeAnc512	FakeDesc512	SIMULPF00001	276	272	301	247	25	29
513	FW_pair513	FakeAnc513	FakeDesc513	SIMULPF00001	176	172	194	154	18	22
514	FW_pair514	FakeAnc514	FakeDesc514	SIMULPF00001	778	799	866	711	88	67
515	FW_pair515	FakeAnc515	FakeDesc515	SIMULPF00001	197	195	218	174	21	23
516	FW_pair516	FakeAnc516	FakeDesc516	SIMULPF00001	232	228	243	217	11	15
517	FW_pair517	FakeAnc517	FakeDesc517	SIMULPF00001	524	556	597	483	73	41
518	FW_pair518	FakeAnc518	FakeDesc518	SIMULPF00001	372	363	409	326	37	46
519	FW_pair519	FakeAnc519	FakeDesc519	SIMULPF00001	274	258	288	244	14	30
520	FW_pair520	FakeAnc520	FakeDesc520	SIMULPF00001	55	52	56	51	1	4
521	FW_pair521	FakeAnc521	FakeDesc521	SIMULPF00001	138	141	151	128	13	10
522	FW_pair522	FakeAnc522	FakeDesc522	SIMULPF00001	196	179	206	169	10	27
523	FW_pair523	FakeAnc523	FakeDesc523	SIMULPF00001	543	544	589	498	46	45
524	FW_pair524	FakeAnc524	FakeDesc524	SIMULPF00001	57	60	64	53	7	4
525	FW_pair525	FakeAnc525	FakeDesc525	SIMULPF00001	167	176	185	158	18	9
526	FW_pair526	FakeAnc526	FakeDesc526	SIMULPF00001	93	90	101	82	8	11
527	FW_pair527	FakeAnc527	FakeDesc527	SIMULPF00001	329	330	360	299	31	30
528	FW_pair528	FakeAnc528	FakeDesc528	SIMULPF00001	410	412	453	369	43	41
529	FW_pair529	FakeAnc529	FakeDesc529	SIMULPF00001	449	435	486	398	37	51
530	FW_pair530	FakeAnc530	FakeDesc530	SIMULPF00001	211	201	230	182	19	29
531	FW_pair531	FakeAnc531	FakeDesc531	SIMULPF00001	91	89	99	81	8	10
532	FW_pair532	FakeAnc532	FakeDesc532	SIMULPF00001	129	122	139	112	10	17
533	FW_pair533	FakeAnc533	FakeDesc533	SIMULPF00001	25	29	29	25	4	0
534	FW_pair534	FakeAnc534	FakeDesc534	SIMULPF00001	164	172	188	148	24	16
535	FW_pair535	FakeAnc535	FakeDesc535	SIMULPF00001	14	13	14	13	0	1
536	FW_pair536	FakeAnc536	FakeDesc536	SIMULPF00001	360	376	396	340	36	20
537	FW_pair537	FakeAnc537	FakeDesc537	SIMULPF00001	874	891	971	794	97	80
538	FW_pair538	FakeAnc538	FakeDesc538	SIMULPF00001	745	743	805	683	60	62
539	FW_pair539	FakeAnc539	FakeDesc539	SIMULPF00001	72	82	85	69	13	3
540	FW_pair540	FakeAnc540	FakeDesc540	SIMULPF00001	337	326	362	301	25	36
541	FW_pair541	FakeAnc541	FakeDesc541	SIMULPF00001	186	185	200	171	14	15
542	FW_pair542	FakeAnc542	FakeDesc542	SIMULPF00001	96	96	104	88	8	8
543	FW_pair543	FakeAnc543	FakeDesc543	SIMULPF00001	187	174	202	159	15	28
544	FW_pair544	FakeAnc544	FakeDesc544	SIMULPF00001	82	84	91	75	9	7
545	FW_pair545	FakeAnc545	FakeDesc545	SIMULPF00001	93	96	108	81	15	12
546	FW_pair546	FakeAnc546	FakeDesc546	SIMULPF00001	364	370	396	338	32	26
547	FW_pair547	FakeAnc547	FakeDesc547	SIMULPF00001	2	2	2	2	0	0
548	FW_pair548	FakeAnc548	FakeDesc548	SIMULPF00001	97	105	109	93	12	4
549	FW_pair549	FakeAnc549	FakeDesc549	SIMULPF00001	109	118	125	102	16	7
550	FW_pair550	FakeAnc550	FakeDesc550	SIMULPF00001	183	171	196	158	13	25
551	FW_pair551	FakeAnc551	FakeDesc551	SIMULPF00001	101	103	115	89	14	12
552	FW_pair552	FakeAnc552	FakeDesc552	SIMULPF00001	198	210	225	183	27	15
553	FW_pair553	FakeAnc553	FakeDesc553	SIMULPF00001	455	458	502	411	47	44
554	FW_pair554	FakeAnc554	FakeDesc554	SIMULPF00001	211	208	235	184	24	27
555	FW_pair555	FakeAnc555	FakeDesc555	SIMULPF00001	6	1	6	1	0	5
556	FW_pair556	FakeAnc556	FakeDesc556	SIMULPF00001	428	407	460	375	32	53
557	FW_pair557	FakeAnc557	FakeDesc557	SIMULPF00001	218	217	238	197	20	21
558	FW_pair558	FakeAnc558	FakeDesc558	SIMULPF00001	248	251	277	222	29	26
559	FW_pair559	FakeAnc559	FakeDesc559	SIMULPF00001	509	507	560	456	51	53
560	FW_pair560	FakeAnc560	FakeDesc560	SIMULPF00001	69	71	76	64	7	5
561	FW_pair561	FakeAnc561	FakeDesc561	SIMULPF00001	224	227	240	211	16	13
562	FW_pair562	FakeAnc562	FakeDesc562	SIMULPF00001	4	3	4	3	0	1
563	FW_pair563	FakeAnc563	FakeDesc563	SIMULPF00001	359	364	390	333	31	26
564	FW_pair564	FakeAnc564	FakeDesc564	SIMULPF00001	43	40	46	37	3	6
565	FW_pair565	FakeAnc565	FakeDesc565	SIMULPF00001	94	93	103	84	9	10
566	FW_pair566	FakeAnc566	FakeDesc566	SIMULPF00001	863	884	966	781	103	82
567	FW_pair567	FakeAnc567	FakeDesc567	SIMULPF00001	770	768	836	702	66	68
568	FW_pair568	FakeAnc568	FakeDesc568	SIMULPF00001	31	30	35	26	4	5
569	FW_pair569	FakeAnc569	FakeDesc569	SIMULPF00001	236	239	260	215	24	21
570	FW_pair570	FakeAnc570	FakeDesc570	SIMULPF00001	500	520	557	463	57	37
571	FW_pair571	FakeAnc571	FakeDesc571	SIMULPF00001	601	619	673	547	72	54
572	FW_pair572	FakeAnc572	FakeDesc572	SIMULPF00001	80	84	95	69	15	11
573	FW_pair573	FakeAnc573	FakeDesc573	SIMULPF00001	184	184	198	170	14	14
574	FW_pair574	FakeAnc574	FakeDesc574	SIMULPF00001	521	513	567	467	46	54
575	FW_pair575	FakeAnc575	FakeDesc575	SIMULPF00001	169	168	180	157	11	12
576	FW_pair576	FakeAnc576	FakeDesc576	SIMULPF00001	65	66	72	59	7	6
577	FW_pair577	FakeAnc577	FakeDesc577	SIMULPF00001	659	680	724	615	65	44
578	FW_pair578	FakeAnc578	FakeDesc578	SIMULPF00001	38	41	45	34	7	4
579	FW_pair579	FakeAnc579	FakeDesc579	SIMULPF00001	14	15	15	14	1	0
580	FW_pair580	FakeAnc580	FakeDesc580	SIMULPF00001	79	73	85	67	6	12
581	FW_pair581	FakeAnc581	FakeDesc581	SIMULPF00001	419	416	451	384	32	35
582	FW_pair582	FakeAnc582	FakeDesc582	SIMULPF00001	27	25	27	25	0	2
583	FW_pair583	FakeAnc583	FakeDesc583	SIMULPF00001	72	82	86	68	14	4
584	FW_pair584	FakeAnc584	FakeDesc584	SIMULPF00001	120	124	133	111	13	9
585	FW_pair585	FakeAnc585	FakeDesc585	SIMULPF00001	153	160	172	141	19	12
586	FW_pair586	FakeAnc586	FakeDesc586	SIMULPF00001	167	167	177	157	10	10
587	FW_pair587	FakeAnc587	FakeDesc587	SIMULPF00001	105	106	110	101	5	4
588	FW_pair588	FakeAnc588	FakeDesc588	SIMULPF00001	66	64	69	61	3	5
589	FW_pair589	FakeAnc589	FakeDesc589	SIMULPF00001	251	247	270	228	19	23
590	FW_pair590	FakeAnc590	FakeDesc590	SIMULPF00001	462	471	505	428	43	34
591	FW_pair591	FakeAnc591	FakeDesc591	SIMULPF00001	41	44	48	37	7	4
592	FW_pair592	FakeAnc592	FakeDesc592	SIMULPF00001	71	68	75	64	4	7
593	FW_pair593	FakeAnc593	FakeDesc593	SIMULPF00001	353	353	377	329	24	24
594	FW_pair594	FakeAnc594	FakeDesc594	SIMULPF00001	101	107	111	97	10	4
595	FW_pair595	FakeAnc595	FakeDesc595	SIMULPF00001	413	414	448	379	35	34
596	FW_pair596	FakeAnc596	FakeDesc596	SIMULPF00001	34	32	35	31	1	3
597	FW_pair597	FakeAnc597	FakeDesc597	SIMULPF00001	74	77	85	66	11	8
598	FW_pair598	FakeAnc598	FakeDesc598	SIMULPF00001	94	102	110	86	16	8
599	FW_pair599	FakeAnc599	FakeDesc599	SIMULPF00001	233	238	261	210	28	23
600	FW_pair600	FakeAnc600	FakeDesc600	SIMULPF00001	262	256	283	235	21	27
601	FW_pair601	FakeAnc601	FakeDesc601	SIMULPF00001	281	290	315	256	34	25
602	FW_pair602	FakeAnc602	FakeDesc602	SIMULPF00001	625	635	695	565	70	60
603	FW_pair603	FakeAnc603	FakeDesc603	SIMULPF00001	10	13	13	10	3	0
604	FW_pair604	FakeAnc604	FakeDesc604	SIMULPF00001	66	69	73	62	7	4
605	FW_pair605	FakeAnc605	FakeDesc605	SIMULPF00001	522	516	570	468	48	54
606	FW_pair606	FakeAnc606	FakeDesc606	SIMULPF00001	11	10	13	8	2	3
607	FW_pair607	FakeAnc607	FakeDesc607	SIMULPF00001	2	2	2	2	0	0
608	FW_pair608	FakeAnc608	FakeDesc608	SIMULPF00001	631	643	686	588	55	43
609	FW_pair609	FakeAnc609	FakeDesc609	SIMULPF00001	261	266	283	244	22	17
610	FW_pair610	FakeAnc610	FakeDesc610	SIMULPF00001	393	408	438	363	45	30
611	FW_pair611	FakeAnc611	FakeDesc611	SIMULPF00001	361	360	392	329	31	32
612	FW_pair612	FakeAnc612	FakeDesc612	SIMULPF00001	101	102	110	93	9	8
613	FW_pair613	FakeAnc613	FakeDesc613	SIMULPF00001	297	280	311	266	14	31
614	FW_pair614	FakeAnc614	FakeDesc614	SIMULPF00001	31	29	33	27	2	4
615	FW_pair615	FakeAnc615	FakeDesc615	SIMULPF00001	160	158	174	144	14	16
616	FW_pair616	FakeAnc616	FakeDesc616	SIMULPF00001	163	173	188	148	25	15
617	FW_pair617	FakeAnc617	FakeDesc617	SIMULPF00001	398	383	431	350	33	48
618	FW_pair618	FakeAnc618	FakeDesc618	SIMULPF00001	466	448	492	422	26	44
619	FW_pair619	FakeAnc619	FakeDesc619	SIMULPF00001	275	274	297	252	22	23
620	FW_pair620	FakeAnc620	FakeDesc620	SIMULPF00001	588	587	643	532	55	56
621	FW_pair621	FakeAnc621	FakeDesc621	SIMULPF00001	807	814	892	729	85	78
622	FW_pair622	FakeAnc622	FakeDesc622	SIMULPF00001	27	26	30	23	3	4
623	FW_pair623	FakeAnc623	FakeDesc623	SIMULPF00001	9	9	9	9	0	0
624	FW_pair624	FakeAnc624	FakeDesc624	SIMULPF00001	452	436	487	401	35	51
625	FW_pair625	FakeAnc625	FakeDesc625	SIMULPF00001	53	53	55	51	2	2
626	FW_pair626	FakeAnc626	FakeDesc626	SIMULPF00001	512	504	549	467	37	45
627	FW_pair627	FakeAnc627	FakeDesc627	SIMULPF00001	85	86	96	75	11	10
628	FW_pair628	FakeAnc628	FakeDesc628	SIMULPF00001	47	45	52	40	5	7
629	FW_pair629	FakeAnc629	FakeDesc629	SIMULPF00001	37	37	44	30	7	7
630	FW_pair630	FakeAnc630	FakeDesc630	SIMULPF00001	428	418	467	379	39	49
631	FW_pair631	FakeAnc631	FakeDesc631	SIMULPF00001	125	121	135	111	10	14
632	FW_pair632	FakeAnc632	FakeDesc632	SIMULPF00001	155	146	161	140	6	15
633	FW_pair633	FakeAnc633	FakeDesc633	SIMULPF00001	406	405	439	372	33	34
634	FW_pair634	FakeAnc634	FakeDesc634	SIMULPF00001	435	415	476	374	41	61
635	FW_pair635	FakeAnc635	FakeDesc635	SIMULPF00001	719	714	787	646	68	73
636	FW_pair636	FakeAnc636	FakeDesc636	SIMULPF00001	131	119	140	110	9	21
637	FW_pair637	FakeAnc637	FakeDesc637	SIMULPF00001	89	92	97	84	8	5
638	FW_pair638	FakeAnc638	FakeDesc638	SIMULPF00001	2	2	2	2	0	0
639	FW_pair639	FakeAnc639	FakeDesc639	SIMULPF00001	132	122	140	114	8	18
640	FW_pair640	FakeAnc640	FakeDesc640	SIMULPF00001	387	392	420	359	33	28
641	FW_pair641	FakeAnc641	FakeDesc641	SIMULPF00001	243	242	263	222	20	21
642	FW_pair642	FakeAnc642	FakeDesc642	SIMULPF00001	3	3	3	3	0	0
643	FW_pair643	FakeAnc643	FakeDesc643	SIMULPF00001	102	100	108	94	6	8
644	FW_pair644	FakeAnc644	FakeDesc644	SIMULPF00001	74	74	82	66	8	8
645	FW_pair645	FakeAnc645	FakeDesc645	SIMULPF00001	12	14	16	10	4	2
646	FW_pair646	FakeAnc646	FakeDesc646	SIMULPF00001	111	106	117	100	6	11
647	FW_pair647	FakeAnc647	FakeDesc647	SIMULPF00001	76	80	86	70	10	6
648	FW_pair648	FakeAnc648	FakeDesc648	SIMULPF00001	83	83	92	74	9	9
649	FW_pair649	FakeAnc649	FakeDesc649	SIMULPF00001	173	166	186	153	13	20
650	FW_pair650	FakeAnc650	FakeDesc650	SIMULPF00001	17	17	19	15	2	2
651	FW_pair651	FakeAnc651	FakeDesc651	SIMULPF00001	451	437	486	402	35	49
652	FW_pair652	FakeAnc652	FakeDesc652	SIMULPF00001	35	34	36	33	1	2
653	FW_pair653	FakeAnc653	FakeDesc653	SIMULPF00001	39	37	40	36	1	3
654	FW_pair654	FakeAnc654	FakeDesc654	SIMULPF00001	498	524	552	470	54	28
655	FW_pair655	FakeAnc655	FakeDesc655	SIMULPF00001	279	288	312	255	33	24
656	FW_pair656	FakeAnc656	FakeDesc656	SIMULPF00001	298	291	320	269	22	29
657	FW_pair657	FakeAnc657	FakeDesc657	SIMULPF00001	506	513	559	460	53	46
658	FW_pair658	FakeAnc658	FakeDesc658	SIMULPF00001	15	16	16	15	1	0
659	FW_pair659	FakeAnc659	FakeDesc659	SIMULPF00001	193	184	210	167	17	26
660	FW_pair660	FakeAnc660	FakeDesc660	SIMULPF00001	75	70	77	68	2	7
661	FW_pair661	FakeAnc661	FakeDesc661	SIMULPF00001	455	467	501	421	46	34
662	FW_pair662	FakeAnc662	FakeDesc662	SIMULPF00001	103	86	105	84	2	19
663	FW_pair663	FakeAnc663	FakeDesc663	SIMULPF00001	1	1	1	1	0	0
664	FW_pair664	FakeAnc664	FakeDesc664	SIMULPF00001	513	487	550	450	37	63
665	FW_pair665	FakeAnc665	FakeDesc665	SIMULPF00001	732	732	808	656	76	76
666	FW_pair666	FakeAnc666	FakeDesc666	SIMULPF00001	127	127	136	118	9	9
667	FW_pair667	FakeAnc667	FakeDesc667	SIMULPF00001	45	52	57	40	12	5
668	FW_pair668	FakeAnc668	FakeDesc668	SIMULPF00001	115	113	129	99	14	16
669	FW_pair669	FakeAnc669	FakeDesc669	SIMULPF00001	48	48	56	40	8	8
670	FW_pair670	FakeAnc670	FakeDesc670	SIMULPF00001	225	226	238	213	13	12
671	FW_pair671	FakeAnc671	FakeDesc671	SIMULPF00001	26	25	28	23	2	3
672	FW_pair672	FakeAnc672	FakeDesc672	SIMULPF00001	246	262	274	234	28	12
673	FW_pair673	FakeAnc673	FakeDesc673	SIMULPF00001	462	455	503	414	41	48
674	FW_pair674	FakeAnc674	FakeDesc674	SIMULPF00001	306	299	337	268	31	38
675	FW_pair675	FakeAnc675	FakeDesc675	SIMULPF00001	46	46	51	41	5	5
676	FW_pair676	FakeAnc676	FakeDesc676	SIMULPF00001	39	41	43	37	4	2
677	FW_pair677	FakeAnc677	FakeDesc677	SIMULPF00001	284	278	309	253	25	31
678	FW_pair678	FakeAnc678	FakeDesc678	SIMULPF00001	149	155	166	138	17	11
679	FW_pair679	FakeAnc679	FakeDesc679	SIMULPF00001	114	106	120	100	6	14
680	FW_pair680	FakeAnc680	FakeDesc680	SIMULPF00001	78	80	86	72	8	6
681	FW_pair681	FakeAnc681	FakeDesc681	SIMULPF00001	463	433	490	406	27	57
682	FW_pair682	FakeAnc682	FakeDesc682	SIMULPF00001	123	116	133	106	10	17
683	FW_pair683	FakeAnc683	FakeDesc683	SIMULPF00001	419	423	457	385	38	34
684	FW_pair684	FakeAnc684	FakeDesc684	SIMULPF00001	800	828	904	724	104	76
685	FW_pair685	FakeAnc685	FakeDesc685	SIMULPF00001	16	14	16	14	0	2
686	FW_pair686	FakeAnc686	FakeDesc686	SIMULPF00001	539	536	585	490	46	49
687	FW_pair687	FakeAnc687	FakeDesc687	SIMULPF00001	239	231	257	213	18	26
688	FW_pair688	FakeAnc688	FakeDesc688	SIMULPF00001	141	133	148	126	7	15
689	FW_pair689	FakeAnc689	FakeDesc689	SIMULPF00001	571	553	622	502	51	69
690	FW_pair690	FakeAnc690	FakeDesc690	SIMULPF00001	109	104	114	99	5	10
691	FW_pair691	FakeAnc691	FakeDesc691	SIMULPF00001	261	259	292	228	31	33
692	FW_pair692	FakeAnc692	FakeDesc692	SIMULPF00001	366	364	399	331	33	35
693	FW_pair693	FakeAnc693	FakeDesc693	SIMULPF00001	121	122	131	112	10	9
694	FW_pair694	FakeAnc694	FakeDesc694	SIMULPF00001	99	100	104	95	5	4
695	FW_pair695	FakeAnc695	FakeDesc695	SIMULPF00001	363	349	380	332	17	31
696	FW_pair696	FakeAnc696	FakeDesc696	SIMULPF00001	210	205	226	189	16	21
697	FW_pair697	FakeAnc697	FakeDesc697	SIMULPF00001	240	247	267	220	27	20
698	FW_pair698	FakeAnc698	FakeDesc698	SIMULPF00001	226	214	238	202	12	24
699	FW_pair699	FakeAnc699	FakeDesc699	SIMULPF00001	149	144	159	134	10	15
700	FW_pair700	FakeAnc700	FakeDesc700	SIMULPF00001	412	421	451	382	39	30
701	FW_pair701	FakeAnc701	FakeDesc701	SIMULPF00001	234	227	257	204	23	30
702	FW_pair702	FakeAnc702	FakeDesc702	SIMULPF00001	587	567	628	526	41	61
703	FW_pair703	FakeAnc703	FakeDesc703	SIMULPF00001	40	40	44	36	4	4
704	FW_pair704	FakeAnc704	FakeDesc704	SIMULPF00001	214	205	232	187	18	27
705	FW_pair705	FakeAnc705	FakeDesc705	SIMULPF00001	131	135	144	122	13	9
706	FW_pair706	FakeAnc706	FakeDesc706	SIMULPF00001	145	136	160	121	15	24
707	FW_pair707	FakeAnc707	FakeDesc707	SIMULPF00001	28	25	30	23	2	5
708	FW_pair708	FakeAnc708	FakeDesc708	SIMULPF00001	25	27	31	21	6	4
709	FW_pair709	FakeAnc709	FakeDesc709	SIMULPF00001	820	809	890	739	70	81
710	FW_pair710	FakeAnc710	FakeDesc710	SIMULPF00001	243	241	265	219	22	24
711	FW_pair711	FakeAnc711	FakeDesc711	SIMULPF00001	139	138	146	131	7	8
712	FW_pair712	FakeAnc712	FakeDesc712	SIMULPF00001	24	25	30	19	6	5
713	FW_pair713	FakeAnc713	FakeDesc713	SIMULPF00001	31	32	36	27	5	4
714	FW_pair714	FakeAnc714	FakeDesc714	SIMULPF00001	476	492	528	440	52	36
715	FW_pair715	FakeAnc715	FakeDesc715	SIMULPF00001	68	67	73	62	5	6
716	FW_pair716	FakeAnc716	FakeDesc716	SIMULPF00001	720	718	793	645	73	75
717	FW_pair717	FakeAnc717	FakeDesc717	SIMULPF00001	84	83	89	78	5	6
718	FW_pair718	FakeAnc718	FakeDesc718	SIMULPF00001	17	16	17	16	0	1
719	FW_pair719	FakeAnc719	FakeDesc719	SIMULPF00001	46	46	49	43	3	3
720	FW_pair720	FakeAnc720	FakeDesc720	SIMULPF00001	712	735	795	652	83	60
721	FW_pair721	FakeAnc721	FakeDesc721	SIMULPF00001	32	29	34	27	2	5
722	FW_pair722	FakeAnc722	FakeDesc722	SIMULPF00001	423	415	464	374	41	49
723	FW_pair723	FakeAnc723	FakeDesc723	SIMULPF00001	272	273	291	254	19	18
724	FW_pair724	FakeAnc724	FakeDesc724	SIMULPF00001	175	177	197	155	22	20
725	FW_pair725	FakeAnc725	FakeDesc725	SIMULPF00001	86	79	94	71	8	15
726	FW_pair726	FakeAnc726	FakeDesc726	SIMULPF00001	345	355	377	323	32	22
727	FW_pair727	FakeAnc727	FakeDesc727	SIMULPF00001	54	58	61	51	7	3
728	FW_pair728	FakeAnc728	FakeDesc728	SIMULPF00001	110	107	115	102	5	8
729	FW_pair729	FakeAnc729	FakeDesc729	SIMULPF00001	213	216	238	191	25	22
730	FW_pair730	FakeAnc730	FakeDesc730	SIMULPF00001	7	5	7	5	0	2
731	FW_pair731	FakeAnc731	FakeDesc731	SIMULPF00001	293	290	323	260	30	33
732	FW_pair732	FakeAnc732	FakeDesc732	SIMULPF00001	401	403	441	363	40	38
733	FW_pair733	FakeAnc733	FakeDesc733	SIMULPF00001	423	426	476	373	53	50
734	FW_pair734	FakeAnc734	FakeDesc734	SIMULPF00001	575	589	646	518	71	57
735	FW_pair735	FakeAnc735	FakeDesc735	SIMULPF00001	16	15	17	14	1	2
736	FW_pair736	FakeAnc736	FakeDesc736	SIMULPF00001	327	346	376	297	49	30
737	FW_pair737	FakeAnc737	FakeDesc737	SIMULPF00001	112	110	120	102	8	10
738	FW_pair738	FakeAnc738	FakeDesc738	SIMULPF00001	88	88	97	79	9	9
739	FW_pair739	FakeAnc739	FakeDesc739	SIMULPF00001	98	99	108	89	10	9
740	FW_pair740	FakeAnc740	FakeDesc740	SIMULPF00001	409	442	474	377	65	32
741	FW_pair741	FakeAnc741	FakeDesc741	SIMULPF00001	246	247	272	221	26	25
742	FW_pair742	FakeAnc742	FakeDesc742	SIMULPF00001	381	372	413	340	32	41
743	FW_pair743	FakeAnc743	FakeDesc743	SIMULPF00001	92	93	103	82	11	10
744	FW_pair744	FakeAnc744	FakeDesc744	SIMULPF00001	309	322	346	285	37	24
745	FW_pair745	FakeAnc745	FakeDesc745	SIMULPF00001	613	637	683	567	70	46
746	FW_pair746	FakeAnc746	FakeDesc746	SIMULPF00001	36	38	40	34	4	2
747	FW_pair747	FakeAnc747	FakeDesc747	SIMULPF00001	89	83	96	76	7	13
748	FW_pair748	FakeAnc748	FakeDesc748	SIMULPF00001	628	645	697	576	69	52
749	FW_pair749	FakeAnc749	FakeDesc749	SIMULPF00001	37	39	43	33	6	4
750	FW_pair750	FakeAnc750	FakeDesc750	SIMULPF00001	50	39	51	38	1	12
751	FW_pair751	FakeAnc751	FakeDesc751	SIMULPF00001	86	87	91	82	5	4
752	FW_pair752	FakeAnc752	FakeDesc752	SIMULPF00001	57	61	65	53	8	4
753	FW_pair753	FakeAnc753	FakeDesc753	SIMULPF00001	139	145	153	131	14	8
754	FW_pair754	FakeAnc754	FakeDesc754	SIMULPF00001	18	23	24	17	6	1
755	FW_pair755	FakeAnc755	FakeDesc755	SIMULPF00001	3	2	3	2	0	1
756	FW_pair756	FakeAnc756	FakeDesc756	SIMULPF00001	524	506	569	461	45	63
757	FW_pair757	FakeAnc757	FakeDesc757	SIMULPF00001	163	176	185	154	22	9
758	FW_pair758	FakeAnc758	FakeDesc758	SIMULPF00001	5	7	7	5	2	0
759	FW_pair759	FakeAnc759	FakeDesc759	SIMULPF00001	111	103	117	97	6	14
760	FW_pair760	FakeAnc760	FakeDesc760	SIMULPF00001	247	233	265	215	18	32
761	FW_pair761	FakeAnc761	FakeDesc761	SIMULPF00001	24	25	25	24	1	0
762	FW_pair762	FakeAnc762	FakeDesc762	SIMULPF00001	254	249	276	227	22	27
763	FW_pair763	FakeAnc763	FakeDesc763	SIMULPF00001	486	487	535	438	49	48
764	FW_pair764	FakeAnc764	FakeDesc764	SIMULPF00001	387	381	415	353	28	34
765	FW_pair765	FakeAnc765	FakeDesc765	SIMULPF00001	675	686	752	609	77	66
766	FW_pair766	FakeAnc766	FakeDesc766	SIMULPF00001	648	654	712	590	64	58
767	FW_pair767	FakeAnc767	FakeDesc767	SIMULPF00001	33	39	41	31	8	2
768	FW_pair768	FakeAnc768	FakeDesc768	SIMULPF00001	107	102	114	95	7	12
769	FW_pair769	FakeAnc769	FakeDesc769	SIMULPF00001	69	66	76	59	7	10
770	FW_pair770	FakeAnc770	FakeDesc770	SIMULPF00001	196	203	211	188	15	8
771	FW_pair771	FakeAnc771	FakeDesc771	SIMULPF00001	41	40	42	39	1	2
772	FW_pair772	FakeAnc772	FakeDesc772	SIMULPF00001	428	441	476	393	48	35
773	FW_pair773	FakeAnc773	FakeDesc773	SIMULPF00001	54	62	66	50	12	4
774	FW_pair774	FakeAnc774	FakeDesc774	SIMULPF00001	97	92	102	87	5	10
775	FW_pair775	FakeAnc775	FakeDesc775	SIMULPF00001	512	526	568	470	56	42
776	FW_pair776	FakeAnc776	FakeDesc776	SIMULPF00001	112	109	123	98	11	14
777	FW_pair777	FakeAnc777	FakeDesc777	SIMULPF00001	149	149	166	132	17	17
778	FW_pair778	FakeAnc778	FakeDesc778	SIMULPF00001	455	445	490	410	35	45
779	FW_pair779	FakeAnc779	FakeDesc779	SIMULPF00001	234	228	253	209	19	25
780	FW_pair780	FakeAnc780	FakeDesc780	SIMULPF00001	517	521	569	469	52	48
781	FW_pair781	FakeAnc781	FakeDesc781	SIMULPF00001	367	369	404	332	37	35
782	FW_pair782	FakeAnc782	FakeDesc782	SIMULPF00001	72	71	76	67	4	5
783	FW_pair783	FakeAnc783	FakeDesc783	SIMULPF00001	43	44	50	37	7	6
784	FW_pair784	FakeAnc784	FakeDesc784	SIMULPF00001	130	137	147	120	17	10
785	FW_pair785	FakeAnc785	FakeDesc785	SIMULPF00001	412	396	445	363	33	49
786	FW_pair786	FakeAnc786	FakeDesc786	SIMULPF00001	152	156	176	132	24	20
787	FW_pair787	FakeAnc787	FakeDesc787	SIMULPF00001	381	394	429	346	48	35
788	FW_pair788	FakeAnc788	FakeDesc788	SIMULPF00001	400	405	439	366	39	34
789	FW_pair789	FakeAnc789	FakeDesc789	SIMULPF00001	111	107	116	102	5	9
790	FW_pair790	FakeAnc790	FakeDesc790	SIMULPF00001	163	171	184	150	21	13
791	FW_pair791	FakeAnc791	FakeDesc791	SIMULPF00001	66	70	75	61	9	5
792	FW_pair792	FakeAnc792	FakeDesc792	SIMULPF00001	388	382	420	350	32	38
793	FW_pair793	FakeAnc793	FakeDesc793	SIMULPF00001	182	174	204	152	22	30
794	FW_pair794	FakeAnc794	FakeDesc794	SIMULPF00001	110	104	121	93	11	17
795	FW_pair795	FakeAnc795	FakeDesc795	SIMULPF00001	810	804	881	733	71	77
796	FW_pair796	FakeAnc796	FakeDesc796	SIMULPF00001	316	308	338	286	22	30
797	FW_pair797	FakeAnc797	FakeDesc797	SIMULPF00001	35	29	35	29	0	6
798	FW_pair798	FakeAnc798	FakeDesc798	SIMULPF00001	118	114	123	109	5	9
799	FW_pair799	FakeAnc799	FakeDesc799	SIMULPF00001	15	15	15	15	0	0
800	FW_pair800	FakeAnc800	FakeDesc800	SIMULPF00001	443	432	480	395	37	48
801	FW_pair801	FakeAnc801	FakeDesc801	SIMULPF00001	174	178	193	159	19	15
802	FW_pair802	FakeAnc802	FakeDesc802	SIMULPF00001	535	521	567	489	32	46
803	FW_pair803	FakeAnc803	FakeDesc803	SIMULPF00001	306	299	337	268	31	38
804	FW_pair804	FakeAnc804	FakeDesc804	SIMULPF00001	65	69	70	64	5	1
805	FW_pair805	FakeAnc805	FakeDesc805	SIMULPF00001	54	49	55	48	1	6
806	FW_pair806	FakeAnc806	FakeDesc806	SIMULPF00001	445	439	491	393	46	52
807	FW_pair807	FakeAnc807	FakeDesc807	SIMULPF00001	168	164	185	147	17	21
808	FW_pair808	FakeAnc808	FakeDesc808	SIMULPF00001	222	219	240	201	18	21
809	FW_pair809	FakeAnc809	FakeDesc809	SIMULPF00001	389	417	440	366	51	23
810	FW_pair810	FakeAnc810	FakeDesc810	SIMULPF00001	100	104	111	93	11	7
811	FW_pair811	FakeAnc811	FakeDesc811	SIMULPF00001	124	124	136	112	12	12
812	FW_pair812	FakeAnc812	FakeDesc812	SIMULPF00001	140	150	160	130	20	10
813	FW_pair813	FakeAnc813	FakeDesc813	SIMULPF00001	410	411	444	377	34	33
814	FW_pair814	FakeAnc814	FakeDesc814	SIMULPF00001	104	100	113	91	9	13
815	FW_pair815	FakeAnc815	FakeDesc815	SIMULPF00001	148	155	173	130	25	18
816	FW_pair816	FakeAnc816	FakeDesc816	SIMULPF00001	173	173	186	160	13	13
817	FW_pair817	FakeAnc817	FakeDesc817	SIMULPF00001	46	46	51	41	5	5
818	FW_pair818	FakeAnc818	FakeDesc818	SIMULPF00001	126	126	137	115	11	11
819	FW_pair819	FakeAnc819	FakeDesc819	SIMULPF00001	23	22	23	22	0	1
820	FW_pair820	FakeAnc820	FakeDesc820	SIMULPF00001	87	85	93	79	6	8
821	FW_pair821	FakeAnc821	FakeDesc821	SIMULPF00001	26	32	32	26	6	0
822	FW_pair822	FakeAnc822	FakeDesc822	SIMULPF00001	93	99	104	88	11	5
823	FW_pair823	FakeAnc823	FakeDesc823	SIMULPF00001	91	95	101	85	10	6
824	FW_pair824	FakeAnc824	FakeDesc824	SIMULPF00001	184	188	199	173	15	11
825	FW_pair825	FakeAnc825	FakeDesc825	SIMULPF00001	169	165	181	153	12	16
826	FW_pair826	FakeAnc826	FakeDesc826	SIMULPF00001	37	35	38	34	1	3
827	FW_pair827	FakeAnc827	FakeDesc827	SIMULPF00001	348	332	374	306	26	42
828	FW_pair828	FakeAnc828	FakeDesc828	SIMULPF00001	542	551	601	492	59	50
829	FW_pair829	FakeAnc829	FakeDesc829	SIMULPF00001	28	26	29	25	1	3
830	FW_pair830	FakeAnc830	FakeDesc830	SIMULPF00001	545	557	599	503	54	42
831	FW_pair831	FakeAnc831	FakeDesc831	SIMULPF00001	134	135	148	121	14	13
832	FW_pair832	FakeAnc832	FakeDesc832	SIMULPF00001	85	89	96	78	11	7
833	FW_pair833	FakeAnc833	FakeDesc833	SIMULPF00001	120	119	130	109	10	11
834	FW_pair834	FakeAnc834	FakeDesc834	SIMULPF00001	94	88	101	81	7	13
835	FW_pair835	FakeAnc835	FakeDesc835	SIMULPF00001	412	394	439	367	27	45
836	FW_pair836	FakeAnc836	FakeDesc836	SIMULPF00001	775	784	845	714	70	61
837	FW_pair837	FakeAnc837	FakeDesc837	SIMULPF00001	498	505	547	456	49	42
838	FW_pair838	FakeAnc838	FakeDesc838	SIMULPF00001	404	409	446	367	42	37
839	FW_pair839	FakeAnc839	FakeDesc839	SIMULPF00001	50	54	56	48	6	2
840	FW_pair840	FakeAnc840	FakeDesc840	SIMULPF00001	430	446	470	406	40	24
841	FW_pair841	FakeAnc841	FakeDesc841	SIMULPF00001	127	119	136	110	9	17
842	FW_pair842	FakeAnc842	FakeDesc842	SIMULPF00001	4	4	4	4	0	0
843	FW_pair843	FakeAnc843	FakeDesc843	SIMULPF00001	421	406	444	383	23	38
844	FW_pair844	FakeAnc844	FakeDesc844	SIMULPF00001	424	422	464	382	40	42
845	FW_pair845	FakeAnc845	FakeDesc845	SIMULPF00001	4	3	4	3	0	1
846	FW_pair846	FakeAnc846	FakeDesc846	SIMULPF00001	61	65	72	54	11	7
847	FW_pair847	FakeAnc847	FakeDesc847	SIMULPF00001	182	181	197	166	15	16
848	FW_pair848	FakeAnc848	FakeDesc848	SIMULPF00001	178	185	198	165	20	13
849	FW_pair849	FakeAnc849	FakeDesc849	SIMULPF00001	811	799	882	728	71	83
850	FW_pair850	FakeAnc850	FakeDesc850	SIMULPF00001	25	23	26	22	1	3
851	FW_pair851	FakeAnc851	FakeDesc851	SIMULPF00001	316	333	355	294	39	22
852	FW_pair852	FakeAnc852	FakeDesc852	SIMULPF00001	128	127	135	120	7	8
853	FW_pair853	FakeAnc853	FakeDesc853	SIMULPF00001	227	228	249	206	22	21
854	FW_pair854	FakeAnc854	FakeDesc854	SIMULPF00001	230	230	251	209	21	21
855	FW_pair855	FakeAnc855	FakeDesc855	SIMULPF00001	98	103	109	92	11	6
856	FW_pair856	FakeAnc856	FakeDesc856	SIMULPF00001	411	412	449	374	38	37
857	FW_pair857	FakeAnc857	FakeDesc857	SIMULPF00001	177	156	184	149	7	28
858	FW_pair858	FakeAnc858	FakeDesc858	SIMULPF00001	159	152	166	145	7	14
859	FW_pair859	FakeAnc859	FakeDesc859	SIMULPF00001	29	29	31	27	2	2
860	FW_pair860	FakeAnc860	FakeDesc860	SIMULPF00001	117	113	128	102	11	15
861	FW_pair861	FakeAnc861	FakeDesc861	SIMULPF00001	322	318	343	297	21	25
862	FW_pair862	FakeAnc862	FakeDesc862	SIMULPF00001	158	150	168	140	10	18
863	FW_pair863	FakeAnc863	FakeDesc863	SIMULPF00001	30	36	37	29	7	1
864	FW_pair864	FakeAnc864	FakeDesc864	SIMULPF00001	62	64	69	57	7	5
865	FW_pair865	FakeAnc865	FakeDesc865	SIMULPF00001	276	285	309	252	33	24
866	FW_pair866	FakeAnc866	FakeDesc866	SIMULPF00001	294	293	317	270	23	24
867	FW_pair867	FakeAnc867	FakeDesc867	SIMULPF00001	133	140	149	124	16	9
868	FW_pair868	FakeAnc868	FakeDesc868	SIMULPF00001	50	45	52	43	2	7
869	FW_pair869	FakeAnc869	FakeDesc869	SIMULPF00001	153	149	169	133	16	20
870	FW_pair870	FakeAnc870	FakeDesc870	SIMULPF00001	319	315	348	286	29	33
871	FW_pair871	FakeAnc871	FakeDesc871	SIMULPF00001	279	275	309	245	30	34
872	FW_pair872	FakeAnc872	FakeDesc872	SIMULPF00001	4	4	4	4	0	0
873	FW_pair873	FakeAnc873	FakeDesc873	SIMULPF00001	219	223	241	201	22	18
874	FW_pair874	FakeAnc874	FakeDesc874	SIMULPF00001	42	46	48	40	6	2
875	FW_pair875	FakeAnc875	FakeDesc875	SIMULPF00001	232	227	252	207	20	25
876	FW_pair876	FakeAnc876	FakeDesc876	SIMULPF00001	16	15	18	13	2	3
877	FW_pair877	FakeAnc877	FakeDesc877	SIMULPF00001	164	152	170	146	6	18
878	FW_pair878	FakeAnc878	FakeDesc878	SIMULPF00001	370	373	409	334	39	36
879	FW_pair879	FakeAnc879	FakeDesc879	SIMULPF00001	162	154	168	148	6	14
880	FW_pair880	FakeAnc880	FakeDesc880	SIMULPF00001	159	163	176	146	17	13
881	FW_pair881	FakeAnc881	FakeDesc881	SIMULPF00001	11	11	12	10	1	1
882	FW_pair882	FakeAnc882	FakeDesc882	SIMULPF00001	339	334	363	310	24	29
883	FW_pair883	FakeAnc883	FakeDesc883	SIMULPF00001	242	252	264	230	22	12
884	FW_pair884	FakeAnc884	FakeDesc884	SIMULPF00001	233	237	256	214	23	19
885	FW_pair885	FakeAnc885	FakeDesc885	SIMULPF00001	32	32	34	30	2	2
886	FW_pair886	FakeAnc886	FakeDesc886	SIMULPF00001	84	86	93	77	9	7
887	FW_pair887	FakeAnc887	FakeDesc887	SIMULPF00001	804	795	863	736	59	68
888	FW_pair888	FakeAnc888	FakeDesc888	SIMULPF00001	219	219	240	198	21	21
889	FW_pair889	FakeAnc889	FakeDesc889	SIMULPF00001	472	470	511	431	39	41
890	FW_pair890	FakeAnc890	FakeDesc890	SIMULPF00001	233	235	260	208	27	25
891	FW_pair891	FakeAnc891	FakeDesc891	SIMULPF00001	83	85	88	80	5	3
892	FW_pair892	FakeAnc892	FakeDesc892	SIMULPF00001	31	35	36	30	5	1
893	FW_pair893	FakeAnc893	FakeDesc893	SIMULPF00001	6	4	6	4	0	2
894	FW_pair894	FakeAnc894	FakeDesc894	SIMULPF00001	394	385	426	353	32	41
895	FW_pair895	FakeAnc895	FakeDesc895	SIMULPF00001	144	148	158	134	14	10
896	FW_pair896	FakeAnc896	FakeDesc896	SIMULPF00001	148	132	149	131	1	17
897	FW_pair897	FakeAnc897	FakeDesc897	SIMULPF00001	144	150	162	132	18	12
898	FW_pair898	FakeAnc898	FakeDesc898	SIMULPF00001	24	22	24	22	0	2
899	FW_pair899	FakeAnc899	FakeDesc899	SIMULPF00001	70	60	71	59	1	11
900	FW_pair900	FakeAnc900	FakeDesc900	SIMULPF00001	531	513	581	463	50	68
901	FW_pair901	FakeAnc901	FakeDesc901	SIMULPF00001	90	89	99	80	9	10
902	FW_pair902	FakeAnc902	FakeDesc902	SIMULPF00001	143	152	158	137	15	6
903	FW_pair903	FakeAnc903	FakeDesc903	SIMULPF00001	106	107	118	95	12	11
904	FW_pair904	FakeAnc904	FakeDesc904	SIMULPF00001	38	42	45	35	7	3
905	FW_pair905	FakeAnc905	FakeDesc905	SIMULPF00001	136	129	143	122	7	14
906	FW_pair906	FakeAnc906	FakeDesc906	SIMULPF00001	194	186	207	173	13	21
907	FW_pair907	FakeAnc907	FakeDesc907	SIMULPF00001	46	56	58	44	12	2
908	FW_pair908	FakeAnc908	FakeDesc908	SIMULPF00001	104	108	120	92	16	12
909	FW_pair909	FakeAnc909	FakeDesc909	SIMULPF00001	550	547	602	495	52	55
910	FW_pair910	FakeAnc910	FakeDesc910	SIMULPF00001	94	89	98	85	4	9
911	FW_pair911	FakeAnc911	FakeDesc911	SIMULPF00001	234	234	259	209	25	25
912	FW_pair912	FakeAnc912	FakeDesc912	SIMULPF00001	667	630	709	588	42	79
913	FW_pair913	FakeAnc913	FakeDesc913	SIMULPF00001	728	710	785	653	57	75
914	FW_pair914	FakeAnc914	FakeDesc914	SIMULPF00001	392	396	435	353	43	39
915	FW_pair915	FakeAnc915	FakeDesc915	SIMULPF00001	126	114	130	110	4	16
916	FW_pair916	FakeAnc916	FakeDesc916	SIMULPF00001	109	116	119	106	10	3
917	FW_pair917	FakeAnc917	FakeDesc917	SIMULPF00001	182	186	197	171	15	11
918	FW_pair918	FakeAnc918	FakeDesc918	SIMULPF00001	24	21	25	20	1	4
919	FW_pair919	FakeAnc919	FakeDesc919	SIMULPF00001	293	302	323	272	30	21
920	FW_pair920	FakeAnc920	FakeDesc920	SIMULPF00001	254	265	284	235	30	19
921	FW_pair921	FakeAnc921	FakeDesc921	SIMULPF00001	59	58	66	51	7	8
922	FW_pair922	FakeAnc922	FakeDesc922	SIMULPF00001	94	92	99	87	5	7
923	FW_pair923	FakeAnc923	FakeDesc923	SIMULPF00001	925	917	995	847	70	78
924	FW_pair924	FakeAnc924	FakeDesc924	SIMULPF00001	558	564	605	517	47	41
925	FW_pair925	FakeAnc925	FakeDesc925	SIMULPF00001	276	272	289	259	13	17
926	FW_pair926	FakeAnc926	FakeDesc926	SIMULPF00001	1	1	1	1	0	0
927	FW_pair927	FakeAnc927	FakeDesc927	SIMULPF00001	284	274	296	262	12	22
928	FW_pair928	FakeAnc928	FakeDesc928	SIMULPF00001	319	316	340	295	21	24
929	FW_pair929	FakeAnc929	FakeDesc929	SIMULPF00001	411	429	466	374	55	37
930	FW_pair930	FakeAnc930	FakeDesc930	SIMULPF00001	42	39	45	36	3	6
931	FW_pair931	FakeAnc931	FakeDesc931	SIMULPF00001	153	144	159	138	6	15
932	FW_pair932	FakeAnc932	FakeDesc932	SIMULPF00001	157	151	172	136	15	21
933	FW_pair933	FakeAnc933	FakeDesc933	SIMULPF00001	238	236	263	211	25	27
934	FW_pair934	FakeAnc934	FakeDesc934	SIMULPF00001	500	488	548	440	48	60
935	FW_pair935	FakeAnc935	FakeDesc935	SIMULPF00001	123	121	135	109	12	14
936	FW_pair936	FakeAnc936	FakeDesc936	SIMULPF00001	78	84	89	73	11	5
937	FW_pair937	FakeAnc937	FakeDesc937	SIMULPF00001	477	490	534	433	57	44
938	FW_pair938	FakeAnc938	FakeDesc938	SIMULPF00001	151	145	163	133	12	18
939	FW_pair939	FakeAnc939	FakeDesc939	SIMULPF00001	193	200	214	179	21	14
940	FW_pair940	FakeAnc940	FakeDesc940	SIMULPF00001	251	240	265	226	14	25
941	FW_pair941	FakeAnc941	FakeDesc941	SIMULPF00001	459	450	489	420	30	39
942	FW_pair942	FakeAnc942	FakeDesc942	SIMULPF00001	36	39	43	32	7	4
943	FW_pair943	FakeAnc943	FakeDesc943	SIMULPF00001	563	570	619	514	56	49
944	FW_pair944	FakeAnc944	FakeDesc944	SIMULPF00001	596	580	649	527	53	69
945	FW_pair945	FakeAnc945	FakeDesc945	SIMULPF00001	144	152	160	136	16	8
946	FW_pair946	FakeAnc946	FakeDesc946	SIMULPF00001	432	416	463	385	31	47
947	FW_pair947	FakeAnc947	FakeDesc947	SIMULPF00001	508	512	554	466	46	42
948	FW_pair948	FakeAnc948	FakeDesc948	SIMULPF00001	103	104	109	98	6	5
949	FW_pair949	FakeAnc949	FakeDesc949	SIMULPF00001	119	121	131	109	12	10
950	FW_pair950	FakeAnc950	FakeDesc950	SIMULPF00001	159	154	166	147	7	12
951	FW_pair951	FakeAnc951	FakeDesc951	SIMULPF00001	137	141	154	124	17	13
952	FW_pair952	FakeAnc952	FakeDesc952	SIMULPF00001	36	40	41	35	5	1
953	FW_pair953	FakeAnc953	FakeDesc953	SIMULPF00001	46	46	48	44	2	2
954	FW_pair954	FakeAnc954	FakeDesc954	SIMULPF00001	172	169	186	155	14	17
955	FW_pair955	FakeAnc955	FakeDesc955	SIMULPF00001	383	392	422	353	39	30
956	FW_pair956	FakeAnc956	FakeDesc956	SIMULPF00001	218	222	240	200	22	18
957	FW_pair957	FakeAnc957	FakeDesc957	SIMULPF00001	495	487	538	444	43	51
958	FW_pair958	FakeAnc958	FakeDesc958	SIMULPF00001	381	402	434	349	53	32
959	FW_pair959	FakeAnc959	FakeDesc959	SIMULPF00001	129	126	138	117	9	12
960	FW_pair960	FakeAnc960	FakeDesc960	SIMULPF00001	17	17	18	16	1	1
961	FW_pair961	FakeAnc961	FakeDesc961	SIMULPF00001	11	7	11	7	0	4
962	FW_pair962	FakeAnc962	FakeDesc962	SIMULPF00001	9	6	10	5	1	4
963	FW_pair963	FakeAnc963	FakeDesc963	SIMULPF00001	199	187	211	175	12	24
964	FW_pair964	FakeAnc964	FakeDesc964	SIMULPF00001	118	121	125	114	7	4
965	FW_pair965	FakeAnc965	FakeDesc965	SIMULPF00001	309	312	332	289	23	20
966	FW_pair966	FakeAnc966	FakeDesc966	SIMULPF00001	746	743	811	678	65	68
967	FW_pair967	FakeAnc967	FakeDesc967	SIMULPF00001	837	811	901	747	64	90
968	FW_pair968	FakeAnc968	FakeDesc968	SIMULPF00001	40	42	46	36	6	4
969	FW_pair969	FakeAnc969	FakeDesc969	SIMULPF00001	432	441	480	393	48	39
970	FW_pair970	FakeAnc970	FakeDesc970	SIMULPF00001	413	406	451	368	38	45
971	FW_pair971	FakeAnc971	FakeDesc971	SIMULPF00001	108	109	120	97	12	11
972	FW_pair972	FakeAnc972	FakeDesc972	SIMULPF00001	24	22	24	22	0	2
973	FW_pair973	FakeAnc973	FakeDesc973	SIMULPF00001	103	103	111	95	8	8
974	FW_pair974	FakeAnc974	FakeDesc974	SIMULPF00001	250	241	267	224	17	26
975	FW_pair975	FakeAnc975	FakeDesc975	SIMULPF00001	270	261	293	238	23	32
976	FW_pair976	FakeAnc976	FakeDesc976	SIMULPF00001	30	30	33	27	3	3
977	FW_pair977	FakeAnc977	FakeDesc977	SIMULPF00001	121	124	138	107	17	14
978	FW_pair978	FakeAnc978	FakeDesc978	SIMULPF00001	296	291	321	266	25	30
979	FW_pair979	FakeAnc979	FakeDesc979	SIMULPF00001	97	105	109	93	12	4
980	FW_pair980	FakeAnc980	FakeDesc980	SIMULPF00001	410	410	447	373	37	37
981	FW_pair981	FakeAnc981	FakeDesc981	SIMULPF00001	78	83	89	72	11	6
982	FW_pair982	FakeAnc982	FakeDesc982	SIMULPF00001	143	143	156	130	13	13
983	FW_pair983	FakeAnc983	FakeDesc983	SIMULPF00001	12	13	13	12	1	0
984	FW_pair984	FakeAnc984	FakeDesc984	SIMULPF00001	99	99	107	91	8	8
985	FW_pair985	FakeAnc985	FakeDesc985	SIMULPF00001	36	32	36	32	0	4
986	FW_pair986	FakeAnc986	FakeDesc986	SIMULPF00001	34	35	41	28	7	6
987	FW_pair987	FakeAnc987	FakeDesc987	SIMULPF00001	708	701	779	630	71	78
988	FW_pair988	FakeAnc988	FakeDesc988	SIMULPF00001	313	323	341	295	28	18
989	FW_pair989	FakeAnc989	FakeDesc989	SIMULPF00001	13	12	13	12	0	1
990	FW_pair990	FakeAnc990	FakeDesc990	SIMULPF00001	342	317	358	301	16	41
991	FW_pair991	FakeAnc991	FakeDesc991	SIMULPF00001	571	578	622	527	51	44
992	FW_pair992	FakeAnc992	FakeDesc992	SIMULPF00001	76	75	83	68	7	8
993	FW_pair993	FakeAnc993	FakeDesc993	SIMULPF00001	152	157	168	141	16	11
994	FW_pair994	FakeAnc994	FakeDesc994	SIMULPF00001	58	61	68	51	10	7
995	FW_pair995	FakeAnc995	FakeDesc995	SIMULPF00001	182	186	201	167	19	15
996	FW_pair996	FakeAnc996	FakeDesc996	SIMULPF00001	112	111	122	101	10	11
997	FW_pair997	FakeAnc997	FakeDesc997	SIMULPF00001	70	75	79	66	9	4
998	FW_pair998	FakeAnc998	FakeDesc998	SIMULPF00001	35	34	36	33	1	2
999	FW_pair999	FakeAnc999	FakeDesc999	SIMULPF00001	436	440	487	389	51	47
1000	FW_pair1000	FakeAnc1000	FakeDesc1000	SIMULPF00001	443	455	499	399	56	44
1001	FW_pair1001	FakeAnc1001	FakeDesc1001	SIMULPF00001	24	26	28	22	4	2
1002	FW_pair1002	FakeAnc1002	FakeDesc1002	SIMULPF00001	335	361	385	311	50	24
1003	FW_pair1003	FakeAnc1003	FakeDesc1003	SIMULPF00001	67	60	70	57	3	10
1004	FW_pair1004	FakeAnc1004	FakeDesc1004	SIMULPF00001	157	160	178	139	21	18
1005	FW_pair1005	FakeAnc1005	FakeDesc1005	SIMULPF00001	704	690	764	630	60	74
1006	FW_pair1006	FakeAnc1006	FakeDesc1006	SIMULPF00001	410	413	453	370	43	40
1007	FW_pair1007	FakeAnc1007	FakeDesc1007	SIMULPF00001	217	214	238	193	21	24
1008	FW_pair1008	FakeAnc1008	FakeDesc1008	SIMULPF00001	276	287	302	261	26	15
1009	FW_pair1009	FakeAnc1009	FakeDesc1009	SIMULPF00001	95	88	95	88	0	7
1010	FW_pair1010	FakeAnc1010	FakeDesc1010	SIMULPF00001	47	47	50	44	3	3
1011	FW_pair1011	FakeAnc1011	FakeDesc1011	SIMULPF00001	302	312	336	278	34	24
1012	FW_pair1012	FakeAnc1012	FakeDesc1012	SIMULPF00001	21	24	24	21	3	0
1013	FW_pair1013	FakeAnc1013	FakeDesc1013	SIMULPF00001	34	34	38	30	4	4
1014	FW_pair1014	FakeAnc1014	FakeDesc1014	SIMULPF00001	40	41	44	37	4	3
1015	FW_pair1015	FakeAnc1015	FakeDesc1015	SIMULPF00001	254	241	269	226	15	28
1016	FW_pair1016	FakeAnc1016	FakeDesc1016	SIMULPF00001	266	251	283	234	17	32
1017	FW_pair1017	FakeAnc1017	FakeDesc1017	SIMULPF00001	686	711	763	634	77	52
1018	FW_pair1018	FakeAnc1018	FakeDesc1018	SIMULPF00001	453	458	497	414	44	39
1019	FW_pair1019	FakeAnc1019	FakeDesc1019	SIMULPF00001	49	54	59	44	10	5
1020	FW_pair1020	FakeAnc1020	FakeDesc1020	SIMULPF00001	693	690	765	618	72	75
1021	FW_pair1021	FakeAnc1021	FakeDesc1021	SIMULPF00001	95	87	100	82	5	13
1022	FW_pair1022	FakeAnc1022	FakeDesc1022	SIMULPF00001	66	69	70	65	4	1
1023	FW_pair1023	FakeAnc1023	FakeDesc1023	SIMULPF00001	519	526	575	470	56	49
1024	FW_pair1024	FakeAnc1024	FakeDesc1024	SIMULPF00001	108	113	123	98	15	10
1025	FW_pair1025	FakeAnc1025	FakeDesc1025	SIMULPF00001	206	222	234	194	28	12
1026	FW_pair1026	FakeAnc1026	FakeDesc1026	SIMULPF00001	750	736	809	677	59	73
1027	FW_pair1027	FakeAnc1027	FakeDesc1027	SIMULPF00001	97	102	104	95	7	2
1028	FW_pair1028	FakeAnc1028	FakeDesc1028	SIMULPF00001	398	404	439	363	41	35
1029	FW_pair1029	FakeAnc1029	FakeDesc1029	SIMULPF00001	15	15	16	14	1	1
1030	FW_pair1030	FakeAnc1030	FakeDesc1030	SIMULPF00001	347	350	384	313	37	34
1031	FW_pair1031	FakeAnc1031	FakeDesc1031	SIMULPF00001	145	136	152	129	7	16
1032	FW_pair1032	FakeAnc1032	FakeDesc1032	SIMULPF00001	348	339	371	316	23	32
1033	FW_pair1033	FakeAnc1033	FakeDesc1033	SIMULPF00001	278	286	311	253	33	25
1034	FW_pair1034	FakeAnc1034	FakeDesc1034	SIMULPF00001	174	168	188	154	14	20
1035	FW_pair1035	FakeAnc1035	FakeDesc1035	SIMULPF00001	108	113	119	102	11	6
1036	FW_pair1036	FakeAnc1036	FakeDesc1036	SIMULPF00001	397	388	438	347	41	50
1037	FW_pair1037	FakeAnc1037	FakeDesc1037	SIMULPF00001	409	404	443	370	34	39
1038	FW_pair1038	FakeAnc1038	FakeDesc1038	SIMULPF00001	460	459	500	419	40	41
1039	FW_pair1039	FakeAnc1039	FakeDesc1039	SIMULPF00001	118	120	130	108	12	10
1040	FW_pair1040	FakeAnc1040	FakeDesc1040	SIMULPF00001	435	418	468	385	33	50
1041	FW_pair1041	FakeAnc1041	FakeDesc1041	SIMULPF00001	363	367	396	334	33	29
1042	FW_pair1042	FakeAnc1042	FakeDesc1042	SIMULPF00001	43	46	48	41	5	2
1043	FW_pair1043	FakeAnc1043	FakeDesc1043	SIMULPF00001	708	725	773	660	65	48
1044	FW_pair1044	FakeAnc1044	FakeDesc1044	SIMULPF00001	94	92	101	85	7	9
1045	FW_pair1045	FakeAnc1045	FakeDesc1045	SIMULPF00001	63	67	73	57	10	6
1046	FW_pair1046	FakeAnc1046	FakeDesc1046	SIMULPF00001	705	704	764	645	59	60
1047	FW_pair1047	FakeAnc1047	FakeDesc1047	SIMULPF00001	126	137	150	113	24	13
1048	FW_pair1048	FakeAnc1048	FakeDesc1048	SIMULPF00001	41	44	46	39	5	2
1049	FW_pair1049	FakeAnc1049	FakeDesc1049	SIMULPF00001	248	248	264	232	16	16
1050	FW_pair1050	FakeAnc1050	FakeDesc1050	SIMULPF00001	293	279	314	258	21	35
1051	FW_pair1051	FakeAnc1051	FakeDesc1051	SIMULPF00001	138	135	145	128	7	10
1052	FW_pair1052	FakeAnc1052	FakeDesc1052	SIMULPF00001	313	309	337	285	24	28
1053	FW_pair1053	FakeAnc1053	FakeDesc1053	SIMULPF00001	32	29	35	26	3	6
1054	FW_pair1054	FakeAnc1054	FakeDesc1054	SIMULPF00001	25	28	29	24	4	1
1055	FW_pair1055	FakeAnc1055	FakeDesc1055	SIMULPF00001	140	136	154	122	14	18
1056	FW_pair1056	FakeAnc1056	FakeDesc1056	SIMULPF00001	526	526	570	482	44	44
1057	FW_pair1057	FakeAnc1057	FakeDesc1057	SIMULPF00001	157	161	170	148	13	9
1058	FW_pair1058	FakeAnc1058	FakeDesc1058	SIMULPF00001	78	76	87	67	9	11
1059	FW_pair1059	FakeAnc1059	FakeDesc1059	SIMULPF00001	250	242	271	221	21	29
1060	FW_pair1060	FakeAnc1060	FakeDesc1060	SIMULPF00001	490	493	539	444	49	46
1061	FW_pair1061	FakeAnc1061	FakeDesc1061	SIMULPF00001	33	33	37	29	4	4
1062	FW_pair1062	FakeAnc1062	FakeDesc1062	SIMULPF00001	68	71	74	65	6	3
1063	FW_pair1063	FakeAnc1063	FakeDesc1063	SIMULPF00001	489	498	540	447	51	42
1064	FW_pair1064	FakeAnc1064	FakeDesc1064	SIMULPF00001	539	540	594	485	55	54
1065	FW_pair1065	FakeAnc1065	FakeDesc1065	SIMULPF00001	358	352	393	317	35	41
1066	FW_pair1066	FakeAnc1066	FakeDesc1066	SIMULPF00001	203	204	227	180	24	23
1067	FW_pair1067	FakeAnc1067	FakeDesc1067	SIMULPF00001	127	125	141	111	14	16
1068	FW_pair1068	FakeAnc1068	FakeDesc1068	SIMULPF00001	5	2	5	2	0	3
1069	FW_pair1069	FakeAnc1069	FakeDesc1069	SIMULPF00001	424	415	457	382	33	42
1070	FW_pair1070	FakeAnc1070	FakeDesc1070	SIMULPF00001	370	366	399	337	29	33
1071	FW_pair1071	FakeAnc1071	FakeDesc1071	SIMULPF00001	63	66	70	59	7	4
1072	FW_pair1072	FakeAnc1072	FakeDesc1072	SIMULPF00001	416	411	456	371	40	45
1073	FW_pair1073	FakeAnc1073	FakeDesc1073	SIMULPF00001	77	85	87	75	10	2
1074	FW_pair1074	FakeAnc1074	FakeDesc1074	SIMULPF00001	115	110	123	102	8	13
1075	FW_pair1075	FakeAnc1075	FakeDesc1075	SIMULPF00001	230	229	254	205	24	25
1076	FW_pair1076	FakeAnc1076	FakeDesc1076	SIMULPF00001	659	638	701	596	42	63
1077	FW_pair1077	FakeAnc1077	FakeDesc1077	SIMULPF00001	274	268	305	237	31	37
1078	FW_pair1078	FakeAnc1078	FakeDesc1078	SIMULPF00001	83	92	95	80	12	3
1079	FW_pair1079	FakeAnc1079	FakeDesc1079	SIMULPF00001	82	84	92	74	10	8
1080	FW_pair1080	FakeAnc1080	FakeDesc1080	SIMULPF00001	18	17	18	17	0	1
1081	FW_pair1081	FakeAnc1081	FakeDesc1081	SIMULPF00001	45	43	45	43	0	2
1082	FW_pair1082	FakeAnc1082	FakeDesc1082	SIMULPF00001	17	12	17	12	0	5
1083	FW_pair1083	FakeAnc1083	FakeDesc1083	SIMULPF00001	536	533	572	497	36	39
1084	FW_pair1084	FakeAnc1084	FakeDesc1084	SIMULPF00001	299	290	316	273	17	26
1085	FW_pair1085	FakeAnc1085	FakeDesc1085	SIMULPF00001	171	175	189	157	18	14
1086	FW_pair1086	FakeAnc1086	FakeDesc1086	SIMULPF00001	523	521	569	475	46	48
1087	FW_pair1087	FakeAnc1087	FakeDesc1087	SIMULPF00001	247	237	263	221	16	26
1088	FW_pair1088	FakeAnc1088	FakeDesc1088	SIMULPF00001	323	311	352	282	29	41
1089	FW_pair1089	FakeAnc1089	FakeDesc1089	SIMULPF00001	23	25	27	21	4	2
1090	FW_pair1090	FakeAnc1090	FakeDesc1090	SIMULPF00001	335	334	364	305	29	30
1091	FW_pair1091	FakeAnc1091	FakeDesc1091	SIMULPF00001	162	158	168	152	6	10
1092	FW_pair1092	FakeAnc1092	FakeDesc1092	SIMULPF00001	121	127	135	113	14	8
1093	FW_pair1093	FakeAnc1093	FakeDesc1093	SIMULPF00001	140	141	153	128	13	12
1094	FW_pair1094	FakeAnc1094	FakeDesc1094	SIMULPF00001	110	109	122	97	12	13
1095	FW_pair1095	FakeAnc1095	FakeDesc1095	SIMULPF00001	134	133	142	125	8	9
1096	FW_pair1096	FakeAnc1096	FakeDesc1096	SIMULPF00001	430	427	476	381	46	49
1097	FW_pair1097	FakeAnc1097	FakeDesc1097	SIMULPF00001	168	174	194	148	26	20
1098	FW_pair1098	FakeAnc1098	FakeDesc1098	SIMULPF00001	205	202	227	180	22	25
1099	FW_pair1099	FakeAnc1099	FakeDesc1099	SIMULPF00001	834	843	931	746	97	88
1100	FW_pair1100	FakeAnc1100	FakeDesc1100	SIMULPF00001	751	747	826	672	75	79
1101	FW_pair1101	FakeAnc1101	FakeDesc1101	SIMULPF00001	28	35	39	24	11	4
1102	FW_pair1102	FakeAnc1102	FakeDesc1102	SIMULPF00001	235	247	271	211	36	24
1103	FW_pair1103	FakeAnc1103	FakeDesc1103	SIMULPF00001	9	8	10	7	1	2
1104	FW_pair1104	FakeAnc1104	FakeDesc1104	SIMULPF00001	282	276	305	253	23	29
1105	FW_pair1105	FakeAnc1105	FakeDesc1105	SIMULPF00001	231	230	262	199	31	32
1106	FW_pair1106	FakeAnc1106	FakeDesc1106	SIMULPF00001	21	18	22	17	1	4
1107	FW_pair1107	FakeAnc1107	FakeDesc1107	SIMULPF00001	112	106	122	96	10	16
1108	FW_pair1108	FakeAnc1108	FakeDesc1108	SIMULPF00001	433	424	474	383	41	50
1109	FW_pair1109	FakeAnc1109	FakeDesc1109	SIMULPF00001	289	281	312	258	23	31
1110	FW_pair1110	FakeAnc1110	FakeDesc1110	SIMULPF00001	193	180	201	172	8	21
1111	FW_pair1111	FakeAnc1111	FakeDesc1111	SIMULPF00001	263	268	299	232	36	31
1112	FW_pair1112	FakeAnc1112	FakeDesc1112	SIMULPF00001	35	34	37	32	2	3
1113	FW_pair1113	FakeAnc1113	FakeDesc1113	SIMULPF00001	198	199	211	186	13	12
1114	FW_pair1114	FakeAnc1114	FakeDesc1114	SIMULPF00001	50	52	54	48	4	2
1115	FW_pair1115	FakeAnc1115	FakeDesc1115	SIMULPF00001	115	123	133	105	18	10
1116	FW_pair1116	FakeAnc1116	FakeDesc1116	SIMULPF00001	265	273	294	244	29	21
1117	FW_pair1117	FakeAnc1117	FakeDesc1117	SIMULPF00001	77	79	85	71	8	6
1118	FW_pair1118	FakeAnc1118	FakeDesc1118	SIMULPF00001	433	429	481	381	48	52
1119	FW_pair1119	FakeAnc1119	FakeDesc1119	SIMULPF00001	291	284	319	256	28	35
1120	FW_pair1120	FakeAnc1120	FakeDesc1120	SIMULPF00001	66	71	72	65	6	1
1121	FW_pair1121	FakeAnc1121	FakeDesc1121	SIMULPF00001	514	515	565	464	51	50
1122	FW_pair1122	FakeAnc1122	FakeDesc1122	SIMULPF00001	333	337	370	300	37	33
1123	FW_pair1123	FakeAnc1123	FakeDesc1123	SIMULPF00001	517	538	584	471	67	46
1124	FW_pair1124	FakeAnc1124	FakeDesc1124	SIMULPF00001	159	151	174	136	15	23
1125	FW_pair1125	FakeAnc1125	FakeDesc1125	SIMULPF00001	194	193	217	170	23	24
1126	FW_pair1126	FakeAnc1126	FakeDesc1126	SIMULPF00001	111	108	116	103	5	8
1127	FW_pair1127	FakeAnc1127	FakeDesc1127	SIMULPF00001	35	30	38	27	3	8
1128	FW_pair1128	FakeAnc1128	FakeDesc1128	SIMULPF00001	212	195	232	175	20	37
1129	FW_pair1129	FakeAnc1129	FakeDesc1129	SIMULPF00001	372	368	403	337	31	35
1130	FW_pair1130	FakeAnc1130	FakeDesc1130	SIMULPF00001	546	539	589	496	43	50
1131	FW_pair1131	FakeAnc1131	FakeDesc1131	SIMULPF00001	110	117	128	99	18	11
1132	FW_pair1132	FakeAnc1132	FakeDesc1132	SIMULPF00001	875	873	947	801	72	74
1133	FW_pair1133	FakeAnc1133	FakeDesc1133	SIMULPF00001	21	22	26	17	5	4
1134	FW_pair1134	FakeAnc1134	FakeDesc1134	SIMULPF00001	193	192	214	171	21	22
1135	FW_pair1135	FakeAnc1135	FakeDesc1135	SIMULPF00001	148	148	160	136	12	12
1136	FW_pair1136	FakeAnc1136	FakeDesc1136	SIMULPF00001	332	324	349	307	17	25
1137	FW_pair1137	FakeAnc1137	FakeDesc1137	SIMULPF00001	730	761	814	677	84	53
1138	FW_pair1138	FakeAnc1138	FakeDesc1138	SIMULPF00001	1	1	1	1	0	0
1139	FW_pair1139	FakeAnc1139	FakeDesc1139	SIMULPF00001	261	259	283	237	22	24
1140	FW_pair1140	FakeAnc1140	FakeDesc1140	SIMULPF00001	444	474	504	414	60	30
1141	FW_pair1141	FakeAnc1141	FakeDesc1141	SIMULPF00001	728	740	818	650	90	78
1142	FW_pair1142	FakeAnc1142	FakeDesc1142	SIMULPF00001	339	341	382	298	43	41
1143	FW_pair1143	FakeAnc1143	FakeDesc1143	SIMULPF00001	2	5	5	2	3	0
1144	FW_pair1144	FakeAnc1144	FakeDesc1144	SIMULPF00001	60	54	62	52	2	8
1145	FW_pair1145	FakeAnc1145	FakeDesc1145	SIMULPF00001	229	229	254	204	25	25
1146	FW_pair1146	FakeAnc1146	FakeDesc1146	SIMULPF00001	675	677	737	615	62	60
1147	FW_pair1147	FakeAnc1147	FakeDesc1147	SIMULPF00001	472	465	508	429	36	43
1148	FW_pair1148	FakeAnc1148	FakeDesc1148	SIMULPF00001	487	484	535	436	48	51
1149	FW_pair1149	FakeAnc1149	FakeDesc1149	SIMULPF00001	82	79	89	72	7	10
1150	FW_pair1150	FakeAnc1150	FakeDesc1150	SIMULPF00001	231	235	253	213	22	18
1151	FW_pair1151	FakeAnc1151	FakeDesc1151	SIMULPF00001	536	517	568	485	32	51
1152	FW_pair1152	FakeAnc1152	FakeDesc1152	SIMULPF00001	4	7	7	4	3	0
1153	FW_pair1153	FakeAnc1153	FakeDesc1153	SIMULPF00001	169	163	179	153	10	16
1154	FW_pair1154	FakeAnc1154	FakeDesc1154	SIMULPF00001	51	54	58	47	7	4
1155	FW_pair1155	FakeAnc1155	FakeDesc1155	SIMULPF00001	21	23	25	19	4	2
1156	FW_pair1156	FakeAnc1156	FakeDesc1156	SIMULPF00001	67	59	68	58	1	9
1157	FW_pair1157	FakeAnc1157	FakeDesc1157	SIMULPF00001	32	30	32	30	0	2
1158	FW_pair1158	FakeAnc1158	FakeDesc1158	SIMULPF00001	204	198	215	187	11	17
1159	FW_pair1159	FakeAnc1159	FakeDesc1159	SIMULPF00001	159	151	167	143	8	16
1160	FW_pair1160	FakeAnc1160	FakeDesc1160	SIMULPF00001	141	144	152	133	11	8
1161	FW_pair1161	FakeAnc1161	FakeDesc1161	SIMULPF00001	77	73	81	69	4	8
1162	FW_pair1162	FakeAnc1162	FakeDesc1162	SIMULPF00001	617	617	659	575	42	42
1163	FW_pair1163	FakeAnc1163	FakeDesc1163	SIMULPF00001	135	133	146	122	11	13
1164	FW_pair1164	FakeAnc1164	FakeDesc1164	SIMULPF00001	145	156	161	140	16	5
1165	FW_pair1165	FakeAnc1165	FakeDesc1165	SIMULPF00001	130	124	137	117	7	13
1166	FW_pair1166	FakeAnc1166	FakeDesc1166	SIMULPF00001	632	615	679	568	47	64
1167	FW_pair1167	FakeAnc1167	FakeDesc1167	SIMULPF00001	271	288	303	256	32	15
1168	FW_pair1168	FakeAnc1168	FakeDesc1168	SIMULPF00001	365	368	405	328	40	37
1169	FW_pair1169	FakeAnc1169	FakeDesc1169	SIMULPF00001	68	72	79	61	11	7
1170	FW_pair1170	FakeAnc1170	FakeDesc1170	SIMULPF00001	38	38	39	37	1	1
1171	FW_pair1171	FakeAnc1171	FakeDesc1171	SIMULPF00001	5	6	6	5	1	0
1172	FW_pair1172	FakeAnc1172	FakeDesc1172	SIMULPF00001	204	207	223	188	19	16
1173	FW_pair1173	FakeAnc1173	FakeDesc1173	SIMULPF00001	164	177	187	154	23	10
1174	FW_pair1174	FakeAnc1174	FakeDesc1174	SIMULPF00001	202	214	229	187	27	15
1175	FW_pair1175	FakeAnc1175	FakeDesc1175	SIMULPF00001	189	199	212	176	23	13
1176	FW_pair1176	FakeAnc1176	FakeDesc1176	SIMULPF00001	36	43	45	34	9	2
1177	FW_pair1177	FakeAnc1177	FakeDesc1177	SIMULPF00001	250	253	273	230	23	20
1178	FW_pair1178	FakeAnc1178	FakeDesc1178	SIMULPF00001	198	207	218	187	20	11
1179	FW_pair1179	FakeAnc1179	FakeDesc1179	SIMULPF00001	247	251	277	221	30	26
1180	FW_pair1180	FakeAnc1180	FakeDesc1180	SIMULPF00001	63	66	68	61	5	2
1181	FW_pair1181	FakeAnc1181	FakeDesc1181	SIMULPF00001	705	694	761	638	56	67
1182	FW_pair1182	FakeAnc1182	FakeDesc1182	SIMULPF00001	78	81	87	72	9	6
1183	FW_pair1183	FakeAnc1183	FakeDesc1183	SIMULPF00001	43	41	47	37	4	6
1184	FW_pair1184	FakeAnc1184	FakeDesc1184	SIMULPF00001	36	29	36	29	0	7
1185	FW_pair1185	FakeAnc1185	FakeDesc1185	SIMULPF00001	141	134	149	126	8	15
1186	FW_pair1186	FakeAnc1186	FakeDesc1186	SIMULPF00001	223	241	253	211	30	12
1187	FW_pair1187	FakeAnc1187	FakeDesc1187	SIMULPF00001	238	243	263	218	25	20
1188	FW_pair1188	FakeAnc1188	FakeDesc1188	SIMULPF00001	60	54	64	50	4	10
1189	FW_pair1189	FakeAnc1189	FakeDesc1189	SIMULPF00001	69	71	76	64	7	5
1190	FW_pair1190	FakeAnc1190	FakeDesc1190	SIMULPF00001	45	44	47	42	2	3
1191	FW_pair1191	FakeAnc1191	FakeDesc1191	SIMULPF00001	50	54	57	47	7	3
1192	FW_pair1192	FakeAnc1192	FakeDesc1192	SIMULPF00001	81	84	87	78	6	3
1193	FW_pair1193	FakeAnc1193	FakeDesc1193	SIMULPF00001	75	81	88	68	13	7
1194	FW_pair1194	FakeAnc1194	FakeDesc1194	SIMULPF00001	180	175	191	164	11	16
1195	FW_pair1195	FakeAnc1195	FakeDesc1195	SIMULPF00001	80	76	91	65	11	15
1196	FW_pair1196	FakeAnc1196	FakeDesc1196	SIMULPF00001	300	289	314	275	14	25
1197	FW_pair1197	FakeAnc1197	FakeDesc1197	SIMULPF00001	193	188	209	172	16	21
1198	FW_pair1198	FakeAnc1198	FakeDesc1198	SIMULPF00001	366	366	400	332	34	34
1199	FW_pair1199	FakeAnc1199	FakeDesc1199	SIMULPF00001	97	107	110	94	13	3
1200	FW_pair1200	FakeAnc1200	FakeDesc1200	SIMULPF00001	370	368	405	333	35	37
1201	FW_pair1201	FakeAnc1201	FakeDesc1201	SIMULPF00001	37	42	45	34	8	3
1202	FW_pair1202	FakeAnc1202	FakeDesc1202	SIMULPF00001	46	42	46	42	0	4
1203	FW_pair1203	FakeAnc1203	FakeDesc1203	SIMULPF00001	11	11	12	10	1	1
1204	FW_pair1204	FakeAnc1204	FakeDesc1204	SIMULPF00001	655	626	716	565	61	90
1205	FW_pair1205	FakeAnc1205	FakeDesc1205	SIMULPF00001	24	25	26	23	2	1
1206	FW_pair1206	FakeAnc1206	FakeDesc1206	SIMULPF00001	181	182	210	153	29	28
1207	FW_pair1207	FakeAnc1207	FakeDesc1207	SIMULPF00001	102	105	117	90	15	12
1208	FW_pair1208	FakeAnc1208	FakeDesc1208	SIMULPF00001	120	111	124	107	4	13
1209	FW_pair1209	FakeAnc1209	FakeDesc1209	SIMULPF00001	75	77	84	68	9	7
1210	FW_pair1210	FakeAnc1210	FakeDesc1210	SIMULPF00001	356	328	376	308	20	48
1211	FW_pair1211	FakeAnc1211	FakeDesc1211	SIMULPF00001	98	97	105	90	7	8
1212	FW_pair1212	FakeAnc1212	FakeDesc1212	SIMULPF00001	312	303	330	285	18	27
1213	FW_pair1213	FakeAnc1213	FakeDesc1213	SIMULPF00001	50	47	52	45	2	5
1214	FW_pair1214	FakeAnc1214	FakeDesc1214	SIMULPF00001	6	6	6	6	0	0
1215	FW_pair1215	FakeAnc1215	FakeDesc1215	SIMULPF00001	636	611	699	548	63	88
1216	FW_pair1216	FakeAnc1216	FakeDesc1216	SIMULPF00001	345	346	383	308	38	37
1217	FW_pair1217	FakeAnc1217	FakeDesc1217	SIMULPF00001	664	677	724	617	60	47
1218	FW_pair1218	FakeAnc1218	FakeDesc1218	SIMULPF00001	84	84	95	73	11	11
1219	FW_pair1219	FakeAnc1219	FakeDesc1219	SIMULPF00001	144	157	164	137	20	7
1220	FW_pair1220	FakeAnc1220	FakeDesc1220	SIMULPF00001	98	96	107	87	9	11
1221	FW_pair1221	FakeAnc1221	FakeDesc1221	SIMULPF00001	395	378	424	349	29	46
1222	FW_pair1222	FakeAnc1222	FakeDesc1222	SIMULPF00001	20	19	24	15	4	5
1223	FW_pair1223	FakeAnc1223	FakeDesc1223	SIMULPF00001	510	499	544	465	34	45
1224	FW_pair1224	FakeAnc1224	FakeDesc1224	SIMULPF00001	246	222	266	202	20	44
1225	FW_pair1225	FakeAnc1225	FakeDesc1225	SIMULPF00001	8	8	8	8	0	0
1226	FW_pair1226	FakeAnc1226	FakeDesc1226	SIMULPF00001	18	16	19	15	1	3
1227	FW_pair1227	FakeAnc1227	FakeDesc1227	SIMULPF00001	159	157	181	135	22	24
1228	FW_pair1228	FakeAnc1228	FakeDesc1228	SIMULPF00001	92	83	98	77	6	15
1229	FW_pair1229	FakeAnc1229	FakeDesc1229	SIMULPF00001	181	183	199	165	18	16
1230	FW_pair1230	FakeAnc1230	FakeDesc1230	SIMULPF00001	548	560	608	500	60	48
1231	FW_pair1231	FakeAnc1231	FakeDesc1231	SIMULPF00001	51	48	56	43	5	8
1232	FW_pair1232	FakeAnc1232	FakeDesc1232	SIMULPF00001	32	27	32	27	0	5
1233	FW_pair1233	FakeAnc1233	FakeDesc1233	SIMULPF00001	275	257	287	245	12	30
1234	FW_pair1234	FakeAnc1234	FakeDesc1234	SIMULPF00001	13	17	18	12	5	1
1235	FW_pair1235	FakeAnc1235	FakeDesc1235	SIMULPF00001	54	68	68	54	14	0
1236	FW_pair1236	FakeAnc1236	FakeDesc1236	SIMULPF00001	41	42	45	38	4	3
1237	FW_pair1237	FakeAnc1237	FakeDesc1237	SIMULPF00001	33	30	33	30	0	3
1238	FW_pair1238	FakeAnc1238	FakeDesc1238	SIMULPF00001	573	574	626	521	53	52
1239	FW_pair1239	FakeAnc1239	FakeDesc1239	SIMULPF00001	117	113	124	106	7	11
1240	FW_pair1240	FakeAnc1240	FakeDesc1240	SIMULPF00001	161	163	170	154	9	7
1241	FW_pair1241	FakeAnc1241	FakeDesc1241	SIMULPF00001	196	205	220	181	24	15
1242	FW_pair1242	FakeAnc1242	FakeDesc1242	SIMULPF00001	106	107	114	99	8	7
1243	FW_pair1243	FakeAnc1243	FakeDesc1243	SIMULPF00001	180	178	198	160	18	20
1244	FW_pair1244	FakeAnc1244	FakeDesc1244	SIMULPF00001	233	240	258	215	25	18
1245	FW_pair1245	FakeAnc1245	FakeDesc1245	SIMULPF00001	46	48	49	45	3	1
1246	FW_pair1246	FakeAnc1246	FakeDesc1246	SIMULPF00001	366	369	399	336	33	30
1247	FW_pair1247	FakeAnc1247	FakeDesc1247	SIMULPF00001	731	730	792	669	61	62
1248	FW_pair1248	FakeAnc1248	FakeDesc1248	SIMULPF00001	24	22	24	22	0	2
1249	FW_pair1249	FakeAnc1249	FakeDesc1249	SIMULPF00001	104	103	111	96	7	8
1250	FW_pair1250	FakeAnc1250	FakeDesc1250	SIMULPF00001	215	217	234	198	19	17
1251	FW_pair1251	FakeAnc1251	FakeDesc1251	SIMULPF00001	151	145	161	135	10	16
1252	FW_pair1252	FakeAnc1252	FakeDesc1252	SIMULPF00001	185	180	198	167	13	18
1253	FW_pair1253	FakeAnc1253	FakeDesc1253	SIMULPF00001	59	56	64	51	5	8
1254	FW_pair1254	FakeAnc1254	FakeDesc1254	SIMULPF00001	199	199	220	178	21	21
1255	FW_pair1255	FakeAnc1255	FakeDesc1255	SIMULPF00001	104	114	126	92	22	12
1256	FW_pair1256	FakeAnc1256	FakeDesc1256	SIMULPF00001	250	243	263	230	13	20
1257	FW_pair1257	FakeAnc1257	FakeDesc1257	SIMULPF00001	407	420	455	372	48	35
1258	FW_pair1258	FakeAnc1258	FakeDesc1258	SIMULPF00001	413	409	453	369	40	44
1259	FW_pair1259	FakeAnc1259	FakeDesc1259	SIMULPF00001	257	254	274	237	17	20
1260	FW_pair1260	FakeAnc1260	FakeDesc1260	SIMULPF00001	138	137	142	133	4	5
1261	FW_pair1261	FakeAnc1261	FakeDesc1261	SIMULPF00001	141	150	155	136	14	5
1262	FW_pair1262	FakeAnc1262	FakeDesc1262	SIMULPF00001	29	27	30	26	1	3
1263	FW_pair1263	FakeAnc1263	FakeDesc1263	SIMULPF00001	425	425	476	374	51	51
1264	FW_pair1264	FakeAnc1264	FakeDesc1264	SIMULPF00001	237	237	261	213	24	24
1265	FW_pair1265	FakeAnc1265	FakeDesc1265	SIMULPF00001	396	391	434	353	38	43
1266	FW_pair1266	FakeAnc1266	FakeDesc1266	SIMULPF00001	300	292	326	266	26	34
1267	FW_pair1267	FakeAnc1267	FakeDesc1267	SIMULPF00001	34	43	43	34	9	0
1268	FW_pair1268	FakeAnc1268	FakeDesc1268	SIMULPF00001	349	350	379	320	30	29
1269	FW_pair1269	FakeAnc1269	FakeDesc1269	SIMULPF00001	39	31	43	27	4	12
1270	FW_pair1270	FakeAnc1270	FakeDesc1270	SIMULPF00001	164	148	171	141	7	23
1271	FW_pair1271	FakeAnc1271	FakeDesc1271	SIMULPF00001	226	216	235	207	9	19
1272	FW_pair1272	FakeAnc1272	FakeDesc1272	SIMULPF00001	419	424	471	372	52	47
1273	FW_pair1273	FakeAnc1273	FakeDesc1273	SIMULPF00001	41	44	45	40	4	1
1274	FW_pair1274	FakeAnc1274	FakeDesc1274	SIMULPF00001	50	49	57	42	7	8
1275	FW_pair1275	FakeAnc1275	FakeDesc1275	SIMULPF00001	198	184	205	177	7	21
1276	FW_pair1276	FakeAnc1276	FakeDesc1276	SIMULPF00001	501	490	542	449	41	52
1277	FW_pair1277	FakeAnc1277	FakeDesc1277	SIMULPF00001	62	67	70	59	8	3
1278	FW_pair1278	FakeAnc1278	FakeDesc1278	SIMULPF00001	632	607	677	562	45	70
1279	FW_pair1279	FakeAnc1279	FakeDesc1279	SIMULPF00001	252	249	271	230	19	22
1280	FW_pair1280	FakeAnc1280	FakeDesc1280	SIMULPF00001	747	735	810	672	63	75
1281	FW_pair1281	FakeAnc1281	FakeDesc1281	SIMULPF00001	439	438	479	398	40	41
1282	FW_pair1282	FakeAnc1282	FakeDesc1282	SIMULPF00001	173	167	183	157	10	16
1283	FW_pair1283	FakeAnc1283	FakeDesc1283	SIMULPF00001	104	100	112	92	8	12
1284	FW_pair1284	FakeAnc1284	FakeDesc1284	SIMULPF00001	51	57	58	50	7	1
1285	FW_pair1285	FakeAnc1285	FakeDesc1285	SIMULPF00001	614	616	685	545	71	69
1286	FW_pair1286	FakeAnc1286	FakeDesc1286	SIMULPF00001	25	26	26	25	1	0
1287	FW_pair1287	FakeAnc1287	FakeDesc1287	SIMULPF00001	115	125	130	110	15	5
1288	FW_pair1288	FakeAnc1288	FakeDesc1288	SIMULPF00001	1	1	1	1	0	0
1289	FW_pair1289	FakeAnc1289	FakeDesc1289	SIMULPF00001	95	98	105	88	10	7
1290	FW_pair1290	FakeAnc1290	FakeDesc1290	SIMULPF00001	15	16	17	14	2	1
1291	FW_pair1291	FakeAnc1291	FakeDesc1291	SIMULPF00001	496	499	542	453	46	43
1292	FW_pair1292	FakeAnc1292	FakeDesc1292	SIMULPF00001	5	2	5	2	0	3
1293	FW_pair1293	FakeAnc1293	FakeDesc1293	SIMULPF00001	23	27	28	22	5	1
1294	FW_pair1294	FakeAnc1294	FakeDesc1294	SIMULPF00001	7	7	8	6	1	1
1295	FW_pair1295	FakeAnc1295	FakeDesc1295	SIMULPF00001	91	90	103	78	12	13
1296	FW_pair1296	FakeAnc1296	FakeDesc1296	SIMULPF00001	77	76	85	68	8	9
1297	FW_pair1297	FakeAnc1297	FakeDesc1297	SIMULPF00001	391	387	422	356	31	35
1298	FW_pair1298	FakeAnc1298	FakeDesc1298	SIMULPF00001	456	449	492	413	36	43
1299	FW_pair1299	FakeAnc1299	FakeDesc1299	SIMULPF00001	89	85	94	80	5	9
1300	FW_pair1300	FakeAnc1300	FakeDesc1300	SIMULPF00001	211	209	226	194	15	17
1301	FW_pair1301	FakeAnc1301	FakeDesc1301	SIMULPF00001	12	12	12	12	0	0
1302	FW_pair1302	FakeAnc1302	FakeDesc1302	SIMULPF00001	138	142	151	129	13	9
1303	FW_pair1303	FakeAnc1303	FakeDesc1303	SIMULPF00001	374	366	402	338	28	36
1304	FW_pair1304	FakeAnc1304	FakeDesc1304	SIMULPF00001	174	174	188	160	14	14
1305	FW_pair1305	FakeAnc1305	FakeDesc1305	SIMULPF00001	455	455	504	406	49	49
1306	FW_pair1306	FakeAnc1306	FakeDesc1306	SIMULPF00001	450	448	490	408	40	42
1307	FW_pair1307	FakeAnc1307	FakeDesc1307	SIMULPF00001	111	100	115	96	4	15
1308	FW_pair1308	FakeAnc1308	FakeDesc1308	SIMULPF00001	338	335	370	303	32	35
1309	FW_pair1309	FakeAnc1309	FakeDesc1309	SIMULPF00001	186	188	213	161	27	25
1310	FW_pair1310	FakeAnc1310	FakeDesc1310	SIMULPF00001	268	279	301	246	33	22
1311	FW_pair1311	FakeAnc1311	FakeDesc1311	SIMULPF00001	153	152	172	133	19	20
1312	FW_pair1312	FakeAnc1312	FakeDesc1312	SIMULPF00001	67	69	75	61	8	6
1313	FW_pair1313	FakeAnc1313	FakeDesc1313	SIMULPF00001	12	6	13	5	1	7
1314	FW_pair1314	FakeAnc1314	FakeDesc1314	SIMULPF00001	666	666	719	613	53	53
1315	FW_pair1315	FakeAnc1315	FakeDesc1315	SIMULPF00001	363	354	394	323	31	40
1316	FW_pair1316	FakeAnc1316	FakeDesc1316	SIMULPF00001	53	55	59	49	6	4
1317	FW_pair1317	FakeAnc1317	FakeDesc1317	SIMULPF00001	451	475	502	424	51	27
1318	FW_pair1318	FakeAnc1318	FakeDesc1318	SIMULPF00001	34	31	36	29	2	5
1319	FW_pair1319	FakeAnc1319	FakeDesc1319	SIMULPF00001	152	158	170	140	18	12
1320	FW_pair1320	FakeAnc1320	FakeDesc1320	SIMULPF00001	88	79	91	76	3	12
1321	FW_pair1321	FakeAnc1321	FakeDesc1321	SIMULPF00001	467	437	496	408	29	59
1322	FW_pair1322	FakeAnc1322	FakeDesc1322	SIMULPF00001	72	71	78	65	6	7
1323	FW_pair1323	FakeAnc1323	FakeDesc1323	SIMULPF00001	354	362	389	327	35	27
1324	FW_pair1324	FakeAnc1324	FakeDesc1324	SIMULPF00001	25	27	32	20	7	5
1325	FW_pair1325	FakeAnc1325	FakeDesc1325	SIMULPF00001	287	288	319	256	32	31
1326	FW_pair1326	FakeAnc1326	FakeDesc1326	SIMULPF00001	106	106	114	98	8	8
1327	FW_pair1327	FakeAnc1327	FakeDesc1327	SIMULPF00001	122	135	141	116	19	6
1328	FW_pair1328	FakeAnc1328	FakeDesc1328	SIMULPF00001	65	64	69	60	4	5
1329	FW_pair1329	FakeAnc1329	FakeDesc1329	SIMULPF00001	484	502	530	456	46	28
1330	FW_pair1330	FakeAnc1330	FakeDesc1330	SIMULPF00001	61	58	69	50	8	11
1331	FW_pair1331	FakeAnc1331	FakeDesc1331	SIMULPF00001	287	294	314	267	27	20
1332	FW_pair1332	FakeAnc1332	FakeDesc1332	SIMULPF00001	118	108	122	104	4	14
1333	FW_pair1333	FakeAnc1333	FakeDesc1333	SIMULPF00001	26	27	29	24	3	2
1334	FW_pair1334	FakeAnc1334	FakeDesc1334	SIMULPF00001	32	32	33	31	1	1
1335	FW_pair1335	FakeAnc1335	FakeDesc1335	SIMULPF00001	128	118	139	107	11	21
1336	FW_pair1336	FakeAnc1336	FakeDesc1336	SIMULPF00001	143	146	161	128	18	15
1337	FW_pair1337	FakeAnc1337	FakeDesc1337	SIMULPF00001	21	18	22	17	1	4
1338	FW_pair1338	FakeAnc1338	FakeDesc1338	SIMULPF00001	29	28	32	25	3	4
1339	FW_pair1339	FakeAnc1339	FakeDesc1339	SIMULPF00001	293	283	316	260	23	33
1340	FW_pair1340	FakeAnc1340	FakeDesc1340	SIMULPF00001	299	281	319	261	20	38
1341	FW_pair1341	FakeAnc1341	FakeDesc1341	SIMULPF00001	274	268	292	250	18	24
1342	FW_pair1342	FakeAnc1342	FakeDesc1342	SIMULPF00001	2	1	2	1	0	1
1343	FW_pair1343	FakeAnc1343	FakeDesc1343	SIMULPF00001	309	319	343	285	34	24
1344	FW_pair1344	FakeAnc1344	FakeDesc1344	SIMULPF00001	140	143	154	129	14	11
1345	FW_pair1345	FakeAnc1345	FakeDesc1345	SIMULPF00001	93	92	103	82	10	11
1346	FW_pair1346	FakeAnc1346	FakeDesc1346	SIMULPF00001	535	525	582	478	47	57
1347	FW_pair1347	FakeAnc1347	FakeDesc1347	SIMULPF00001	176	187	200	163	24	13
1348	FW_pair1348	FakeAnc1348	FakeDesc1348	SIMULPF00001	7	6	7	6	0	1
1349	FW_pair1349	FakeAnc1349	FakeDesc1349	SIMULPF00001	55	54	56	53	1	2
1350	FW_pair1350	FakeAnc1350	FakeDesc1350	SIMULPF00001	428	420	461	387	33	41
1351	FW_pair1351	FakeAnc1351	FakeDesc1351	SIMULPF00001	204	206	218	192	14	12
1352	FW_pair1352	FakeAnc1352	FakeDesc1352	SIMULPF00001	446	441	489	398	43	48
1353	FW_pair1353	FakeAnc1353	FakeDesc1353	SIMULPF00001	354	352	389	317	35	37
1354	FW_pair1354	FakeAnc1354	FakeDesc1354	SIMULPF00001	131	132	144	119	13	12
1355	FW_pair1355	FakeAnc1355	FakeDesc1355	SIMULPF00001	180	172	190	162	10	18
1356	FW_pair1356	FakeAnc1356	FakeDesc1356	SIMULPF00001	15	21	22	14	7	1
1357	FW_pair1357	FakeAnc1357	FakeDesc1357	SIMULPF00001	102	99	109	92	7	10
1358	FW_pair1358	FakeAnc1358	FakeDesc1358	SIMULPF00001	774	813	876	711	102	63
1359	FW_pair1359	FakeAnc1359	FakeDesc1359	SIMULPF00001	87	93	105	75	18	12
1360	FW_pair1360	FakeAnc1360	FakeDesc1360	SIMULPF00001	144	143	156	131	12	13
1361	FW_pair1361	FakeAnc1361	FakeDesc1361	SIMULPF00001	311	320	353	278	42	33
1362	FW_pair1362	FakeAnc1362	FakeDesc1362	SIMULPF00001	111	106	119	98	8	13
1363	FW_pair1363	FakeAnc1363	FakeDesc1363	SIMULPF00001	65	68	73	60	8	5
1364	FW_pair1364	FakeAnc1364	FakeDesc1364	SIMULPF00001	46	54	56	44	10	2
1365	FW_pair1365	FakeAnc1365	FakeDesc1365	SIMULPF00001	286	274	307	253	21	33
1366	FW_pair1366	FakeAnc1366	FakeDesc1366	SIMULPF00001	38	40	42	36	4	2
1367	FW_pair1367	FakeAnc1367	FakeDesc1367	SIMULPF00001	69	72	78	63	9	6
1368	FW_pair1368	FakeAnc1368	FakeDesc1368	SIMULPF00001	275	270	295	250	20	25
1369	FW_pair1369	FakeAnc1369	FakeDesc1369	SIMULPF00001	101	99	107	93	6	8
1370	FW_pair1370	FakeAnc1370	FakeDesc1370	SIMULPF00001	148	150	163	135	15	13
1371	FW_pair1371	FakeAnc1371	FakeDesc1371	SIMULPF00001	327	319	358	288	31	39
1372	FW_pair1372	FakeAnc1372	FakeDesc1372	SIMULPF00001	2	3	3	2	1	0
1373	FW_pair1373	FakeAnc1373	FakeDesc1373	SIMULPF00001	197	202	220	179	23	18
1374	FW_pair1374	FakeAnc1374	FakeDesc1374	SIMULPF00001	319	313	345	287	26	32
1375	FW_pair1375	FakeAnc1375	FakeDesc1375	SIMULPF00001	131	135	141	125	10	6
1376	FW_pair1376	FakeAnc1376	FakeDesc1376	SIMULPF00001	223	230	247	206	24	17
1377	FW_pair1377	FakeAnc1377	FakeDesc1377	SIMULPF00001	45	46	47	44	2	1
1378	FW_pair1378	FakeAnc1378	FakeDesc1378	SIMULPF00001	11	13	13	11	2	0
1379	FW_pair1379	FakeAnc1379	FakeDesc1379	SIMULPF00001	167	176	189	154	22	13
1380	FW_pair1380	FakeAnc1380	FakeDesc1380	SIMULPF00001	38	42	44	36	6	2
1381	FW_pair1381	FakeAnc1381	FakeDesc1381	SIMULPF00001	903	911	987	827	84	76
1382	FW_pair1382	FakeAnc1382	FakeDesc1382	SIMULPF00001	215	204	234	185	19	30
1383	FW_pair1383	FakeAnc1383	FakeDesc1383	SIMULPF00001	204	206	228	182	24	22
1384	FW_pair1384	FakeAnc1384	FakeDesc1384	SIMULPF00001	278	262	299	241	21	37
1385	FW_pair1385	FakeAnc1385	FakeDesc1385	SIMULPF00001	696	689	750	635	54	61
1386	FW_pair1386	FakeAnc1386	FakeDesc1386	SIMULPF00001	6	7	7	6	1	0
1387	FW_pair1387	FakeAnc1387	FakeDesc1387	SIMULPF00001	14	11	14	11	0	3
1388	FW_pair1388	FakeAnc1388	FakeDesc1388	SIMULPF00001	61	64	70	55	9	6
1389	FW_pair1389	FakeAnc1389	FakeDesc1389	SIMULPF00001	256	247	275	228	19	28
1390	FW_pair1390	FakeAnc1390	FakeDesc1390	SIMULPF00001	73	68	76	65	3	8
1391	FW_pair1391	FakeAnc1391	FakeDesc1391	SIMULPF00001	381	369	410	340	29	41
1392	FW_pair1392	FakeAnc1392	FakeDesc1392	SIMULPF00001	32	33	33	32	1	0
1393	FW_pair1393	FakeAnc1393	FakeDesc1393	SIMULPF00001	435	441	470	406	35	29
1394	FW_pair1394	FakeAnc1394	FakeDesc1394	SIMULPF00001	129	120	136	113	7	16
1395	FW_pair1395	FakeAnc1395	FakeDesc1395	SIMULPF00001	21	23	24	20	3	1
1396	FW_pair1396	FakeAnc1396	FakeDesc1396	SIMULPF00001	35	39	39	35	4	0
1397	FW_pair1397	FakeAnc1397	FakeDesc1397	SIMULPF00001	52	51	60	43	8	9
1398	FW_pair1398	FakeAnc1398	FakeDesc1398	SIMULPF00001	139	130	150	119	11	20
1399	FW_pair1399	FakeAnc1399	FakeDesc1399	SIMULPF00001	28	28	31	25	3	3
1400	FW_pair1400	FakeAnc1400	FakeDesc1400	SIMULPF00001	838	857	933	762	95	76
1401	FW_pair1401	FakeAnc1401	FakeDesc1401	SIMULPF00001	12	15	15	12	3	0
1402	FW_pair1402	FakeAnc1402	FakeDesc1402	SIMULPF00001	194	197	215	176	21	18
1403	FW_pair1403	FakeAnc1403	FakeDesc1403	SIMULPF00001	518	530	570	478	52	40
1404	FW_pair1404	FakeAnc1404	FakeDesc1404	SIMULPF00001	200	202	226	176	26	24
1405	FW_pair1405	FakeAnc1405	FakeDesc1405	SIMULPF00001	847	821	913	755	66	92
1406	FW_pair1406	FakeAnc1406	FakeDesc1406	SIMULPF00001	142	132	148	126	6	16
1407	FW_pair1407	FakeAnc1407	FakeDesc1407	SIMULPF00001	55	48	60	43	5	12
1408	FW_pair1408	FakeAnc1408	FakeDesc1408	SIMULPF00001	293	291	323	261	30	32
1409	FW_pair1409	FakeAnc1409	FakeDesc1409	SIMULPF00001	86	76	90	72	4	14
1410	FW_pair1410	FakeAnc1410	FakeDesc1410	SIMULPF00001	41	44	49	36	8	5
1411	FW_pair1411	FakeAnc1411	FakeDesc1411	SIMULPF00001	268	271	302	237	34	31
1412	FW_pair1412	FakeAnc1412	FakeDesc1412	SIMULPF00001	208	224	238	194	30	14
1413	FW_pair1413	FakeAnc1413	FakeDesc1413	SIMULPF00001	658	663	744	577	86	81
1414	FW_pair1414	FakeAnc1414	FakeDesc1414	SIMULPF00001	6	4	6	4	0	2
1415	FW_pair1415	FakeAnc1415	FakeDesc1415	SIMULPF00001	170	162	182	150	12	20
1416	FW_pair1416	FakeAnc1416	FakeDesc1416	SIMULPF00001	187	175	201	161	14	26
1417	FW_pair1417	FakeAnc1417	FakeDesc1417	SIMULPF00001	37	34	39	32	2	5
1418	FW_pair1418	FakeAnc1418	FakeDesc1418	SIMULPF00001	89	87	96	80	7	9
1419	FW_pair1419	FakeAnc1419	FakeDesc1419	SIMULPF00001	153	152	165	140	12	13
1420	FW_pair1420	FakeAnc1420	FakeDesc1420	SIMULPF00001	2	2	2	2	0	0
1421	FW_pair1421	FakeAnc1421	FakeDesc1421	SIMULPF00001	14	17	17	14	3	0
1422	FW_pair1422	FakeAnc1422	FakeDesc1422	SIMULPF00001	360	366	405	321	45	39
1423	FW_pair1423	FakeAnc1423	FakeDesc1423	SIMULPF00001	131	126	140	117	9	14
1424	FW_pair1424	FakeAnc1424	FakeDesc1424	SIMULPF00001	257	273	292	238	35	19
1425	FW_pair1425	FakeAnc1425	FakeDesc1425	SIMULPF00001	83	82	87	78	4	5
1426	FW_pair1426	FakeAnc1426	FakeDesc1426	SIMULPF00001	53	47	55	45	2	8
1427	FW_pair1427	FakeAnc1427	FakeDesc1427	SIMULPF00001	303	317	339	281	36	22
1428	FW_pair1428	FakeAnc1428	FakeDesc1428	SIMULPF00001	124	126	136	114	12	10
1429	FW_pair1429	FakeAnc1429	FakeDesc1429	SIMULPF00001	250	265	281	234	31	16
1430	FW_pair1430	FakeAnc1430	FakeDesc1430	SIMULPF00001	8	9	9	8	1	0
1431	FW_pair1431	FakeAnc1431	FakeDesc1431	SIMULPF00001	46	44	51	39	5	7
1432	FW_pair1432	FakeAnc1432	FakeDesc1432	SIMULPF00001	5	3	5	3	0	2
1433	FW_pair1433	FakeAnc1433	FakeDesc1433	SIMULPF00001	31	28	32	27	1	4
1434	FW_pair1434	FakeAnc1434	FakeDesc1434	SIMULPF00001	42	48	50	40	8	2
1435	FW_pair1435	FakeAnc1435	FakeDesc1435	SIMULPF00001	56	51	58	49	2	7
1436	FW_pair1436	FakeAnc1436	FakeDesc1436	SIMULPF00001	65	66	72	59	7	6
1437	FW_pair1437	FakeAnc1437	FakeDesc1437	SIMULPF00001	186	176	202	160	16	26
1438	FW_pair1438	FakeAnc1438	FakeDesc1438	SIMULPF00001	618	620	686	552	68	66
1439	FW_pair1439	FakeAnc1439	FakeDesc1439	SIMULPF00001	191	191	211	171	20	20
1440	FW_pair1440	FakeAnc1440	FakeDesc1440	SIMULPF00001	367	382	415	334	48	33
1441	FW_pair1441	FakeAnc1441	FakeDesc1441	SIMULPF00001	505	498	555	448	50	57
1442	FW_pair1442	FakeAnc1442	FakeDesc1442	SIMULPF00001	118	116	124	110	6	8
1443	FW_pair1443	FakeAnc1443	FakeDesc1443	SIMULPF00001	103	106	116	93	13	10
1444	FW_pair1444	FakeAnc1444	FakeDesc1444	SIMULPF00001	398	375	417	356	19	42
1445	FW_pair1445	FakeAnc1445	FakeDesc1445	SIMULPF00001	67	64	71	60	4	7
1446	FW_pair1446	FakeAnc1446	FakeDesc1446	SIMULPF00001	375	382	416	341	41	34
1447	FW_pair1447	FakeAnc1447	FakeDesc1447	SIMULPF00001	342	341	382	301	40	41
1448	FW_pair1448	FakeAnc1448	FakeDesc1448	SIMULPF00001	87	84	91	80	4	7
1449	FW_pair1449	FakeAnc1449	FakeDesc1449	SIMULPF00001	718	703	763	658	45	60
1450	FW_pair1450	FakeAnc1450	FakeDesc1450	SIMULPF00001	443	448	477	414	34	29
1451	FW_pair1451	FakeAnc1451	FakeDesc1451	SIMULPF00001	86	89	97	78	11	8
1452	FW_pair1452	FakeAnc1452	FakeDesc1452	SIMULPF00001	73	71	77	67	4	6
1453	FW_pair1453	FakeAnc1453	FakeDesc1453	SIMULPF00001	257	254	280	231	23	26
1454	FW_pair1454	FakeAnc1454	FakeDesc1454	SIMULPF00001	574	574	636	512	62	62
1455	FW_pair1455	FakeAnc1455	FakeDesc1455	SIMULPF00001	340	323	366	297	26	43
1456	FW_pair1456	FakeAnc1456	FakeDesc1456	SIMULPF00001	35	38	39	34	4	1
1457	FW_pair1457	FakeAnc1457	FakeDesc1457	SIMULPF00001	119	115	124	110	5	9
1458	FW_pair1458	FakeAnc1458	FakeDesc1458	SIMULPF00001	467	481	516	432	49	35
1459	FW_pair1459	FakeAnc1459	FakeDesc1459	SIMULPF00001	112	114	128	98	16	14
1460	FW_pair1460	FakeAnc1460	FakeDesc1460	SIMULPF00001	494	498	537	455	43	39
1461	FW_pair1461	FakeAnc1461	FakeDesc1461	SIMULPF00001	42	39	44	37	2	5
1462	FW_pair1462	FakeAnc1462	FakeDesc1462	SIMULPF00001	35	34	35	34	0	1
1463	FW_pair1463	FakeAnc1463	FakeDesc1463	SIMULPF00001	220	220	242	198	22	22
1464	FW_pair1464	FakeAnc1464	FakeDesc1464	SIMULPF00001	169	165	179	155	10	14
1465	FW_pair1465	FakeAnc1465	FakeDesc1465	SIMULPF00001	153	155	170	138	17	15
1466	FW_pair1466	FakeAnc1466	FakeDesc1466	SIMULPF00001	337	325	362	300	25	37
1467	FW_pair1467	FakeAnc1467	FakeDesc1467	SIMULPF00001	302	314	342	274	40	28
1468	FW_pair1468	FakeAnc1468	FakeDesc1468	SIMULPF00001	355	350	372	333	17	22
1469	FW_pair1469	FakeAnc1469	FakeDesc1469	SIMULPF00001	58	63	66	55	8	3
1470	FW_pair1470	FakeAnc1470	FakeDesc1470	SIMULPF00001	627	613	685	555	58	72
1471	FW_pair1471	FakeAnc1471	FakeDesc1471	SIMULPF00001	96	104	109	91	13	5
1472	FW_pair1472	FakeAnc1472	FakeDesc1472	SIMULPF00001	4	3	4	3	0	1
1473	FW_pair1473	FakeAnc1473	FakeDesc1473	SIMULPF00001	349	342	373	318	24	31
1474	FW_pair1474	FakeAnc1474	FakeDesc1474	SIMULPF00001	403	409	445	367	42	36
1475	FW_pair1475	FakeAnc1475	FakeDesc1475	SIMULPF00001	180	164	188	156	8	24
1476	FW_pair1476	FakeAnc1476	FakeDesc1476	SIMULPF00001	8	8	8	8	0	0
1477	FW_pair1477	FakeAnc1477	FakeDesc1477	SIMULPF00001	211	198	227	182	16	29
1478	FW_pair1478	FakeAnc1478	FakeDesc1478	SIMULPF00001	103	101	112	92	9	11
1479	FW_pair1479	FakeAnc1479	FakeDesc1479	SIMULPF00001	242	236	256	222	14	20
1480	FW_pair1480	FakeAnc1480	FakeDesc1480	SIMULPF00001	50	48	51	47	1	3
1481	FW_pair1481	FakeAnc1481	FakeDesc1481	SIMULPF00001	205	205	222	188	17	17
1482	FW_pair1482	FakeAnc1482	FakeDesc1482	SIMULPF00001	441	441	482	400	41	41
1483	FW_pair1483	FakeAnc1483	FakeDesc1483	SIMULPF00001	111	116	122	105	11	6
1484	FW_pair1484	FakeAnc1484	FakeDesc1484	SIMULPF00001	86	90	95	81	9	5
1485	FW_pair1485	FakeAnc1485	FakeDesc1485	SIMULPF00001	528	529	571	486	43	42
1486	FW_pair1486	FakeAnc1486	FakeDesc1486	SIMULPF00001	322	310	350	282	28	40
1487	FW_pair1487	FakeAnc1487	FakeDesc1487	SIMULPF00001	194	184	202	176	8	18
1488	FW_pair1488	FakeAnc1488	FakeDesc1488	SIMULPF00001	332	313	363	282	31	50
1489	FW_pair1489	FakeAnc1489	FakeDesc1489	SIMULPF00001	14	13	17	10	3	4
1490	FW_pair1490	FakeAnc1490	FakeDesc1490	SIMULPF00001	58	56	62	52	4	6
1491	FW_pair1491	FakeAnc1491	FakeDesc1491	SIMULPF00001	17	13	17	13	0	4
1492	FW_pair1492	FakeAnc1492	FakeDesc1492	SIMULPF00001	38	36	40	34	2	4
1493	FW_pair1493	FakeAnc1493	FakeDesc1493	SIMULPF00001	181	175	194	162	13	19
1494	FW_pair1494	FakeAnc1494	FakeDesc1494	SIMULPF00001	181	192	205	168	24	13
1495	FW_pair1495	FakeAnc1495	FakeDesc1495	SIMULPF00001	5	5	5	5	0	0
1496	FW_pair1496	FakeAnc1496	FakeDesc1496	SIMULPF00001	107	113	126	94	19	13
1497	FW_pair1497	FakeAnc1497	FakeDesc1497	SIMULPF00001	385	381	422	344	37	41
1498	FW_pair1498	FakeAnc1498	FakeDesc1498	SIMULPF00001	212	200	220	192	8	20
1499	FW_pair1499	FakeAnc1499	FakeDesc1499	SIMULPF00001	123	135	144	114	21	9
1500	FW_pair1500	FakeAnc1500	FakeDesc1500	SIMULPF00001	129	138	144	123	15	6
1501	FW_pair1501	FakeAnc1501	FakeDesc1501	SIMULPF00001	304	293	324	273	20	31
1502	FW_pair1502	FakeAnc1502	FakeDesc1502	SIMULPF00001	78	74	81	71	3	7
1503	FW_pair1503	FakeAnc1503	FakeDesc1503	SIMULPF00001	24	23	24	23	0	1
1504	FW_pair1504	FakeAnc1504	FakeDesc1504	SIMULPF00001	632	646	704	574	72	58
1505	FW_pair1505	FakeAnc1505	FakeDesc1505	SIMULPF00001	65	45	66	44	1	21
1506	FW_pair1506	FakeAnc1506	FakeDesc1506	SIMULPF00001	232	234	253	213	21	19
1507	FW_pair1507	FakeAnc1507	FakeDesc1507	SIMULPF00001	516	532	572	476	56	40
1508	FW_pair1508	FakeAnc1508	FakeDesc1508	SIMULPF00001	24	22	24	22	0	2
1509	FW_pair1509	FakeAnc1509	FakeDesc1509	SIMULPF00001	109	108	116	101	7	8
1510	FW_pair1510	FakeAnc1510	FakeDesc1510	SIMULPF00001	1	1	1	1	0	0
1511	FW_pair1511	FakeAnc1511	FakeDesc1511	SIMULPF00001	324	319	347	296	23	28
1512	FW_pair1512	FakeAnc1512	FakeDesc1512	SIMULPF00001	399	389	445	343	46	56
1513	FW_pair1513	FakeAnc1513	FakeDesc1513	SIMULPF00001	766	793	852	707	86	59
1514	FW_pair1514	FakeAnc1514	FakeDesc1514	SIMULPF00001	248	251	277	222	29	26
1515	FW_pair1515	FakeAnc1515	FakeDesc1515	SIMULPF00001	246	251	268	229	22	17
1516	FW_pair1516	FakeAnc1516	FakeDesc1516	SIMULPF00001	306	313	343	276	37	30
1517	FW_pair1517	FakeAnc1517	FakeDesc1517	SIMULPF00001	56	56	59	53	3	3
1518	FW_pair1518	FakeAnc1518	FakeDesc1518	SIMULPF00001	235	236	258	213	23	22
1519	FW_pair1519	FakeAnc1519	FakeDesc1519	SIMULPF00001	29	28	32	25	3	4
1520	FW_pair1520	FakeAnc1520	FakeDesc1520	SIMULPF00001	31	29	33	27	2	4
1521	FW_pair1521	FakeAnc1521	FakeDesc1521	SIMULPF00001	247	235	264	218	17	29
1522	FW_pair1522	FakeAnc1522	FakeDesc1522	SIMULPF00001	34	35	36	33	2	1
1523	FW_pair1523	FakeAnc1523	FakeDesc1523	SIMULPF00001	1	1	1	1	0	0
1524	FW_pair1524	FakeAnc1524	FakeDesc1524	SIMULPF00001	39	36	44	31	5	8
1525	FW_pair1525	FakeAnc1525	FakeDesc1525	SIMULPF00001	152	145	163	134	11	18
1526	FW_pair1526	FakeAnc1526	FakeDesc1526	SIMULPF00001	29	26	30	25	1	4
1527	FW_pair1527	FakeAnc1527	FakeDesc1527	SIMULPF00001	110	104	118	96	8	14
1528	FW_pair1528	FakeAnc1528	FakeDesc1528	SIMULPF00001	436	438	482	392	46	44
1529	FW_pair1529	FakeAnc1529	FakeDesc1529	SIMULPF00001	429	425	465	389	36	40
1530	FW_pair1530	FakeAnc1530	FakeDesc1530	SIMULPF00001	174	179	197	156	23	18
1531	FW_pair1531	FakeAnc1531	FakeDesc1531	SIMULPF00001	357	355	382	330	25	27
1532	FW_pair1532	FakeAnc1532	FakeDesc1532	SIMULPF00001	88	80	93	75	5	13
1533	FW_pair1533	FakeAnc1533	FakeDesc1533	SIMULPF00001	110	111	121	100	11	10
1534	FW_pair1534	FakeAnc1534	FakeDesc1534	SIMULPF00001	169	152	179	142	10	27
1535	FW_pair1535	FakeAnc1535	FakeDesc1535	SIMULPF00001	211	218	238	191	27	20
1536	FW_pair1536	FakeAnc1536	FakeDesc1536	SIMULPF00001	200	199	217	182	17	18
1537	FW_pair1537	FakeAnc1537	FakeDesc1537	SIMULPF00001	22	20	23	19	1	3
1538	FW_pair1538	FakeAnc1538	FakeDesc1538	SIMULPF00001	177	187	199	165	22	12
1539	FW_pair1539	FakeAnc1539	FakeDesc1539	SIMULPF00001	66	61	69	58	3	8
1540	FW_pair1540	FakeAnc1540	FakeDesc1540	SIMULPF00001	117	110	125	102	8	15
1541	FW_pair1541	FakeAnc1541	FakeDesc1541	SIMULPF00001	84	88	94	78	10	6
1542	FW_pair1542	FakeAnc1542	FakeDesc1542	SIMULPF00001	183	189	206	166	23	17
1543	FW_pair1543	FakeAnc1543	FakeDesc1543	SIMULPF00001	723	721	778	666	55	57
1544	FW_pair1544	FakeAnc1544	FakeDesc1544	SIMULPF00001	292	310	333	269	41	23
1545	FW_pair1545	FakeAnc1545	FakeDesc1545	SIMULPF00001	74	74	82	66	8	8
1546	FW_pair1546	FakeAnc1546	FakeDesc1546	SIMULPF00001	370	372	403	339	33	31
1547	FW_pair1547	FakeAnc1547	FakeDesc1547	SIMULPF00001	90	86	98	78	8	12
1548	FW_pair1548	FakeAnc1548	FakeDesc1548	SIMULPF00001	65	70	74	61	9	4
1549	FW_pair1549	FakeAnc1549	FakeDesc1549	SIMULPF00001	567	548	610	505	43	62
1550	FW_pair1550	FakeAnc1550	FakeDesc1550	SIMULPF00001	7	6	7	6	0	1
1551	FW_pair1551	FakeAnc1551	FakeDesc1551	SIMULPF00001	224	233	246	211	22	13
1552	FW_pair1552	FakeAnc1552	FakeDesc1552	SIMULPF00001	147	143	158	132	11	15
1553	FW_pair1553	FakeAnc1553	FakeDesc1553	SIMULPF00001	258	268	290	236	32	22
1554	FW_pair1554	FakeAnc1554	FakeDesc1554	SIMULPF00001	82	89	94	77	12	5
1555	FW_pair1555	FakeAnc1555	FakeDesc1555	SIMULPF00001	175	176	190	161	15	14
1556	FW_pair1556	FakeAnc1556	FakeDesc1556	SIMULPF00001	780	757	851	686	71	94
1557	FW_pair1557	FakeAnc1557	FakeDesc1557	SIMULPF00001	116	123	138	101	22	15
1558	FW_pair1558	FakeAnc1558	FakeDesc1558	SIMULPF00001	73	79	83	69	10	4
1559	FW_pair1559	FakeAnc1559	FakeDesc1559	SIMULPF00001	400	417	447	370	47	30
1560	FW_pair1560	FakeAnc1560	FakeDesc1560	SIMULPF00001	14	12	14	12	0	2
1561	FW_pair1561	FakeAnc1561	FakeDesc1561	SIMULPF00001	166	160	180	146	14	20
1562	FW_pair1562	FakeAnc1562	FakeDesc1562	SIMULPF00001	55	48	58	45	3	10
1563	FW_pair1563	FakeAnc1563	FakeDesc1563	SIMULPF00001	66	65	70	61	4	5
1564	FW_pair1564	FakeAnc1564	FakeDesc1564	SIMULPF00001	223	216	238	201	15	22
1565	FW_pair1565	FakeAnc1565	FakeDesc1565	SIMULPF00001	183	172	197	158	14	25
1566	FW_pair1566	FakeAnc1566	FakeDesc1566	SIMULPF00001	310	313	340	283	30	27
1567	FW_pair1567	FakeAnc1567	FakeDesc1567	SIMULPF00001	403	393	428	368	25	35
1568	FW_pair1568	FakeAnc1568	FakeDesc1568	SIMULPF00001	106	96	110	92	4	14
1569	FW_pair1569	FakeAnc1569	FakeDesc1569	SIMULPF00001	53	48	55	46	2	7
1570	FW_pair1570	FakeAnc1570	FakeDesc1570	SIMULPF00001	75	66	77	64	2	11
1571	FW_pair1571	FakeAnc1571	FakeDesc1571	SIMULPF00001	55	54	60	49	5	6
1572	FW_pair1572	FakeAnc1572	FakeDesc1572	SIMULPF00001	32	29	33	28	1	4
1573	FW_pair1573	FakeAnc1573	FakeDesc1573	SIMULPF00001	8	9	9	8	1	0
1574	FW_pair1574	FakeAnc1574	FakeDesc1574	SIMULPF00001	101	105	114	92	13	9
1575	FW_pair1575	FakeAnc1575	FakeDesc1575	SIMULPF00001	122	123	141	104	19	18
1576	FW_pair1576	FakeAnc1576	FakeDesc1576	SIMULPF00001	186	185	202	169	16	17
1577	FW_pair1577	FakeAnc1577	FakeDesc1577	SIMULPF00001	40	37	40	37	0	3
1578	FW_pair1578	FakeAnc1578	FakeDesc1578	SIMULPF00001	281	278	306	253	25	28
1579	FW_pair1579	FakeAnc1579	FakeDesc1579	SIMULPF00001	95	93	101	87	6	8
1580	FW_pair1580	FakeAnc1580	FakeDesc1580	SIMULPF00001	372	372	407	337	35	35
1581	FW_pair1581	FakeAnc1581	FakeDesc1581	SIMULPF00001	390	396	435	351	45	39
1582	FW_pair1582	FakeAnc1582	FakeDesc1582	SIMULPF00001	100	110	114	96	14	4
1583	FW_pair1583	FakeAnc1583	FakeDesc1583	SIMULPF00001	185	187	203	169	18	16
1584	FW_pair1584	FakeAnc1584	FakeDesc1584	SIMULPF00001	237	223	253	207	16	30
1585	FW_pair1585	FakeAnc1585	FakeDesc1585	SIMULPF00001	225	232	246	211	21	14
1586	FW_pair1586	FakeAnc1586	FakeDesc1586	SIMULPF00001	18	20	21	17	3	1
1587	FW_pair1587	FakeAnc1587	FakeDesc1587	SIMULPF00001	22	26	26	22	4	0
1588	FW_pair1588	FakeAnc1588	FakeDesc1588	SIMULPF00001	78	75	84	69	6	9
1589	FW_pair1589	FakeAnc1589	FakeDesc1589	SIMULPF00001	58	54	61	51	3	7
1590	FW_pair1590	FakeAnc1590	FakeDesc1590	SIMULPF00001	455	460	503	412	48	43
1591	FW_pair1591	FakeAnc1591	FakeDesc1591	SIMULPF00001	680	693	741	632	61	48
1592	FW_pair1592	FakeAnc1592	FakeDesc1592	SIMULPF00001	252	241	273	220	21	32
1593	FW_pair1593	FakeAnc1593	FakeDesc1593	SIMULPF00001	98	106	117	87	19	11
1594	FW_pair1594	FakeAnc1594	FakeDesc1594	SIMULPF00001	380	362	408	334	28	46
1595	FW_pair1595	FakeAnc1595	FakeDesc1595	SIMULPF00001	738	740	802	676	64	62
1596	FW_pair1596	FakeAnc1596	FakeDesc1596	SIMULPF00001	286	275	310	251	24	35
1597	FW_pair1597	FakeAnc1597	FakeDesc1597	SIMULPF00001	80	75	88	67	8	13
1598	FW_pair1598	FakeAnc1598	FakeDesc1598	SIMULPF00001	344	328	363	309	19	35
1599	FW_pair1599	FakeAnc1599	FakeDesc1599	SIMULPF00001	146	148	162	132	16	14
1600	FW_pair1600	FakeAnc1600	FakeDesc1600	SIMULPF00001	8	8	8	8	0	0
1601	FW_pair1601	FakeAnc1601	FakeDesc1601	SIMULPF00001	78	79	88	69	10	9
1602	FW_pair1602	FakeAnc1602	FakeDesc1602	SIMULPF00001	15	20	20	15	5	0
1603	FW_pair1603	FakeAnc1603	FakeDesc1603	SIMULPF00001	91	94	102	83	11	8
1604	FW_pair1604	FakeAnc1604	FakeDesc1604	SIMULPF00001	89	99	103	85	14	4
1605	FW_pair1605	FakeAnc1605	FakeDesc1605	SIMULPF00001	218	223	233	208	15	10
1606	FW_pair1606	FakeAnc1606	FakeDesc1606	SIMULPF00001	294	279	310	263	16	31
1607	FW_pair1607	FakeAnc1607	FakeDesc1607	SIMULPF00001	127	126	134	119	7	8
1608	FW_pair1608	FakeAnc1608	FakeDesc1608	SIMULPF00001	82	81	89	74	7	8
1609	FW_pair1609	FakeAnc1609	FakeDesc1609	SIMULPF00001	348	359	399	308	51	40
1610	FW_pair1610	FakeAnc1610	FakeDesc1610	SIMULPF00001	312	297	337	272	25	40
1611	FW_pair1611	FakeAnc1611	FakeDesc1611	SIMULPF00001	786	774	865	695	79	91
1612	FW_pair1612	FakeAnc1612	FakeDesc1612	SIMULPF00001	618	644	687	575	69	43
1613	FW_pair1613	FakeAnc1613	FakeDesc1613	SIMULPF00001	542	522	592	472	50	70
1614	FW_pair1614	FakeAnc1614	FakeDesc1614	SIMULPF00001	127	125	137	115	10	12
1615	FW_pair1615	FakeAnc1615	FakeDesc1615	SIMULPF00001	449	447	494	402	45	47
1616	FW_pair1616	FakeAnc1616	FakeDesc1616	SIMULPF00001	19	24	25	18	6	1
1617	FW_pair1617	FakeAnc1617	FakeDesc1617	SIMULPF00001	726	745	798	673	72	53
1618	FW_pair1618	FakeAnc1618	FakeDesc1618	SIMULPF00001	274	282	307	249	33	25
1619	FW_pair1619	FakeAnc1619	FakeDesc1619	SIMULPF00001	635	631	694	572	59	63
1620	FW_pair1620	FakeAnc1620	FakeDesc1620	SIMULPF00001	304	315	356	263	52	41
1621	FW_pair1621	FakeAnc1621	FakeDesc1621	SIMULPF00001	11	11	11	11	0	0
1622	FW_pair1622	FakeAnc1622	FakeDesc1622	SIMULPF00001	142	132	150	124	8	18
1623	FW_pair1623	FakeAnc1623	FakeDesc1623	SIMULPF00001	61	57	64	54	3	7
1624	FW_pair1624	FakeAnc1624	FakeDesc1624	SIMULPF00001	214	212	231	195	17	19
1625	FW_pair1625	FakeAnc1625	FakeDesc1625	SIMULPF00001	521	542	582	481	61	40
1626	FW_pair1626	FakeAnc1626	FakeDesc1626	SIMULPF00001	797	773	853	717	56	80
1627	FW_pair1627	FakeAnc1627	FakeDesc1627	SIMULPF00001	84	87	93	78	9	6
1628	FW_pair1628	FakeAnc1628	FakeDesc1628	SIMULPF00001	485	472	517	440	32	45
1629	FW_pair1629	FakeAnc1629	FakeDesc1629	SIMULPF00001	581	569	626	524	45	57
1630	FW_pair1630	FakeAnc1630	FakeDesc1630	SIMULPF00001	248	245	270	223	22	25
1631	FW_pair1631	FakeAnc1631	FakeDesc1631	SIMULPF00001	543	553	597	499	54	44
1632	FW_pair1632	FakeAnc1632	FakeDesc1632	SIMULPF00001	354	356	397	313	43	41
1633	FW_pair1633	FakeAnc1633	FakeDesc1633	SIMULPF00001	444	428	477	395	33	49
1634	FW_pair1634	FakeAnc1634	FakeDesc1634	SIMULPF00001	90	94	97	87	7	3
1635	FW_pair1635	FakeAnc1635	FakeDesc1635	SIMULPF00001	128	132	144	116	16	12
1636	FW_pair1636	FakeAnc1636	FakeDesc1636	SIMULPF00001	107	103	115	95	8	12
1637	FW_pair1637	FakeAnc1637	FakeDesc1637	SIMULPF00001	67	62	73	56	6	11
1638	FW_pair1638	FakeAnc1638	FakeDesc1638	SIMULPF00001	306	316	336	286	30	20
1639	FW_pair1639	FakeAnc1639	FakeDesc1639	SIMULPF00001	122	117	126	113	4	9
1640	FW_pair1640	FakeAnc1640	FakeDesc1640	SIMULPF00001	83	77	87	73	4	10
1641	FW_pair1641	FakeAnc1641	FakeDesc1641	SIMULPF00001	213	214	241	186	28	27
1642	FW_pair1642	FakeAnc1642	FakeDesc1642	SIMULPF00001	194	203	216	181	22	13
1643	FW_pair1643	FakeAnc1643	FakeDesc1643	SIMULPF00001	36	26	36	26	0	10
1644	FW_pair1644	FakeAnc1644	FakeDesc1644	SIMULPF00001	296	314	334	276	38	20
1645	FW_pair1645	FakeAnc1645	FakeDesc1645	SIMULPF00001	449	474	507	416	58	33
1646	FW_pair1646	FakeAnc1646	FakeDesc1646	SIMULPF00001	85	84	92	77	7	8
1647	FW_pair1647	FakeAnc1647	FakeDesc1647	SIMULPF00001	245	252	272	225	27	20
1648	FW_pair1648	FakeAnc1648	FakeDesc1648	SIMULPF00001	52	45	55	42	3	10
1649	FW_pair1649	FakeAnc1649	FakeDesc1649	SIMULPF00001	290	282	312	260	22	30
1650	FW_pair1650	FakeAnc1650	FakeDesc1650	SIMULPF00001	419	426	459	386	40	33
1651	FW_pair1651	FakeAnc1651	FakeDesc1651	SIMULPF00001	104	104	111	97	7	7
1652	FW_pair1652	FakeAnc1652	FakeDesc1652	SIMULPF00001	645	667	715	597	70	48
1653	FW_pair1653	FakeAnc1653	FakeDesc1653	SIMULPF00001	540	549	596	493	56	47
1654	FW_pair1654	FakeAnc1654	FakeDesc1654	SIMULPF00001	65	67	72	60	7	5
1655	FW_pair1655	FakeAnc1655	FakeDesc1655	SIMULPF00001	325	343	360	308	35	17
1656	FW_pair1656	FakeAnc1656	FakeDesc1656	SIMULPF00001	66	60	70	56	4	10
1657	FW_pair1657	FakeAnc1657	FakeDesc1657	SIMULPF00001	335	343	374	304	39	31
1658	FW_pair1658	FakeAnc1658	FakeDesc1658	SIMULPF00001	142	141	156	127	14	15
1659	FW_pair1659	FakeAnc1659	FakeDesc1659	SIMULPF00001	259	244	279	224	20	35
1660	FW_pair1660	FakeAnc1660	FakeDesc1660	SIMULPF00001	211	221	238	194	27	17
1661	FW_pair1661	FakeAnc1661	FakeDesc1661	SIMULPF00001	373	375	414	334	41	39
1662	FW_pair1662	FakeAnc1662	FakeDesc1662	SIMULPF00001	104	99	112	91	8	13
1663	FW_pair1663	FakeAnc1663	FakeDesc1663	SIMULPF00001	70	75	78	67	8	3
1664	FW_pair1664	FakeAnc1664	FakeDesc1664	SIMULPF00001	18	15	18	15	0	3
1665	FW_pair1665	FakeAnc1665	FakeDesc1665	SIMULPF00001	91	80	93	78	2	13
1666	FW_pair1666	FakeAnc1666	FakeDesc1666	SIMULPF00001	329	316	354	291	25	38
1667	FW_pair1667	FakeAnc1667	FakeDesc1667	SIMULPF00001	574	589	642	521	68	53
1668	FW_pair1668	FakeAnc1668	FakeDesc1668	SIMULPF00001	36	37	37	36	1	0
1669	FW_pair1669	FakeAnc1669	FakeDesc1669	SIMULPF00001	103	101	110	94	7	9
1670	FW_pair1670	FakeAnc1670	FakeDesc1670	SIMULPF00001	60	63	68	55	8	5
1671	FW_pair1671	FakeAnc1671	FakeDesc1671	SIMULPF00001	304	303	320	287	16	17
1672	FW_pair1672	FakeAnc1672	FakeDesc1672	SIMULPF00001	83	88	94	77	11	6
1673	FW_pair1673	FakeAnc1673	FakeDesc1673	SIMULPF00001	592	594	655	531	63	61
1674	FW_pair1674	FakeAnc1674	FakeDesc1674	SIMULPF00001	41	42	49	34	8	7
1675	FW_pair1675	FakeAnc1675	FakeDesc1675	SIMULPF00001	59	53	63	49	4	10
1676	FW_pair1676	FakeAnc1676	FakeDesc1676	SIMULPF00001	219	229	250	198	31	21
1677	FW_pair1677	FakeAnc1677	FakeDesc1677	SIMULPF00001	224	219	246	197	22	27
1678	FW_pair1678	FakeAnc1678	FakeDesc1678	SIMULPF00001	109	122	124	107	15	2
1679	FW_pair1679	FakeAnc1679	FakeDesc1679	SIMULPF00001	134	119	136	117	2	17
1680	FW_pair1680	FakeAnc1680	FakeDesc1680	SIMULPF00001	17	16	19	14	2	3
1681	FW_pair1681	FakeAnc1681	FakeDesc1681	SIMULPF00001	165	155	178	142	13	23
1682	FW_pair1682	FakeAnc1682	FakeDesc1682	SIMULPF00001	185	185	204	166	19	19
1683	FW_pair1683	FakeAnc1683	FakeDesc1683	SIMULPF00001	157	157	164	150	7	7
1684	FW_pair1684	FakeAnc1684	FakeDesc1684	SIMULPF00001	61	60	70	51	9	10
1685	FW_pair1685	FakeAnc1685	FakeDesc1685	SIMULPF00001	283	284	319	248	36	35
1686	FW_pair1686	FakeAnc1686	FakeDesc1686	SIMULPF00001	133	135	145	123	12	10
1687	FW_pair1687	FakeAnc1687	FakeDesc1687	SIMULPF00001	281	283	309	255	28	26
1688	FW_pair1688	FakeAnc1688	FakeDesc1688	SIMULPF00001	88	94	102	80	14	8
1689	FW_pair1689	FakeAnc1689	FakeDesc1689	SIMULPF00001	150	141	155	136	5	14
1690	FW_pair1690	FakeAnc1690	FakeDesc1690	SIMULPF00001	123	120	136	107	13	16
1691	FW_pair1691	FakeAnc1691	FakeDesc1691	SIMULPF00001	139	137	150	126	11	13
1692	FW_pair1692	FakeAnc1692	FakeDesc1692	SIMULPF00001	61	57	64	54	3	7
1693	FW_pair1693	FakeAnc1693	FakeDesc1693	SIMULPF00001	112	111	118	105	6	7
1694	FW_pair1694	FakeAnc1694	FakeDesc1694	SIMULPF00001	47	47	49	45	2	2
1695	FW_pair1695	FakeAnc1695	FakeDesc1695	SIMULPF00001	25	26	26	25	1	0
1696	FW_pair1696	FakeAnc1696	FakeDesc1696	SIMULPF00001	28	26	31	23	3	5
1697	FW_pair1697	FakeAnc1697	FakeDesc1697	SIMULPF00001	18	20	21	17	3	1
1698	FW_pair1698	FakeAnc1698	FakeDesc1698	SIMULPF00001	47	51	53	45	6	2
1699	FW_pair1699	FakeAnc1699	FakeDesc1699	SIMULPF00001	483	493	535	441	52	42
1700	FW_pair1700	FakeAnc1700	FakeDesc1700	SIMULPF00001	577	549	627	499	50	78
1701	FW_pair1701	FakeAnc1701	FakeDesc1701	SIMULPF00001	651	655	714	592	63	59
1702	FW_pair1702	FakeAnc1702	FakeDesc1702	SIMULPF00001	102	98	106	94	4	8
1703	FW_pair1703	FakeAnc1703	FakeDesc1703	SIMULPF00001	164	165	181	148	17	16
1704	FW_pair1704	FakeAnc1704	FakeDesc1704	SIMULPF00001	90	98	106	82	16	8
1705	FW_pair1705	FakeAnc1705	FakeDesc1705	SIMULPF00001	43	41	47	37	4	6
1706	FW_pair1706	FakeAnc1706	FakeDesc1706	SIMULPF00001	68	75	76	67	8	1
1707	FW_pair1707	FakeAnc1707	FakeDesc1707	SIMULPF00001	5	7	7	5	2	0
1708	FW_pair1708	FakeAnc1708	FakeDesc1708	SIMULPF00001	277	296	324	249	47	28
1709	FW_pair1709	FakeAnc1709	FakeDesc1709	SIMULPF00001	29	29	31	27	2	2
1710	FW_pair1710	FakeAnc1710	FakeDesc1710	SIMULPF00001	85	81	94	72	9	13
1711	FW_pair1711	FakeAnc1711	FakeDesc1711	SIMULPF00001	48	50	52	46	4	2
1712	FW_pair1712	FakeAnc1712	FakeDesc1712	SIMULPF00001	334	349	362	321	28	13
1713	FW_pair1713	FakeAnc1713	FakeDesc1713	SIMULPF00001	195	205	218	182	23	13
1714	FW_pair1714	FakeAnc1714	FakeDesc1714	SIMULPF00001	270	293	309	254	39	16
1715	FW_pair1715	FakeAnc1715	FakeDesc1715	SIMULPF00001	100	107	110	97	10	3
1716	FW_pair1716	FakeAnc1716	FakeDesc1716	SIMULPF00001	149	144	152	141	3	8
1717	FW_pair1717	FakeAnc1717	FakeDesc1717	SIMULPF00001	444	441	491	394	47	50
1718	FW_pair1718	FakeAnc1718	FakeDesc1718	SIMULPF00001	175	168	188	155	13	20
1719	FW_pair1719	FakeAnc1719	FakeDesc1719	SIMULPF00001	786	792	862	716	76	70
1720	FW_pair1720	FakeAnc1720	FakeDesc1720	SIMULPF00001	292	291	313	270	21	22
1721	FW_pair1721	FakeAnc1721	FakeDesc1721	SIMULPF00001	202	185	211	176	9	26
1722	FW_pair1722	FakeAnc1722	FakeDesc1722	SIMULPF00001	385	380	411	354	26	31
1723	FW_pair1723	FakeAnc1723	FakeDesc1723	SIMULPF00001	52	47	56	43	4	9
1724	FW_pair1724	FakeAnc1724	FakeDesc1724	SIMULPF00001	56	57	61	52	5	4
1725	FW_pair1725	FakeAnc1725	FakeDesc1725	SIMULPF00001	57	58	64	51	7	6
1726	FW_pair1726	FakeAnc1726	FakeDesc1726	SIMULPF00001	583	593	636	540	53	43
1727	FW_pair1727	FakeAnc1727	FakeDesc1727	SIMULPF00001	84	82	87	79	3	5
1728	FW_pair1728	FakeAnc1728	FakeDesc1728	SIMULPF00001	75	79	80	74	5	1
1729	FW_pair1729	FakeAnc1729	FakeDesc1729	SIMULPF00001	506	507	534	479	28	27
1730	FW_pair1730	FakeAnc1730	FakeDesc1730	SIMULPF00001	36	34	40	30	4	6
1731	FW_pair1731	FakeAnc1731	FakeDesc1731	SIMULPF00001	328	307	352	283	24	45
1732	FW_pair1732	FakeAnc1732	FakeDesc1732	SIMULPF00001	66	71	80	57	14	9
1733	FW_pair1733	FakeAnc1733	FakeDesc1733	SIMULPF00001	768	761	843	686	75	82
1734	FW_pair1734	FakeAnc1734	FakeDesc1734	SIMULPF00001	311	290	337	264	26	47
1735	FW_pair1735	FakeAnc1735	FakeDesc1735	SIMULPF00001	217	227	244	200	27	17
1736	FW_pair1736	FakeAnc1736	FakeDesc1736	SIMULPF00001	652	638	701	589	49	63
1737	FW_pair1737	FakeAnc1737	FakeDesc1737	SIMULPF00001	126	135	145	116	19	10
1738	FW_pair1738	FakeAnc1738	FakeDesc1738	SIMULPF00001	429	424	461	392	32	37
1739	FW_pair1739	FakeAnc1739	FakeDesc1739	SIMULPF00001	281	295	320	256	39	25
1740	FW_pair1740	FakeAnc1740	FakeDesc1740	SIMULPF00001	160	165	173	152	13	8
1741	FW_pair1741	FakeAnc1741	FakeDesc1741	SIMULPF00001	37	34	41	30	4	7
1742	FW_pair1742	FakeAnc1742	FakeDesc1742	SIMULPF00001	89	81	93	77	4	12
1743	FW_pair1743	FakeAnc1743	FakeDesc1743	SIMULPF00001	59	58	65	52	6	7
1744	FW_pair1744	FakeAnc1744	FakeDesc1744	SIMULPF00001	145	142	158	129	13	16
1745	FW_pair1745	FakeAnc1745	FakeDesc1745	SIMULPF00001	180	174	191	163	11	17
1746	FW_pair1746	FakeAnc1746	FakeDesc1746	SIMULPF00001	467	469	514	422	47	45
1747	FW_pair1747	FakeAnc1747	FakeDesc1747	SIMULPF00001	179	192	205	166	26	13
1748	FW_pair1748	FakeAnc1748	FakeDesc1748	SIMULPF00001	35	34	39	30	4	5
1749	FW_pair1749	FakeAnc1749	FakeDesc1749	SIMULPF00001	278	289	311	256	33	22
1750	FW_pair1750	FakeAnc1750	FakeDesc1750	SIMULPF00001	126	127	137	116	11	10
1751	FW_pair1751	FakeAnc1751	FakeDesc1751	SIMULPF00001	609	622	678	553	69	56
1752	FW_pair1752	FakeAnc1752	FakeDesc1752	SIMULPF00001	107	104	114	97	7	10
1753	FW_pair1753	FakeAnc1753	FakeDesc1753	SIMULPF00001	10	9	10	9	0	1
1754	FW_pair1754	FakeAnc1754	FakeDesc1754	SIMULPF00001	85	82	90	77	5	8
1755	FW_pair1755	FakeAnc1755	FakeDesc1755	SIMULPF00001	158	168	177	149	19	9
1756	FW_pair1756	FakeAnc1756	FakeDesc1756	SIMULPF00001	798	795	885	708	87	90
1757	FW_pair1757	FakeAnc1757	FakeDesc1757	SIMULPF00001	281	279	310	250	29	31
1758	FW_pair1758	FakeAnc1758	FakeDesc1758	SIMULPF00001	674	651	742	583	68	91
1759	FW_pair1759	FakeAnc1759	FakeDesc1759	SIMULPF00001	74	71	78	67	4	7
1760	FW_pair1760	FakeAnc1760	FakeDesc1760	SIMULPF00001	8	11	11	8	3	0
1761	FW_pair1761	FakeAnc1761	FakeDesc1761	SIMULPF00001	335	324	358	301	23	34
1762	FW_pair1762	FakeAnc1762	FakeDesc1762	SIMULPF00001	71	75	84	62	13	9
1763	FW_pair1763	FakeAnc1763	FakeDesc1763	SIMULPF00001	6	6	6	6	0	0
1764	FW_pair1764	FakeAnc1764	FakeDesc1764	SIMULPF00001	166	170	185	151	19	15
1765	FW_pair1765	FakeAnc1765	FakeDesc1765	SIMULPF00001	57	57	62	52	5	5
1766	FW_pair1766	FakeAnc1766	FakeDesc1766	SIMULPF00001	731	713	790	654	59	77
1767	FW_pair1767	FakeAnc1767	FakeDesc1767	SIMULPF00001	105	106	116	95	11	10
1768	FW_pair1768	FakeAnc1768	FakeDesc1768	SIMULPF00001	139	137	152	124	13	15
1769	FW_pair1769	FakeAnc1769	FakeDesc1769	SIMULPF00001	150	151	164	137	14	13
1770	FW_pair1770	FakeAnc1770	FakeDesc1770	SIMULPF00001	151	151	164	138	13	13
1771	FW_pair1771	FakeAnc1771	FakeDesc1771	SIMULPF00001	106	109	118	97	12	9
1772	FW_pair1772	FakeAnc1772	FakeDesc1772	SIMULPF00001	33	33	34	32	1	1
1773	FW_pair1773	FakeAnc1773	FakeDesc1773	SIMULPF00001	31	35	38	28	7	3
1774	FW_pair1774	FakeAnc1774	FakeDesc1774	SIMULPF00001	14	14	15	13	1	1
1775	FW_pair1775	FakeAnc1775	FakeDesc1775	SIMULPF00001	129	133	140	122	11	7
1776	FW_pair1776	FakeAnc1776	FakeDesc1776	SIMULPF00001	392	396	434	354	42	38
1777	FW_pair1777	FakeAnc1777	FakeDesc1777	SIMULPF00001	463	460	503	420	40	43
1778	FW_pair1778	FakeAnc1778	FakeDesc1778	SIMULPF00001	22	20	23	19	1	3
1779	FW_pair1779	FakeAnc1779	FakeDesc1779	SIMULPF00001	146	147	158	135	12	11
1780	FW_pair1780	FakeAnc1780	FakeDesc1780	SIMULPF00001	25	30	31	24	6	1
1781	FW_pair1781	FakeAnc1781	FakeDesc1781	SIMULPF00001	143	136	155	124	12	19
1782	FW_pair1782	FakeAnc1782	FakeDesc1782	SIMULPF00001	144	145	157	132	13	12
1783	FW_pair1783	FakeAnc1783	FakeDesc1783	SIMULPF00001	238	243	269	212	31	26
1784	FW_pair1784	FakeAnc1784	FakeDesc1784	SIMULPF00001	892	895	974	813	82	79
1785	FW_pair1785	FakeAnc1785	FakeDesc1785	SIMULPF00001	3	3	3	3	0	0
1786	FW_pair1786	FakeAnc1786	FakeDesc1786	SIMULPF00001	352	362	396	318	44	34
1787	FW_pair1787	FakeAnc1787	FakeDesc1787	SIMULPF00001	101	103	108	96	7	5
1788	FW_pair1788	FakeAnc1788	FakeDesc1788	SIMULPF00001	848	852	944	756	96	92
1789	FW_pair1789	FakeAnc1789	FakeDesc1789	SIMULPF00001	78	74	86	66	8	12
1790	FW_pair1790	FakeAnc1790	FakeDesc1790	SIMULPF00001	242	248	269	221	27	21
1791	FW_pair1791	FakeAnc1791	FakeDesc1791	SIMULPF00001	433	423	463	393	30	40
1792	FW_pair1792	FakeAnc1792	FakeDesc1792	SIMULPF00001	291	294	322	263	31	28
1793	FW_pair1793	FakeAnc1793	FakeDesc1793	SIMULPF00001	850	861	946	765	96	85
1794	FW_pair1794	FakeAnc1794	FakeDesc1794	SIMULPF00001	312	302	336	278	24	34
1795	FW_pair1795	FakeAnc1795	FakeDesc1795	SIMULPF00001	114	125	132	107	18	7
1796	FW_pair1796	FakeAnc1796	FakeDesc1796	SIMULPF00001	533	542	584	491	51	42
1797	FW_pair1797	FakeAnc1797	FakeDesc1797	SIMULPF00001	61	64	69	56	8	5
1798	FW_pair1798	FakeAnc1798	FakeDesc1798	SIMULPF00001	272	290	314	248	42	24
1799	FW_pair1799	FakeAnc1799	FakeDesc1799	SIMULPF00001	35	36	40	31	5	4
1800	FW_pair1800	FakeAnc1800	FakeDesc1800	SIMULPF00001	128	128	138	118	10	10
1801	FW_pair1801	FakeAnc1801	FakeDesc1801	SIMULPF00001	149	147	157	139	8	10
1802	FW_pair1802	FakeAnc1802	FakeDesc1802	SIMULPF00001	86	80	93	73	7	13
1803	FW_pair1803	FakeAnc1803	FakeDesc1803	SIMULPF00001	839	853	923	769	84	70
1804	FW_pair1804	FakeAnc1804	FakeDesc1804	SIMULPF00001	121	119	127	113	6	8
1805	FW_pair1805	FakeAnc1805	FakeDesc1805	SIMULPF00001	297	272	325	244	28	53
1806	FW_pair1806	FakeAnc1806	FakeDesc1806	SIMULPF00001	888	904	974	818	86	70
1807	FW_pair1807	FakeAnc1807	FakeDesc1807	SIMULPF00001	144	135	151	128	7	16
1808	FW_pair1808	FakeAnc1808	FakeDesc1808	SIMULPF00001	156	165	180	141	24	15
1809	FW_pair1809	FakeAnc1809	FakeDesc1809	SIMULPF00001	9	10	10	9	1	0
1810	FW_pair1810	FakeAnc1810	FakeDesc1810	SIMULPF00001	116	118	124	110	8	6
1811	FW_pair1811	FakeAnc1811	FakeDesc1811	SIMULPF00001	710	722	779	653	69	57
1812	FW_pair1812	FakeAnc1812	FakeDesc1812	SIMULPF00001	253	245	273	225	20	28
1813	FW_pair1813	FakeAnc1813	FakeDesc1813	SIMULPF00001	428	436	484	380	56	48
1814	FW_pair1814	FakeAnc1814	FakeDesc1814	SIMULPF00001	86	84	99	71	13	15
1815	FW_pair1815	FakeAnc1815	FakeDesc1815	SIMULPF00001	546	514	582	478	36	68
1816	FW_pair1816	FakeAnc1816	FakeDesc1816	SIMULPF00001	141	143	156	128	15	13
1817	FW_pair1817	FakeAnc1817	FakeDesc1817	SIMULPF00001	306	306	331	281	25	25
1818	FW_pair1818	FakeAnc1818	FakeDesc1818	SIMULPF00001	131	139	147	123	16	8
1819	FW_pair1819	FakeAnc1819	FakeDesc1819	SIMULPF00001	60	60	66	54	6	6
1820	FW_pair1820	FakeAnc1820	FakeDesc1820	SIMULPF00001	308	291	326	273	18	35
1821	FW_pair1821	FakeAnc1821	FakeDesc1821	SIMULPF00001	206	205	220	191	14	15
1822	FW_pair1822	FakeAnc1822	FakeDesc1822	SIMULPF00001	65	72	76	61	11	4
1823	FW_pair1823	FakeAnc1823	FakeDesc1823	SIMULPF00001	109	126	129	106	20	3
1824	FW_pair1824	FakeAnc1824	FakeDesc1824	SIMULPF00001	161	159	174	146	13	15
1825	FW_pair1825	FakeAnc1825	FakeDesc1825	SIMULPF00001	7	7	7	7	0	0
1826	FW_pair1826	FakeAnc1826	FakeDesc1826	SIMULPF00001	291	290	318	263	27	28
1827	FW_pair1827	FakeAnc1827	FakeDesc1827	SIMULPF00001	196	193	210	179	14	17
1828	FW_pair1828	FakeAnc1828	FakeDesc1828	SIMULPF00001	8	8	8	8	0	0
1829	FW_pair1829	FakeAnc1829	FakeDesc1829	SIMULPF00001	218	206	231	193	13	25
1830	FW_pair1830	FakeAnc1830	FakeDesc1830	SIMULPF00001	520	510	563	467	43	53
1831	FW_pair1831	FakeAnc1831	FakeDesc1831	SIMULPF00001	211	206	230	187	19	24
1832	FW_pair1832	FakeAnc1832	FakeDesc1832	SIMULPF00001	218	223	239	202	21	16
1833	FW_pair1833	FakeAnc1833	FakeDesc1833	SIMULPF00001	242	247	268	221	26	21
1834	FW_pair1834	FakeAnc1834	FakeDesc1834	SIMULPF00001	190	196	215	171	25	19
1835	FW_pair1835	FakeAnc1835	FakeDesc1835	SIMULPF00001	143	144	157	130	14	13
1836	FW_pair1836	FakeAnc1836	FakeDesc1836	SIMULPF00001	836	823	914	745	78	91
1837	FW_pair1837	FakeAnc1837	FakeDesc1837	SIMULPF00001	219	201	227	193	8	26
1838	FW_pair1838	FakeAnc1838	FakeDesc1838	SIMULPF00001	402	399	432	369	30	33
1839	FW_pair1839	FakeAnc1839	FakeDesc1839	SIMULPF00001	25	23	26	22	1	3
1840	FW_pair1840	FakeAnc1840	FakeDesc1840	SIMULPF00001	146	145	162	129	16	17
1841	FW_pair1841	FakeAnc1841	FakeDesc1841	SIMULPF00001	86	93	100	79	14	7
1842	FW_pair1842	FakeAnc1842	FakeDesc1842	SIMULPF00001	45	50	52	43	7	2
1843	FW_pair1843	FakeAnc1843	FakeDesc1843	SIMULPF00001	102	95	110	87	8	15
1844	FW_pair1844	FakeAnc1844	FakeDesc1844	SIMULPF00001	204	198	220	182	16	22
1845	FW_pair1845	FakeAnc1845	FakeDesc1845	SIMULPF00001	21	19	21	19	0	2
1846	FW_pair1846	FakeAnc1846	FakeDesc1846	SIMULPF00001	45	43	47	41	2	4
1847	FW_pair1847	FakeAnc1847	FakeDesc1847	SIMULPF00001	70	75	79	66	9	4
1848	FW_pair1848	FakeAnc1848	FakeDesc1848	SIMULPF00001	444	449	491	402	47	42
1849	FW_pair1849	FakeAnc1849	FakeDesc1849	SIMULPF00001	260	273	292	241	32	19
1850	FW_pair1850	FakeAnc1850	FakeDesc1850	SIMULPF00001	207	212	228	191	21	16
1851	FW_pair1851	FakeAnc1851	FakeDesc1851	SIMULPF00001	87	86	94	79	7	8
1852	FW_pair1852	FakeAnc1852	FakeDesc1852	SIMULPF00001	258	252	277	233	19	25
1853	FW_pair1853	FakeAnc1853	FakeDesc1853	SIMULPF00001	272	270	299	243	27	29
1854	FW_pair1854	FakeAnc1854	FakeDesc1854	SIMULPF00001	199	214	224	189	25	10
1855	FW_pair1855	FakeAnc1855	FakeDesc1855	SIMULPF00001	225	224	249	200	24	25
1856	FW_pair1856	FakeAnc1856	FakeDesc1856	SIMULPF00001	686	693	750	629	64	57
1857	FW_pair1857	FakeAnc1857	FakeDesc1857	SIMULPF00001	174	164	187	151	13	23
1858	FW_pair1858	FakeAnc1858	FakeDesc1858	SIMULPF00001	140	149	158	131	18	9
1859	FW_pair1859	FakeAnc1859	FakeDesc1859	SIMULPF00001	248	253	282	219	34	29
1860	FW_pair1860	FakeAnc1860	FakeDesc1860	SIMULPF00001	617	613	667	563	50	54
1861	FW_pair1861	FakeAnc1861	FakeDesc1861	SIMULPF00001	14	15	16	13	2	1
1862	FW_pair1862	FakeAnc1862	FakeDesc1862	SIMULPF00001	653	649	719	583	66	70
1863	FW_pair1863	FakeAnc1863	FakeDesc1863	SIMULPF00001	117	116	127	106	10	11
1864	FW_pair1864	FakeAnc1864	FakeDesc1864	SIMULPF00001	61	66	72	55	11	6
1865	FW_pair1865	FakeAnc1865	FakeDesc1865	SIMULPF00001	49	45	50	44	1	5
1866	FW_pair1866	FakeAnc1866	FakeDesc1866	SIMULPF00001	13	13	14	12	1	1
1867	FW_pair1867	FakeAnc1867	FakeDesc1867	SIMULPF00001	153	158	170	141	17	12
1868	FW_pair1868	FakeAnc1868	FakeDesc1868	SIMULPF00001	397	400	435	362	38	35
1869	FW_pair1869	FakeAnc1869	FakeDesc1869	SIMULPF00001	193	208	221	180	28	13
1870	FW_pair1870	FakeAnc1870	FakeDesc1870	SIMULPF00001	103	103	114	92	11	11
1871	FW_pair1871	FakeAnc1871	FakeDesc1871	SIMULPF00001	68	66	71	63	3	5
1872	FW_pair1872	FakeAnc1872	FakeDesc1872	SIMULPF00001	410	404	450	364	40	46
1873	FW_pair1873	FakeAnc1873	FakeDesc1873	SIMULPF00001	319	321	350	290	31	29
1874	FW_pair1874	FakeAnc1874	FakeDesc1874	SIMULPF00001	282	285	314	253	32	29
1875	FW_pair1875	FakeAnc1875	FakeDesc1875	SIMULPF00001	503	504	536	471	33	32
1876	FW_pair1876	FakeAnc1876	FakeDesc1876	SIMULPF00001	135	136	144	127	9	8
1877	FW_pair1877	FakeAnc1877	FakeDesc1877	SIMULPF00001	25	24	26	23	1	2
1878	FW_pair1878	FakeAnc1878	FakeDesc1878	SIMULPF00001	429	444	471	402	42	27
1879	FW_pair1879	FakeAnc1879	FakeDesc1879	SIMULPF00001	443	439	473	409	30	34
1880	FW_pair1880	FakeAnc1880	FakeDesc1880	SIMULPF00001	77	77	86	68	9	9
1881	FW_pair1881	FakeAnc1881	FakeDesc1881	SIMULPF00001	1	3	3	1	2	0
1882	FW_pair1882	FakeAnc1882	FakeDesc1882	SIMULPF00001	189	189	206	172	17	17
1883	FW_pair1883	FakeAnc1883	FakeDesc1883	SIMULPF00001	20	22	23	19	3	1
1884	FW_pair1884	FakeAnc1884	FakeDesc1884	SIMULPF00001	302	295	334	263	32	39
1885	FW_pair1885	FakeAnc1885	FakeDesc1885	SIMULPF00001	462	447	502	407	40	55
1886	FW_pair1886	FakeAnc1886	FakeDesc1886	SIMULPF00001	259	262	290	231	31	28
1887	FW_pair1887	FakeAnc1887	FakeDesc1887	SIMULPF00001	379	388	419	348	40	31
1888	FW_pair1888	FakeAnc1888	FakeDesc1888	SIMULPF00001	18	18	19	17	1	1
1889	FW_pair1889	FakeAnc1889	FakeDesc1889	SIMULPF00001	229	227	242	214	13	15
1890	FW_pair1890	FakeAnc1890	FakeDesc1890	SIMULPF00001	286	286	310	262	24	24
1891	FW_pair1891	FakeAnc1891	FakeDesc1891	SIMULPF00001	95	104	109	90	14	5
1892	FW_pair1892	FakeAnc1892	FakeDesc1892	SIMULPF00001	171	173	190	154	19	17
1893	FW_pair1893	FakeAnc1893	FakeDesc1893	SIMULPF00001	242	222	252	212	10	30
1894	FW_pair1894	FakeAnc1894	FakeDesc1894	SIMULPF00001	690	715	766	639	76	51
1895	FW_pair1895	FakeAnc1895	FakeDesc1895	SIMULPF00001	646	641	706	581	60	65
1896	FW_pair1896	FakeAnc1896	FakeDesc1896	SIMULPF00001	17	13	17	13	0	4
1897	FW_pair1897	FakeAnc1897	FakeDesc1897	SIMULPF00001	21	27	28	20	7	1
1898	FW_pair1898	FakeAnc1898	FakeDesc1898	SIMULPF00001	185	186	205	166	20	19
1899	FW_pair1899	FakeAnc1899	FakeDesc1899	SIMULPF00001	275	275	304	246	29	29
1900	FW_pair1900	FakeAnc1900	FakeDesc1900	SIMULPF00001	415	421	450	386	35	29
1901	FW_pair1901	FakeAnc1901	FakeDesc1901	SIMULPF00001	230	227	252	205	22	25
1902	FW_pair1902	FakeAnc1902	FakeDesc1902	SIMULPF00001	720	705	787	638	67	82
1903	FW_pair1903	FakeAnc1903	FakeDesc1903	SIMULPF00001	95	97	105	87	10	8
1904	FW_pair1904	FakeAnc1904	FakeDesc1904	SIMULPF00001	514	522	567	469	53	45
1905	FW_pair1905	FakeAnc1905	FakeDesc1905	SIMULPF00001	8	7	8	7	0	1
1906	FW_pair1906	FakeAnc1906	FakeDesc1906	SIMULPF00001	887	895	968	814	81	73
1907	FW_pair1907	FakeAnc1907	FakeDesc1907	SIMULPF00001	298	288	322	264	24	34
1908	FW_pair1908	FakeAnc1908	FakeDesc1908	SIMULPF00001	17	18	18	17	1	0
1909	FW_pair1909	FakeAnc1909	FakeDesc1909	SIMULPF00001	60	64	67	57	7	3
1910	FW_pair1910	FakeAnc1910	FakeDesc1910	SIMULPF00001	25	22	26	21	1	4
1911	FW_pair1911	FakeAnc1911	FakeDesc1911	SIMULPF00001	104	106	112	98	8	6
1912	FW_pair1912	FakeAnc1912	FakeDesc1912	SIMULPF00001	474	468	518	424	44	50
1913	FW_pair1913	FakeAnc1913	FakeDesc1913	SIMULPF00001	303	317	336	284	33	19
1914	FW_pair1914	FakeAnc1914	FakeDesc1914	SIMULPF00001	288	271	309	250	21	38
1915	FW_pair1915	FakeAnc1915	FakeDesc1915	SIMULPF00001	1	1	1	1	0	0
1916	FW_pair1916	FakeAnc1916	FakeDesc1916	SIMULPF00001	33	32	34	31	1	2
1917	FW_pair1917	FakeAnc1917	FakeDesc1917	SIMULPF00001	109	97	114	92	5	17
1918	FW_pair1918	FakeAnc1918	FakeDesc1918	SIMULPF00001	27	31	32	26	5	1
1919	FW_pair1919	FakeAnc1919	FakeDesc1919	SIMULPF00001	87	95	103	79	16	8
1920	FW_pair1920	FakeAnc1920	FakeDesc1920	SIMULPF00001	435	430	473	392	38	43
1921	FW_pair1921	FakeAnc1921	FakeDesc1921	SIMULPF00001	356	358	393	321	37	35
1922	FW_pair1922	FakeAnc1922	FakeDesc1922	SIMULPF00001	400	393	442	351	42	49
1923	FW_pair1923	FakeAnc1923	FakeDesc1923	SIMULPF00001	240	232	259	213	19	27
1924	FW_pair1924	FakeAnc1924	FakeDesc1924	SIMULPF00001	27	23	27	23	0	4
1925	FW_pair1925	FakeAnc1925	FakeDesc1925	SIMULPF00001	103	94	112	85	9	18
1926	FW_pair1926	FakeAnc1926	FakeDesc1926	SIMULPF00001	16	16	17	15	1	1
1927	FW_pair1927	FakeAnc1927	FakeDesc1927	SIMULPF00001	20	21	23	18	3	2
1928	FW_pair1928	FakeAnc1928	FakeDesc1928	SIMULPF00001	207	206	225	188	18	19
1929	FW_pair1929	FakeAnc1929	FakeDesc1929	SIMULPF00001	82	87	94	75	12	7
1930	FW_pair1930	FakeAnc1930	FakeDesc1930	SIMULPF00001	211	220	240	191	29	20
1931	FW_pair1931	FakeAnc1931	FakeDesc1931	SIMULPF00001	146	145	154	137	8	9
1932	FW_pair1932	FakeAnc1932	FakeDesc1932	SIMULPF00001	811	807	886	732	75	79
1933	FW_pair1933	FakeAnc1933	FakeDesc1933	SIMULPF00001	453	435	490	398	37	55
1934	FW_pair1934	FakeAnc1934	FakeDesc1934	SIMULPF00001	27	21	27	21	0	6
1935	FW_pair1935	FakeAnc1935	FakeDesc1935	SIMULPF00001	85	80	90	75	5	10
1936	FW_pair1936	FakeAnc1936	FakeDesc1936	SIMULPF00001	53	54	56	51	3	2
1937	FW_pair1937	FakeAnc1937	FakeDesc1937	SIMULPF00001	375	367	409	333	34	42
1938	FW_pair1938	FakeAnc1938	FakeDesc1938	SIMULPF00001	14	13	14	13	0	1
1939	FW_pair1939	FakeAnc1939	FakeDesc1939	SIMULPF00001	298	296	330	264	32	34
1940	FW_pair1940	FakeAnc1940	FakeDesc1940	SIMULPF00001	403	396	439	360	36	43
1941	FW_pair1941	FakeAnc1941	FakeDesc1941	SIMULPF00001	393	385	424	354	31	39
1942	FW_pair1942	FakeAnc1942	FakeDesc1942	SIMULPF00001	253	251	276	228	23	25
1943	FW_pair1943	FakeAnc1943	FakeDesc1943	SIMULPF00001	60	64	67	57	7	3
1944	FW_pair1944	FakeAnc1944	FakeDesc1944	SIMULPF00001	28	22	29	21	1	7
1945	FW_pair1945	FakeAnc1945	FakeDesc1945	SIMULPF00001	119	116	128	107	9	12
1946	FW_pair1946	FakeAnc1946	FakeDesc1946	SIMULPF00001	106	113	117	102	11	4
1947	FW_pair1947	FakeAnc1947	FakeDesc1947	SIMULPF00001	160	153	174	139	14	21
1948	FW_pair1948	FakeAnc1948	FakeDesc1948	SIMULPF00001	255	267	289	233	34	22
1949	FW_pair1949	FakeAnc1949	FakeDesc1949	SIMULPF00001	97	109	114	92	17	5
1950	FW_pair1950	FakeAnc1950	FakeDesc1950	SIMULPF00001	7	5	7	5	0	2
1951	FW_pair1951	FakeAnc1951	FakeDesc1951	SIMULPF00001	54	61	62	53	8	1
1952	FW_pair1952	FakeAnc1952	FakeDesc1952	SIMULPF00001	159	163	175	147	16	12
1953	FW_pair1953	FakeAnc1953	FakeDesc1953	SIMULPF00001	52	47	60	39	8	13
1954	FW_pair1954	FakeAnc1954	FakeDesc1954	SIMULPF00001	9	10	10	9	1	0
1955	FW_pair1955	FakeAnc1955	FakeDesc1955	SIMULPF00001	519	518	561	476	42	43
1956	FW_pair1956	FakeAnc1956	FakeDesc1956	SIMULPF00001	3	3	3	3	0	0
1957	FW_pair1957	FakeAnc1957	FakeDesc1957	SIMULPF00001	89	94	103	80	14	9
1958	FW_pair1958	FakeAnc1958	FakeDesc1958	SIMULPF00001	5	4	5	4	0	1
1959	FW_pair1959	FakeAnc1959	FakeDesc1959	SIMULPF00001	185	185	198	172	13	13
1960	FW_pair1960	FakeAnc1960	FakeDesc1960	SIMULPF00001	191	189	204	176	13	15
1961	FW_pair1961	FakeAnc1961	FakeDesc1961	SIMULPF00001	178	183	193	168	15	10
1962	FW_pair1962	FakeAnc1962	FakeDesc1962	SIMULPF00001	23	20	23	20	0	3
1963	FW_pair1963	FakeAnc1963	FakeDesc1963	SIMULPF00001	203	210	219	194	16	9
1964	FW_pair1964	FakeAnc1964	FakeDesc1964	SIMULPF00001	140	144	152	132	12	8
1965	FW_pair1965	FakeAnc1965	FakeDesc1965	SIMULPF00001	15	19	19	15	4	0
1966	FW_pair1966	FakeAnc1966	FakeDesc1966	SIMULPF00001	36	38	41	33	5	3
1967	FW_pair1967	FakeAnc1967	FakeDesc1967	SIMULPF00001	85	93	94	84	9	1
1968	FW_pair1968	FakeAnc1968	FakeDesc1968	SIMULPF00001	218	225	241	202	23	16
1969	FW_pair1969	FakeAnc1969	FakeDesc1969	SIMULPF00001	108	104	118	94	10	14
1970	FW_pair1970	FakeAnc1970	FakeDesc1970	SIMULPF00001	20	21	21	20	1	0
1971	FW_pair1971	FakeAnc1971	FakeDesc1971	SIMULPF00001	46	48	48	46	2	0
1972	FW_pair1972	FakeAnc1972	FakeDesc1972	SIMULPF00001	20	19	24	15	4	5
1973	FW_pair1973	FakeAnc1973	FakeDesc1973	SIMULPF00001	288	283	315	256	27	32
1974	FW_pair1974	FakeAnc1974	FakeDesc1974	SIMULPF00001	776	766	842	700	66	76
1975	FW_pair1975	FakeAnc1975	FakeDesc1975	SIMULPF00001	247	241	268	220	21	27
1976	FW_pair1976	FakeAnc1976	FakeDesc1976	SIMULPF00001	435	431	468	398	33	37
1977	FW_pair1977	FakeAnc1977	FakeDesc1977	SIMULPF00001	726	710	792	644	66	82
1978	FW_pair1978	FakeAnc1978	FakeDesc1978	SIMULPF00001	452	452	496	408	44	44
1979	FW_pair1979	FakeAnc1979	FakeDesc1979	SIMULPF00001	856	854	934	776	78	80
1980	FW_pair1980	FakeAnc1980	FakeDesc1980	SIMULPF00001	144	148	155	137	11	7
1981	FW_pair1981	FakeAnc1981	FakeDesc1981	SIMULPF00001	94	100	105	89	11	5
1982	FW_pair1982	FakeAnc1982	FakeDesc1982	SIMULPF00001	264	259	285	238	21	26
1983	FW_pair1983	FakeAnc1983	FakeDesc1983	SIMULPF00001	23	25	26	22	3	1
1984	FW_pair1984	FakeAnc1984	FakeDesc1984	SIMULPF00001	4	5	5	4	1	0
1985	FW_pair1985	FakeAnc1985	FakeDesc1985	SIMULPF00001	485	474	528	431	43	54
1986	FW_pair1986	FakeAnc1986	FakeDesc1986	SIMULPF00001	151	147	162	136	11	15
1987	FW_pair1987	FakeAnc1987	FakeDesc1987	SIMULPF00001	34	38	44	28	10	6
1988	FW_pair1988	FakeAnc1988	FakeDesc1988	SIMULPF00001	56	58	60	54	4	2
1989	FW_pair1989	FakeAnc1989	FakeDesc1989	SIMULPF00001	56	58	62	52	6	4
1990	FW_pair1990	FakeAnc1990	FakeDesc1990	SIMULPF00001	61	57	65	53	4	8
1991	FW_pair1991	FakeAnc1991	FakeDesc1991	SIMULPF00001	160	171	187	144	27	16
1992	FW_pair1992	FakeAnc1992	FakeDesc1992	SIMULPF00001	155	151	172	134	17	21
1993	FW_pair1993	FakeAnc1993	FakeDesc1993	SIMULPF00001	387	390	417	360	30	27
1994	FW_pair1994	FakeAnc1994	FakeDesc1994	SIMULPF00001	549	552	605	496	56	53
1995	FW_pair1995	FakeAnc1995	FakeDesc1995	SIMULPF00001	90	95	97	88	7	2
1996	FW_pair1996	FakeAnc1996	FakeDesc1996	SIMULPF00001	374	371	404	341	30	33
1997	FW_pair1997	FakeAnc1997	FakeDesc1997	SIMULPF00001	363	366	404	325	41	38
1998	FW_pair1998	FakeAnc1998	FakeDesc1998	SIMULPF00001	517	503	560	460	43	57
1999	FW_pair1999	FakeAnc1999	FakeDesc1999	SIMULPF00001	29	32	35	26	6	3
2000	FW_pair2000	FakeAnc2000	FakeDesc2000	SIMULPF00001	63	58	66	55	3	8
2001	FW_pair2001	FakeAnc2001	FakeDesc2001	SIMULPF00001	57	59	63	53	6	4
2002	FW_pair2002	FakeAnc2002	FakeDesc2002	SIMULPF00001	242	233	258	217	16	25
2003	FW_pair2003	FakeAnc2003	FakeDesc2003	SIMULPF00001	63	72	76	59	13	4
2004	FW_pair2004	FakeAnc2004	FakeDesc2004	SIMULPF00001	10	10	11	9	1	1
2005	FW_pair2005	FakeAnc2005	FakeDesc2005	SIMULPF00001	29	27	31	25	2	4
2006	FW_pair2006	FakeAnc2006	FakeDesc2006	SIMULPF00001	24	21	25	20	1	4
2007	FW_pair2007	FakeAnc2007	FakeDesc2007	SIMULPF00001	191	203	214	180	23	11
2008	FW_pair2008	FakeAnc2008	FakeDesc2008	SIMULPF00001	299	307	331	275	32	24
2009	FW_pair2009	FakeAnc2009	FakeDesc2009	SIMULPF00001	140	138	156	122	16	18
2010	FW_pair2010	FakeAnc2010	FakeDesc2010	SIMULPF00001	161	166	180	147	19	14
2011	FW_pair2011	FakeAnc2011	FakeDesc2011	SIMULPF00001	42	39	42	39	0	3
2012	FW_pair2012	FakeAnc2012	FakeDesc2012	SIMULPF00001	152	154	169	137	17	15
2013	FW_pair2013	FakeAnc2013	FakeDesc2013	SIMULPF00001	152	154	169	137	17	15
2014	FW_pair2014	FakeAnc2014	FakeDesc2014	SIMULPF00001	91	94	100	85	9	6
2015	FW_pair2015	FakeAnc2015	FakeDesc2015	SIMULPF00001	284	289	318	255	34	29
2016	FW_pair2016	FakeAnc2016	FakeDesc2016	SIMULPF00001	240	240	265	215	25	25
2017	FW_pair2017	FakeAnc2017	FakeDesc2017	SIMULPF00001	508	510	552	466	44	42
2018	FW_pair2018	FakeAnc2018	FakeDesc2018	SIMULPF00001	83	84	89	78	6	5
2019	FW_pair2019	FakeAnc2019	FakeDesc2019	SIMULPF00001	112	114	124	102	12	10
2020	FW_pair2020	FakeAnc2020	FakeDesc2020	SIMULPF00001	785	783	861	707	76	78
2021	FW_pair2021	FakeAnc2021	FakeDesc2021	SIMULPF00001	112	104	118	98	6	14
2022	FW_pair2022	FakeAnc2022	FakeDesc2022	SIMULPF00001	260	250	279	231	19	29
2023	FW_pair2023	FakeAnc2023	FakeDesc2023	SIMULPF00001	692	709	760	641	68	51
2024	FW_pair2024	FakeAnc2024	FakeDesc2024	SIMULPF00001	234	226	253	207	19	27
2025	FW_pair2025	FakeAnc2025	FakeDesc2025	SIMULPF00001	336	340	361	315	25	21
2026	FW_pair2026	FakeAnc2026	FakeDesc2026	SIMULPF00001	19	19	22	16	3	3
2027	FW_pair2027	FakeAnc2027	FakeDesc2027	SIMULPF00001	24	31	31	24	7	0
2028	FW_pair2028	FakeAnc2028	FakeDesc2028	SIMULPF00001	31	32	32	31	1	0
2029	FW_pair2029	FakeAnc2029	FakeDesc2029	SIMULPF00001	568	563	607	524	39	44
2030	FW_pair2030	FakeAnc2030	FakeDesc2030	SIMULPF00001	388	380	428	340	40	48
2031	FW_pair2031	FakeAnc2031	FakeDesc2031	SIMULPF00001	709	699	766	642	57	67
2032	FW_pair2032	FakeAnc2032	FakeDesc2032	SIMULPF00001	206	213	228	191	22	15
2033	FW_pair2033	FakeAnc2033	FakeDesc2033	SIMULPF00001	212	209	232	189	20	23
2034	FW_pair2034	FakeAnc2034	FakeDesc2034	SIMULPF00001	17	17	19	15	2	2
2035	FW_pair2035	FakeAnc2035	FakeDesc2035	SIMULPF00001	415	425	463	377	48	38
2036	FW_pair2036	FakeAnc2036	FakeDesc2036	SIMULPF00001	612	605	661	556	49	56
2037	FW_pair2037	FakeAnc2037	FakeDesc2037	SIMULPF00001	11	13	13	11	2	0
2038	FW_pair2038	FakeAnc2038	FakeDesc2038	SIMULPF00001	112	123	128	107	16	5
2039	FW_pair2039	FakeAnc2039	FakeDesc2039	SIMULPF00001	86	84	90	80	4	6
2040	FW_pair2040	FakeAnc2040	FakeDesc2040	SIMULPF00001	41	38	43	36	2	5
2041	FW_pair2041	FakeAnc2041	FakeDesc2041	SIMULPF00001	266	275	301	240	35	26
2042	FW_pair2042	FakeAnc2042	FakeDesc2042	SIMULPF00001	172	172	186	158	14	14
2043	FW_pair2043	FakeAnc2043	FakeDesc2043	SIMULPF00001	106	97	115	88	9	18
2044	FW_pair2044	FakeAnc2044	FakeDesc2044	SIMULPF00001	31	34	35	30	4	1
2045	FW_pair2045	FakeAnc2045	FakeDesc2045	SIMULPF00001	265	258	287	236	22	29
2046	FW_pair2046	FakeAnc2046	FakeDesc2046	SIMULPF00001	58	49	60	47	2	11
2047	FW_pair2047	FakeAnc2047	FakeDesc2047	SIMULPF00001	101	104	110	95	9	6
2048	FW_pair2048	FakeAnc2048	FakeDesc2048	SIMULPF00001	104	97	116	85	12	19
2049	FW_pair2049	FakeAnc2049	FakeDesc2049	SIMULPF00001	128	121	133	116	5	12
2050	FW_pair2050	FakeAnc2050	FakeDesc2050	SIMULPF00001	52	52	59	45	7	7
2051	FW_pair2051	FakeAnc2051	FakeDesc2051	SIMULPF00001	27	30	30	27	3	0
2052	FW_pair2052	FakeAnc2052	FakeDesc2052	SIMULPF00001	399	387	442	344	43	55
2053	FW_pair2053	FakeAnc2053	FakeDesc2053	SIMULPF00001	446	450	487	409	41	37
2054	FW_pair2054	FakeAnc2054	FakeDesc2054	SIMULPF00001	59	59	63	55	4	4
2055	FW_pair2055	FakeAnc2055	FakeDesc2055	SIMULPF00001	321	312	346	287	25	34
2056	FW_pair2056	FakeAnc2056	FakeDesc2056	SIMULPF00001	7	9	10	6	3	1
2057	FW_pair2057	FakeAnc2057	FakeDesc2057	SIMULPF00001	689	698	771	616	82	73
2058	FW_pair2058	FakeAnc2058	FakeDesc2058	SIMULPF00001	128	133	141	120	13	8
2059	FW_pair2059	FakeAnc2059	FakeDesc2059	SIMULPF00001	46	48	50	44	4	2
2060	FW_pair2060	FakeAnc2060	FakeDesc2060	SIMULPF00001	194	209	222	181	28	13
2061	FW_pair2061	FakeAnc2061	FakeDesc2061	SIMULPF00001	196	187	205	178	9	18
2062	FW_pair2062	FakeAnc2062	FakeDesc2062	SIMULPF00001	136	144	150	130	14	6
2063	FW_pair2063	FakeAnc2063	FakeDesc2063	SIMULPF00001	58	58	61	55	3	3
2064	FW_pair2064	FakeAnc2064	FakeDesc2064	SIMULPF00001	339	341	366	314	27	25
2065	FW_pair2065	FakeAnc2065	FakeDesc2065	SIMULPF00001	22	17	22	17	0	5
2066	FW_pair2066	FakeAnc2066	FakeDesc2066	SIMULPF00001	37	35	38	34	1	3
2067	FW_pair2067	FakeAnc2067	FakeDesc2067	SIMULPF00001	357	344	389	312	32	45
2068	FW_pair2068	FakeAnc2068	FakeDesc2068	SIMULPF00001	226	210	233	203	7	23
2069	FW_pair2069	FakeAnc2069	FakeDesc2069	SIMULPF00001	5	3	6	2	1	3
2070	FW_pair2070	FakeAnc2070	FakeDesc2070	SIMULPF00001	228	223	249	202	21	26
2071	FW_pair2071	FakeAnc2071	FakeDesc2071	SIMULPF00001	146	147	163	130	17	16
2072	FW_pair2072	FakeAnc2072	FakeDesc2072	SIMULPF00001	40	42	43	39	3	1
2073	FW_pair2073	FakeAnc2073	FakeDesc2073	SIMULPF00001	152	156	169	139	17	13
2074	FW_pair2074	FakeAnc2074	FakeDesc2074	SIMULPF00001	189	185	201	173	12	16
2075	FW_pair2075	FakeAnc2075	FakeDesc2075	SIMULPF00001	677	673	727	623	50	54
2076	FW_pair2076	FakeAnc2076	FakeDesc2076	SIMULPF00001	56	52	57	51	1	5
2077	FW_pair2077	FakeAnc2077	FakeDesc2077	SIMULPF00001	133	140	147	126	14	7
2078	FW_pair2078	FakeAnc2078	FakeDesc2078	SIMULPF00001	62	65	70	57	8	5
2079	FW_pair2079	FakeAnc2079	FakeDesc2079	SIMULPF00001	84	86	94	76	10	8
2080	FW_pair2080	FakeAnc2080	FakeDesc2080	SIMULPF00001	33	34	37	30	4	3
2081	FW_pair2081	FakeAnc2081	FakeDesc2081	SIMULPF00001	168	188	198	158	30	10
2082	FW_pair2082	FakeAnc2082	FakeDesc2082	SIMULPF00001	31	28	32	27	1	4
2083	FW_pair2083	FakeAnc2083	FakeDesc2083	SIMULPF00001	151	156	170	137	19	14
2084	FW_pair2084	FakeAnc2084	FakeDesc2084	SIMULPF00001	346	344	374	316	28	30
2085	FW_pair2085	FakeAnc2085	FakeDesc2085	SIMULPF00001	156	158	171	143	15	13
2086	FW_pair2086	FakeAnc2086	FakeDesc2086	SIMULPF00001	20	21	25	16	5	4
2087	FW_pair2087	FakeAnc2087	FakeDesc2087	SIMULPF00001	23	24	25	22	2	1
2088	FW_pair2088	FakeAnc2088	FakeDesc2088	SIMULPF00001	71	65	74	62	3	9
2089	FW_pair2089	FakeAnc2089	FakeDesc2089	SIMULPF00001	149	141	163	127	14	22
2090	FW_pair2090	FakeAnc2090	FakeDesc2090	SIMULPF00001	204	203	226	181	22	23
2091	FW_pair2091	FakeAnc2091	FakeDesc2091	SIMULPF00001	325	319	345	299	20	26
2092	FW_pair2092	FakeAnc2092	FakeDesc2092	SIMULPF00001	110	99	121	88	11	22
2093	FW_pair2093	FakeAnc2093	FakeDesc2093	SIMULPF00001	130	132	144	118	14	12
2094	FW_pair2094	FakeAnc2094	FakeDesc2094	SIMULPF00001	278	291	304	265	26	13
2095	FW_pair2095	FakeAnc2095	FakeDesc2095	SIMULPF00001	320	304	346	278	26	42
2096	FW_pair2096	FakeAnc2096	FakeDesc2096	SIMULPF00001	500	487	539	448	39	52
2097	FW_pair2097	FakeAnc2097	FakeDesc2097	SIMULPF00001	678	679	749	608	71	70
2098	FW_pair2098	FakeAnc2098	FakeDesc2098	SIMULPF00001	145	143	161	127	16	18
2099	FW_pair2099	FakeAnc2099	FakeDesc2099	SIMULPF00001	116	129	138	107	22	9
2100	FW_pair2100	FakeAnc2100	FakeDesc2100	SIMULPF00001	126	117	140	103	14	23
2101	FW_pair2101	FakeAnc2101	FakeDesc2101	SIMULPF00001	223	232	243	212	20	11
2102	FW_pair2102	FakeAnc2102	FakeDesc2102	SIMULPF00001	181	182	197	166	16	15
2103	FW_pair2103	FakeAnc2103	FakeDesc2103	SIMULPF00001	495	502	556	441	61	54
2104	FW_pair2104	FakeAnc2104	FakeDesc2104	SIMULPF00001	101	97	107	91	6	10
2105	FW_pair2105	FakeAnc2105	FakeDesc2105	SIMULPF00001	41	39	45	35	4	6
2106	FW_pair2106	FakeAnc2106	FakeDesc2106	SIMULPF00001	40	35	41	34	1	6
2107	FW_pair2107	FakeAnc2107	FakeDesc2107	SIMULPF00001	525	536	586	475	61	50
2108	FW_pair2108	FakeAnc2108	FakeDesc2108	SIMULPF00001	267	260	282	245	15	22
2109	FW_pair2109	FakeAnc2109	FakeDesc2109	SIMULPF00001	251	252	277	226	26	25
2110	FW_pair2110	FakeAnc2110	FakeDesc2110	SIMULPF00001	200	207	227	180	27	20
2111	FW_pair2111	FakeAnc2111	FakeDesc2111	SIMULPF00001	515	534	568	481	53	34
2112	FW_pair2112	FakeAnc2112	FakeDesc2112	SIMULPF00001	24	22	25	21	1	3
2113	FW_pair2113	FakeAnc2113	FakeDesc2113	SIMULPF00001	374	387	417	344	43	30
2114	FW_pair2114	FakeAnc2114	FakeDesc2114	SIMULPF00001	59	63	69	53	10	6
2115	FW_pair2115	FakeAnc2115	FakeDesc2115	SIMULPF00001	525	509	572	462	47	63
2116	FW_pair2116	FakeAnc2116	FakeDesc2116	SIMULPF00001	164	173	185	152	21	12
2117	FW_pair2117	FakeAnc2117	FakeDesc2117	SIMULPF00001	289	287	317	259	28	30
2118	FW_pair2118	FakeAnc2118	FakeDesc2118	SIMULPF00001	192	185	206	171	14	21
2119	FW_pair2119	FakeAnc2119	FakeDesc2119	SIMULPF00001	736	745	808	673	72	63
2120	FW_pair2120	FakeAnc2120	FakeDesc2120	SIMULPF00001	188	195	210	173	22	15
2121	FW_pair2121	FakeAnc2121	FakeDesc2121	SIMULPF00001	28	25	28	25	0	3
2122	FW_pair2122	FakeAnc2122	FakeDesc2122	SIMULPF00001	290	309	335	264	45	26
2123	FW_pair2123	FakeAnc2123	FakeDesc2123	SIMULPF00001	372	366	398	340	26	32
2124	FW_pair2124	FakeAnc2124	FakeDesc2124	SIMULPF00001	291	295	319	267	28	24
2125	FW_pair2125	FakeAnc2125	FakeDesc2125	SIMULPF00001	284	292	321	255	37	29
2126	FW_pair2126	FakeAnc2126	FakeDesc2126	SIMULPF00001	175	171	187	159	12	16
2127	FW_pair2127	FakeAnc2127	FakeDesc2127	SIMULPF00001	275	269	290	254	15	21
2128	FW_pair2128	FakeAnc2128	FakeDesc2128	SIMULPF00001	66	70	73	63	7	3
2129	FW_pair2129	FakeAnc2129	FakeDesc2129	SIMULPF00001	23	24	24	23	1	0
2130	FW_pair2130	FakeAnc2130	FakeDesc2130	SIMULPF00001	175	173	192	156	17	19
2131	FW_pair2131	FakeAnc2131	FakeDesc2131	SIMULPF00001	85	87	90	82	5	3
2132	FW_pair2132	FakeAnc2132	FakeDesc2132	SIMULPF00001	262	262	287	237	25	25
2133	FW_pair2133	FakeAnc2133	FakeDesc2133	SIMULPF00001	674	669	736	607	62	67
2134	FW_pair2134	FakeAnc2134	FakeDesc2134	SIMULPF00001	748	751	816	683	68	65
2135	FW_pair2135	FakeAnc2135	FakeDesc2135	SIMULPF00001	190	181	202	169	12	21
2136	FW_pair2136	FakeAnc2136	FakeDesc2136	SIMULPF00001	489	503	545	447	56	42
2137	FW_pair2137	FakeAnc2137	FakeDesc2137	SIMULPF00001	251	250	278	223	27	28
2138	FW_pair2138	FakeAnc2138	FakeDesc2138	SIMULPF00001	27	25	28	24	1	3
2139	FW_pair2139	FakeAnc2139	FakeDesc2139	SIMULPF00001	199	209	227	181	28	18
2140	FW_pair2140	FakeAnc2140	FakeDesc2140	SIMULPF00001	155	156	168	143	13	12
2141	FW_pair2141	FakeAnc2141	FakeDesc2141	SIMULPF00001	109	120	125	104	16	5
2142	FW_pair2142	FakeAnc2142	FakeDesc2142	SIMULPF00001	19	14	19	14	0	5
2143	FW_pair2143	FakeAnc2143	FakeDesc2143	SIMULPF00001	120	114	128	106	8	14
2144	FW_pair2144	FakeAnc2144	FakeDesc2144	SIMULPF00001	88	80	94	74	6	14
2145	FW_pair2145	FakeAnc2145	FakeDesc2145	SIMULPF00001	134	135	147	122	13	12
2146	FW_pair2146	FakeAnc2146	FakeDesc2146	SIMULPF00001	107	115	123	99	16	8
2147	FW_pair2147	FakeAnc2147	FakeDesc2147	SIMULPF00001	242	256	278	220	36	22
2148	FW_pair2148	FakeAnc2148	FakeDesc2148	SIMULPF00001	315	327	358	284	43	31
2149	FW_pair2149	FakeAnc2149	FakeDesc2149	SIMULPF00001	393	387	431	349	38	44
2150	FW_pair2150	FakeAnc2150	FakeDesc2150	SIMULPF00001	157	155	165	147	8	10
2151	FW_pair2151	FakeAnc2151	FakeDesc2151	SIMULPF00001	14	13	14	13	0	1
2152	FW_pair2152	FakeAnc2152	FakeDesc2152	SIMULPF00001	111	106	120	97	9	14
2153	FW_pair2153	FakeAnc2153	FakeDesc2153	SIMULPF00001	552	551	590	513	38	39
2154	FW_pair2154	FakeAnc2154	FakeDesc2154	SIMULPF00001	79	76	91	64	12	15
2155	FW_pair2155	FakeAnc2155	FakeDesc2155	SIMULPF00001	461	452	496	417	35	44
2156	FW_pair2156	FakeAnc2156	FakeDesc2156	SIMULPF00001	298	304	326	276	28	22
2157	FW_pair2157	FakeAnc2157	FakeDesc2157	SIMULPF00001	73	67	77	63	4	10
2158	FW_pair2158	FakeAnc2158	FakeDesc2158	SIMULPF00001	223	233	262	194	39	29
2159	FW_pair2159	FakeAnc2159	FakeDesc2159	SIMULPF00001	132	134	144	122	12	10
2160	FW_pair2160	FakeAnc2160	FakeDesc2160	SIMULPF00001	91	90	97	84	6	7
2161	FW_pair2161	FakeAnc2161	FakeDesc2161	SIMULPF00001	554	567	605	516	51	38
2162	FW_pair2162	FakeAnc2162	FakeDesc2162	SIMULPF00001	108	106	116	98	8	10
2163	FW_pair2163	FakeAnc2163	FakeDesc2163	SIMULPF00001	49	53	54	48	5	1
2164	FW_pair2164	FakeAnc2164	FakeDesc2164	SIMULPF00001	227	232	254	205	27	22
2165	FW_pair2165	FakeAnc2165	FakeDesc2165	SIMULPF00001	340	339	374	305	34	35
2166	FW_pair2166	FakeAnc2166	FakeDesc2166	SIMULPF00001	62	59	65	56	3	6
2167	FW_pair2167	FakeAnc2167	FakeDesc2167	SIMULPF00001	8	8	9	7	1	1
2168	FW_pair2168	FakeAnc2168	FakeDesc2168	SIMULPF00001	385	409	441	353	56	32
2169	FW_pair2169	FakeAnc2169	FakeDesc2169	SIMULPF00001	62	62	67	57	5	5
2170	FW_pair2170	FakeAnc2170	FakeDesc2170	SIMULPF00001	575	569	617	527	42	48
2171	FW_pair2171	FakeAnc2171	FakeDesc2171	SIMULPF00001	41	39	46	34	5	7
2172	FW_pair2172	FakeAnc2172	FakeDesc2172	SIMULPF00001	9	7	10	6	1	3
2173	FW_pair2173	FakeAnc2173	FakeDesc2173	SIMULPF00001	146	160	170	136	24	10
2174	FW_pair2174	FakeAnc2174	FakeDesc2174	SIMULPF00001	168	160	182	146	14	22
2175	FW_pair2175	FakeAnc2175	FakeDesc2175	SIMULPF00001	14	15	15	14	1	0
2176	FW_pair2176	FakeAnc2176	FakeDesc2176	SIMULPF00001	229	234	255	208	26	21
2177	FW_pair2177	FakeAnc2177	FakeDesc2177	SIMULPF00001	188	190	206	172	18	16
2178	FW_pair2178	FakeAnc2178	FakeDesc2178	SIMULPF00001	220	205	233	192	13	28
2179	FW_pair2179	FakeAnc2179	FakeDesc2179	SIMULPF00001	138	132	148	122	10	16
2180	FW_pair2180	FakeAnc2180	FakeDesc2180	SIMULPF00001	9	10	11	8	2	1
2181	FW_pair2181	FakeAnc2181	FakeDesc2181	SIMULPF00001	74	74	80	68	6	6
2182	FW_pair2182	FakeAnc2182	FakeDesc2182	SIMULPF00001	275	274	299	250	24	25
2183	FW_pair2183	FakeAnc2183	FakeDesc2183	SIMULPF00001	588	590	634	544	46	44
2184	FW_pair2184	FakeAnc2184	FakeDesc2184	SIMULPF00001	111	117	124	104	13	7
2185	FW_pair2185	FakeAnc2185	FakeDesc2185	SIMULPF00001	137	135	154	118	17	19
2186	FW_pair2186	FakeAnc2186	FakeDesc2186	SIMULPF00001	12	11	12	11	0	1
2187	FW_pair2187	FakeAnc2187	FakeDesc2187	SIMULPF00001	526	534	583	477	57	49
2188	FW_pair2188	FakeAnc2188	FakeDesc2188	SIMULPF00001	292	290	317	265	25	27
2189	FW_pair2189	FakeAnc2189	FakeDesc2189	SIMULPF00001	90	89	101	78	11	12
2190	FW_pair2190	FakeAnc2190	FakeDesc2190	SIMULPF00001	42	45	49	38	7	4
2191	FW_pair2191	FakeAnc2191	FakeDesc2191	SIMULPF00001	81	87	96	72	15	9
2192	FW_pair2192	FakeAnc2192	FakeDesc2192	SIMULPF00001	376	379	405	350	29	26
2193	FW_pair2193	FakeAnc2193	FakeDesc2193	SIMULPF00001	259	265	283	241	24	18
2194	FW_pair2194	FakeAnc2194	FakeDesc2194	SIMULPF00001	433	419	476	376	43	57
2195	FW_pair2195	FakeAnc2195	FakeDesc2195	SIMULPF00001	109	115	125	99	16	10
2196	FW_pair2196	FakeAnc2196	FakeDesc2196	SIMULPF00001	194	194	218	170	24	24
2197	FW_pair2197	FakeAnc2197	FakeDesc2197	SIMULPF00001	118	112	122	108	4	10
2198	FW_pair2198	FakeAnc2198	FakeDesc2198	SIMULPF00001	265	290	300	255	35	10
2199	FW_pair2199	FakeAnc2199	FakeDesc2199	SIMULPF00001	2	2	2	2	0	0
2200	FW_pair2200	FakeAnc2200	FakeDesc2200	SIMULPF00001	218	223	235	206	17	12
2201	FW_pair2201	FakeAnc2201	FakeDesc2201	SIMULPF00001	220	229	244	205	24	15
2202	FW_pair2202	FakeAnc2202	FakeDesc2202	SIMULPF00001	86	86	93	79	7	7
2203	FW_pair2203	FakeAnc2203	FakeDesc2203	SIMULPF00001	77	81	90	68	13	9
2204	FW_pair2204	FakeAnc2204	FakeDesc2204	SIMULPF00001	278	277	304	251	26	27
2205	FW_pair2205	FakeAnc2205	FakeDesc2205	SIMULPF00001	33	31	36	28	3	5
2206	FW_pair2206	FakeAnc2206	FakeDesc2206	SIMULPF00001	78	76	85	69	7	9
2207	FW_pair2207	FakeAnc2207	FakeDesc2207	SIMULPF00001	247	259	281	225	34	22
2208	FW_pair2208	FakeAnc2208	FakeDesc2208	SIMULPF00001	30	31	32	29	2	1
2209	FW_pair2209	FakeAnc2209	FakeDesc2209	SIMULPF00001	240	243	267	216	27	24
2210	FW_pair2210	FakeAnc2210	FakeDesc2210	SIMULPF00001	280	288	309	259	29	21
2211	FW_pair2211	FakeAnc2211	FakeDesc2211	SIMULPF00001	386	391	424	353	38	33
2212	FW_pair2212	FakeAnc2212	FakeDesc2212	SIMULPF00001	433	425	472	386	39	47
2213	FW_pair2213	FakeAnc2213	FakeDesc2213	SIMULPF00001	597	599	658	538	61	59
2214	FW_pair2214	FakeAnc2214	FakeDesc2214	SIMULPF00001	50	52	56	46	6	4
2215	FW_pair2215	FakeAnc2215	FakeDesc2215	SIMULPF00001	85	77	90	72	5	13
2216	FW_pair2216	FakeAnc2216	FakeDesc2216	SIMULPF00001	273	270	294	249	21	24
2217	FW_pair2217	FakeAnc2217	FakeDesc2217	SIMULPF00001	156	147	169	134	13	22
2218	FW_pair2218	FakeAnc2218	FakeDesc2218	SIMULPF00001	426	446	471	401	45	25
2219	FW_pair2219	FakeAnc2219	FakeDesc2219	SIMULPF00001	819	801	884	736	65	83
2220	FW_pair2220	FakeAnc2220	FakeDesc2220	SIMULPF00001	251	255	280	226	29	25
2221	FW_pair2221	FakeAnc2221	FakeDesc2221	SIMULPF00001	113	114	120	107	7	6
2222	FW_pair2222	FakeAnc2222	FakeDesc2222	SIMULPF00001	94	86	97	83	3	11
2223	FW_pair2223	FakeAnc2223	FakeDesc2223	SIMULPF00001	341	348	378	311	37	30
2224	FW_pair2224	FakeAnc2224	FakeDesc2224	SIMULPF00001	365	364	400	329	35	36
2225	FW_pair2225	FakeAnc2225	FakeDesc2225	SIMULPF00001	59	58	64	53	5	6
2226	FW_pair2226	FakeAnc2226	FakeDesc2226	SIMULPF00001	10	10	10	10	0	0
2227	FW_pair2227	FakeAnc2227	FakeDesc2227	SIMULPF00001	255	258	278	235	23	20
2228	FW_pair2228	FakeAnc2228	FakeDesc2228	SIMULPF00001	2	3	3	2	1	0
2229	FW_pair2229	FakeAnc2229	FakeDesc2229	SIMULPF00001	123	111	132	102	9	21
2230	FW_pair2230	FakeAnc2230	FakeDesc2230	SIMULPF00001	426	414	458	382	32	44
2231	FW_pair2231	FakeAnc2231	FakeDesc2231	SIMULPF00001	111	110	125	96	14	15
2232	FW_pair2232	FakeAnc2232	FakeDesc2232	SIMULPF00001	22	21	23	20	1	2
2233	FW_pair2233	FakeAnc2233	FakeDesc2233	SIMULPF00001	123	131	141	113	18	10
2234	FW_pair2234	FakeAnc2234	FakeDesc2234	SIMULPF00001	85	81	87	79	2	6
2235	FW_pair2235	FakeAnc2235	FakeDesc2235	SIMULPF00001	395	407	436	366	41	29
2236	FW_pair2236	FakeAnc2236	FakeDesc2236	SIMULPF00001	255	249	273	231	18	24
2237	FW_pair2237	FakeAnc2237	FakeDesc2237	SIMULPF00001	16	13	16	13	0	3
2238	FW_pair2238	FakeAnc2238	FakeDesc2238	SIMULPF00001	67	63	73	57	6	10
2239	FW_pair2239	FakeAnc2239	FakeDesc2239	SIMULPF00001	132	123	148	107	16	25
2240	FW_pair2240	FakeAnc2240	FakeDesc2240	SIMULPF00001	120	119	132	107	12	13
2241	FW_pair2241	FakeAnc2241	FakeDesc2241	SIMULPF00001	147	152	164	135	17	12
2242	FW_pair2242	FakeAnc2242	FakeDesc2242	SIMULPF00001	141	143	154	130	13	11
2243	FW_pair2243	FakeAnc2243	FakeDesc2243	SIMULPF00001	32	33	37	28	5	4
2244	FW_pair2244	FakeAnc2244	FakeDesc2244	SIMULPF00001	253	251	279	225	26	28
2245	FW_pair2245	FakeAnc2245	FakeDesc2245	SIMULPF00001	303	305	330	278	27	25
2246	FW_pair2246	FakeAnc2246	FakeDesc2246	SIMULPF00001	15	15	15	15	0	0
2247	FW_pair2247	FakeAnc2247	FakeDesc2247	SIMULPF00001	322	316	346	292	24	30
2248	FW_pair2248	FakeAnc2248	FakeDesc2248	SIMULPF00001	11	11	12	10	1	1
2249	FW_pair2249	FakeAnc2249	FakeDesc2249	SIMULPF00001	712	724	785	651	73	61
2250	FW_pair2250	FakeAnc2250	FakeDesc2250	SIMULPF00001	56	57	63	50	7	6
2251	FW_pair2251	FakeAnc2251	FakeDesc2251	SIMULPF00001	106	104	115	95	9	11
2252	FW_pair2252	FakeAnc2252	FakeDesc2252	SIMULPF00001	55	53	60	48	5	7
2253	FW_pair2253	FakeAnc2253	FakeDesc2253	SIMULPF00001	361	355	391	325	30	36
2254	FW_pair2254	FakeAnc2254	FakeDesc2254	SIMULPF00001	183	192	204	171	21	12
2255	FW_pair2255	FakeAnc2255	FakeDesc2255	SIMULPF00001	3	3	3	3	0	0
2256	FW_pair2256	FakeAnc2256	FakeDesc2256	SIMULPF00001	9	8	9	8	0	1
2257	FW_pair2257	FakeAnc2257	FakeDesc2257	SIMULPF00001	239	247	265	221	26	18
2258	FW_pair2258	FakeAnc2258	FakeDesc2258	SIMULPF00001	271	274	295	250	24	21
2259	FW_pair2259	FakeAnc2259	FakeDesc2259	SIMULPF00001	62	64	65	61	3	1
2260	FW_pair2260	FakeAnc2260	FakeDesc2260	SIMULPF00001	34	34	41	27	7	7
2261	FW_pair2261	FakeAnc2261	FakeDesc2261	SIMULPF00001	154	140	159	135	5	19
2262	FW_pair2262	FakeAnc2262	FakeDesc2262	SIMULPF00001	293	284	321	256	28	37
2263	FW_pair2263	FakeAnc2263	FakeDesc2263	SIMULPF00001	241	233	257	217	16	24
2264	FW_pair2264	FakeAnc2264	FakeDesc2264	SIMULPF00001	301	322	339	284	38	17
2265	FW_pair2265	FakeAnc2265	FakeDesc2265	SIMULPF00001	128	136	145	119	17	9
2266	FW_pair2266	FakeAnc2266	FakeDesc2266	SIMULPF00001	351	344	385	310	34	41
2267	FW_pair2267	FakeAnc2267	FakeDesc2267	SIMULPF00001	10	8	10	8	0	2
2268	FW_pair2268	FakeAnc2268	FakeDesc2268	SIMULPF00001	199	177	208	168	9	31
2269	FW_pair2269	FakeAnc2269	FakeDesc2269	SIMULPF00001	312	314	346	280	34	32
2270	FW_pair2270	FakeAnc2270	FakeDesc2270	SIMULPF00001	43	37	44	36	1	7
2271	FW_pair2271	FakeAnc2271	FakeDesc2271	SIMULPF00001	755	759	817	697	62	58
2272	FW_pair2272	FakeAnc2272	FakeDesc2272	SIMULPF00001	492	488	544	436	52	56
2273	FW_pair2273	FakeAnc2273	FakeDesc2273	SIMULPF00001	204	209	226	187	22	17
2274	FW_pair2274	FakeAnc2274	FakeDesc2274	SIMULPF00001	290	287	318	259	28	31
2275	FW_pair2275	FakeAnc2275	FakeDesc2275	SIMULPF00001	145	138	153	130	8	15
2276	FW_pair2276	FakeAnc2276	FakeDesc2276	SIMULPF00001	496	506	554	448	58	48
2277	FW_pair2277	FakeAnc2277	FakeDesc2277	SIMULPF00001	8	10	10	8	2	0
2278	FW_pair2278	FakeAnc2278	FakeDesc2278	SIMULPF00001	366	363	402	327	36	39
2279	FW_pair2279	FakeAnc2279	FakeDesc2279	SIMULPF00001	94	100	105	89	11	5
2280	FW_pair2280	FakeAnc2280	FakeDesc2280	SIMULPF00001	508	507	555	460	47	48
2281	FW_pair2281	FakeAnc2281	FakeDesc2281	SIMULPF00001	209	208	230	187	21	22
2282	FW_pair2282	FakeAnc2282	FakeDesc2282	SIMULPF00001	82	90	95	77	13	5
2283	FW_pair2283	FakeAnc2283	FakeDesc2283	SIMULPF00001	122	135	139	118	17	4
2284	FW_pair2284	FakeAnc2284	FakeDesc2284	SIMULPF00001	683	700	750	633	67	50
2285	FW_pair2285	FakeAnc2285	FakeDesc2285	SIMULPF00001	209	203	228	184	19	25
2286	FW_pair2286	FakeAnc2286	FakeDesc2286	SIMULPF00001	182	181	195	168	13	14
2287	FW_pair2287	FakeAnc2287	FakeDesc2287	SIMULPF00001	146	161	165	142	19	4
2288	FW_pair2288	FakeAnc2288	FakeDesc2288	SIMULPF00001	81	83	89	75	8	6
2289	FW_pair2289	FakeAnc2289	FakeDesc2289	SIMULPF00001	42	40	44	38	2	4
2290	FW_pair2290	FakeAnc2290	FakeDesc2290	SIMULPF00001	457	448	493	412	36	45
2291	FW_pair2291	FakeAnc2291	FakeDesc2291	SIMULPF00001	195	190	209	176	14	19
2292	FW_pair2292	FakeAnc2292	FakeDesc2292	SIMULPF00001	93	93	98	88	5	5
2293	FW_pair2293	FakeAnc2293	FakeDesc2293	SIMULPF00001	20	23	23	20	3	0
2294	FW_pair2294	FakeAnc2294	FakeDesc2294	SIMULPF00001	131	128	147	112	16	19
2295	FW_pair2295	FakeAnc2295	FakeDesc2295	SIMULPF00001	172	172	190	154	18	18
2296	FW_pair2296	FakeAnc2296	FakeDesc2296	SIMULPF00001	35	35	37	33	2	2
2297	FW_pair2297	FakeAnc2297	FakeDesc2297	SIMULPF00001	106	102	114	94	8	12
2298	FW_pair2298	FakeAnc2298	FakeDesc2298	SIMULPF00001	14	15	20	9	6	5
2299	FW_pair2299	FakeAnc2299	FakeDesc2299	SIMULPF00001	7	7	7	7	0	0
2300	FW_pair2300	FakeAnc2300	FakeDesc2300	SIMULPF00001	190	185	200	175	10	15
2301	FW_pair2301	FakeAnc2301	FakeDesc2301	SIMULPF00001	50	54	54	50	4	0
2302	FW_pair2302	FakeAnc2302	FakeDesc2302	SIMULPF00001	68	64	75	57	7	11
2303	FW_pair2303	FakeAnc2303	FakeDesc2303	SIMULPF00001	91	88	97	82	6	9
2304	FW_pair2304	FakeAnc2304	FakeDesc2304	SIMULPF00001	193	196	220	169	27	24
2305	FW_pair2305	FakeAnc2305	FakeDesc2305	SIMULPF00001	537	545	595	487	58	50
2306	FW_pair2306	FakeAnc2306	FakeDesc2306	SIMULPF00001	90	107	114	83	24	7
2307	FW_pair2307	FakeAnc2307	FakeDesc2307	SIMULPF00001	275	272	298	249	23	26
2308	FW_pair2308	FakeAnc2308	FakeDesc2308	SIMULPF00001	425	421	469	377	44	48
2309	FW_pair2309	FakeAnc2309	FakeDesc2309	SIMULPF00001	30	30	32	28	2	2
2310	FW_pair2310	FakeAnc2310	FakeDesc2310	SIMULPF00001	579	593	636	536	57	43
2311	FW_pair2311	FakeAnc2311	FakeDesc2311	SIMULPF00001	43	53	54	42	11	1
2312	FW_pair2312	FakeAnc2312	FakeDesc2312	SIMULPF00001	480	480	530	430	50	50
2313	FW_pair2313	FakeAnc2313	FakeDesc2313	SIMULPF00001	29	30	33	26	4	3
2314	FW_pair2314	FakeAnc2314	FakeDesc2314	SIMULPF00001	167	169	181	155	14	12
2315	FW_pair2315	FakeAnc2315	FakeDesc2315	SIMULPF00001	306	318	350	274	44	32
2316	FW_pair2316	FakeAnc2316	FakeDesc2316	SIMULPF00001	9	8	9	8	0	1
2317	FW_pair2317	FakeAnc2317	FakeDesc2317	SIMULPF00001	82	84	93	73	11	9
2318	FW_pair2318	FakeAnc2318	FakeDesc2318	SIMULPF00001	42	42	44	40	2	2
2319	FW_pair2319	FakeAnc2319	FakeDesc2319	SIMULPF00001	160	160	174	146	14	14
2320	FW_pair2320	FakeAnc2320	FakeDesc2320	SIMULPF00001	89	88	93	84	4	5
2321	FW_pair2321	FakeAnc2321	FakeDesc2321	SIMULPF00001	241	241	266	216	25	25
2322	FW_pair2322	FakeAnc2322	FakeDesc2322	SIMULPF00001	10	11	12	9	2	1
2323	FW_pair2323	FakeAnc2323	FakeDesc2323	SIMULPF00001	348	340	382	306	34	42
2324	FW_pair2324	FakeAnc2324	FakeDesc2324	SIMULPF00001	20	19	22	17	2	3
2325	FW_pair2325	FakeAnc2325	FakeDesc2325	SIMULPF00001	353	360	387	326	34	27
2326	FW_pair2326	FakeAnc2326	FakeDesc2326	SIMULPF00001	617	621	693	545	76	72
2327	FW_pair2327	FakeAnc2327	FakeDesc2327	SIMULPF00001	387	397	431	353	44	34
2328	FW_pair2328	FakeAnc2328	FakeDesc2328	SIMULPF00001	298	304	329	273	31	25
2329	FW_pair2329	FakeAnc2329	FakeDesc2329	SIMULPF00001	679	687	747	619	68	60
2330	FW_pair2330	FakeAnc2330	FakeDesc2330	SIMULPF00001	98	105	114	89	16	9
2331	FW_pair2331	FakeAnc2331	FakeDesc2331	SIMULPF00001	190	186	202	174	12	16
2332	FW_pair2332	FakeAnc2332	FakeDesc2332	SIMULPF00001	261	266	288	239	27	22
2333	FW_pair2333	FakeAnc2333	FakeDesc2333	SIMULPF00001	133	126	140	119	7	14
2334	FW_pair2334	FakeAnc2334	FakeDesc2334	SIMULPF00001	54	49	57	46	3	8
2335	FW_pair2335	FakeAnc2335	FakeDesc2335	SIMULPF00001	434	433	474	393	40	41
2336	FW_pair2336	FakeAnc2336	FakeDesc2336	SIMULPF00001	237	238	253	222	16	15
2337	FW_pair2337	FakeAnc2337	FakeDesc2337	SIMULPF00001	220	207	241	186	21	34
2338	FW_pair2338	FakeAnc2338	FakeDesc2338	SIMULPF00001	83	89	92	80	9	3
2339	FW_pair2339	FakeAnc2339	FakeDesc2339	SIMULPF00001	25	27	27	25	2	0
2340	FW_pair2340	FakeAnc2340	FakeDesc2340	SIMULPF00001	168	161	183	146	15	22
2341	FW_pair2341	FakeAnc2341	FakeDesc2341	SIMULPF00001	242	261	273	230	31	12
2342	FW_pair2342	FakeAnc2342	FakeDesc2342	SIMULPF00001	124	123	137	110	13	14
2343	FW_pair2343	FakeAnc2343	FakeDesc2343	SIMULPF00001	654	648	714	588	60	66
2344	FW_pair2344	FakeAnc2344	FakeDesc2344	SIMULPF00001	132	123	138	117	6	15
2345	FW_pair2345	FakeAnc2345	FakeDesc2345	SIMULPF00001	497	500	538	459	41	38
2346	FW_pair2346	FakeAnc2346	FakeDesc2346	SIMULPF00001	197	193	211	179	14	18
2347	FW_pair2347	FakeAnc2347	FakeDesc2347	SIMULPF00001	95	102	109	88	14	7
2348	FW_pair2348	FakeAnc2348	FakeDesc2348	SIMULPF00001	70	73	78	65	8	5
2349	FW_pair2349	FakeAnc2349	FakeDesc2349	SIMULPF00001	175	166	186	155	11	20
2350	FW_pair2350	FakeAnc2350	FakeDesc2350	SIMULPF00001	157	161	174	144	17	13
2351	FW_pair2351	FakeAnc2351	FakeDesc2351	SIMULPF00001	128	120	139	109	11	19
2352	FW_pair2352	FakeAnc2352	FakeDesc2352	SIMULPF00001	238	259	275	222	37	16
2353	FW_pair2353	FakeAnc2353	FakeDesc2353	SIMULPF00001	709	696	770	635	61	74
2354	FW_pair2354	FakeAnc2354	FakeDesc2354	SIMULPF00001	923	887	999	811	76	112
2355	FW_pair2355	FakeAnc2355	FakeDesc2355	SIMULPF00001	517	516	567	466	50	51
2356	FW_pair2356	FakeAnc2356	FakeDesc2356	SIMULPF00001	66	66	70	62	4	4
2357	FW_pair2357	FakeAnc2357	FakeDesc2357	SIMULPF00001	201	191	210	182	9	19
2358	FW_pair2358	FakeAnc2358	FakeDesc2358	SIMULPF00001	785	787	853	719	68	66
2359	FW_pair2359	FakeAnc2359	FakeDesc2359	SIMULPF00001	44	42	48	38	4	6
2360	FW_pair2360	FakeAnc2360	FakeDesc2360	SIMULPF00001	371	357	389	339	18	32
2361	FW_pair2361	FakeAnc2361	FakeDesc2361	SIMULPF00001	351	353	385	319	34	32
2362	FW_pair2362	FakeAnc2362	FakeDesc2362	SIMULPF00001	235	245	262	218	27	17
2363	FW_pair2363	FakeAnc2363	FakeDesc2363	SIMULPF00001	31	32	32	31	1	0
2364	FW_pair2364	FakeAnc2364	FakeDesc2364	SIMULPF00001	104	109	118	95	14	9
2365	FW_pair2365	FakeAnc2365	FakeDesc2365	SIMULPF00001	478	494	536	436	58	42
2366	FW_pair2366	FakeAnc2366	FakeDesc2366	SIMULPF00001	149	143	161	131	12	18
2367	FW_pair2367	FakeAnc2367	FakeDesc2367	SIMULPF00001	230	225	245	210	15	20
2368	FW_pair2368	FakeAnc2368	FakeDesc2368	SIMULPF00001	93	92	99	86	6	7
2369	FW_pair2369	FakeAnc2369	FakeDesc2369	SIMULPF00001	144	142	154	132	10	12
2370	FW_pair2370	FakeAnc2370	FakeDesc2370	SIMULPF00001	130	133	141	122	11	8
2371	FW_pair2371	FakeAnc2371	FakeDesc2371	SIMULPF00001	202	204	223	183	21	19
2372	FW_pair2372	FakeAnc2372	FakeDesc2372	SIMULPF00001	142	137	152	127	10	15
2373	FW_pair2373	FakeAnc2373	FakeDesc2373	SIMULPF00001	66	69	73	62	7	4
2374	FW_pair2374	FakeAnc2374	FakeDesc2374	SIMULPF00001	299	304	324	279	25	20
2375	FW_pair2375	FakeAnc2375	FakeDesc2375	SIMULPF00001	753	750	815	688	62	65
2376	FW_pair2376	FakeAnc2376	FakeDesc2376	SIMULPF00001	341	336	368	309	27	32
2377	FW_pair2377	FakeAnc2377	FakeDesc2377	SIMULPF00001	560	572	621	511	61	49
2378	FW_pair2378	FakeAnc2378	FakeDesc2378	SIMULPF00001	79	77	88	68	9	11
2379	FW_pair2379	FakeAnc2379	FakeDesc2379	SIMULPF00001	98	96	108	86	10	12
2380	FW_pair2380	FakeAnc2380	FakeDesc2380	SIMULPF00001	117	115	127	105	10	12
2381	FW_pair2381	FakeAnc2381	FakeDesc2381	SIMULPF00001	396	408	443	361	47	35
2382	FW_pair2382	FakeAnc2382	FakeDesc2382	SIMULPF00001	278	275	316	237	38	41
2383	FW_pair2383	FakeAnc2383	FakeDesc2383	SIMULPF00001	64	66	70	60	6	4
2384	FW_pair2384	FakeAnc2384	FakeDesc2384	SIMULPF00001	352	345	385	312	33	40
2385	FW_pair2385	FakeAnc2385	FakeDesc2385	SIMULPF00001	864	886	943	807	79	57
2386	FW_pair2386	FakeAnc2386	FakeDesc2386	SIMULPF00001	177	170	190	157	13	20
2387	FW_pair2387	FakeAnc2387	FakeDesc2387	SIMULPF00001	56	61	64	53	8	3
2388	FW_pair2388	FakeAnc2388	FakeDesc2388	SIMULPF00001	380	374	417	337	37	43
2389	FW_pair2389	FakeAnc2389	FakeDesc2389	SIMULPF00001	320	323	357	286	37	34
2390	FW_pair2390	FakeAnc2390	FakeDesc2390	SIMULPF00001	313	305	330	288	17	25
2391	FW_pair2391	FakeAnc2391	FakeDesc2391	SIMULPF00001	244	242	269	217	25	27
2392	FW_pair2392	FakeAnc2392	FakeDesc2392	SIMULPF00001	53	50	57	46	4	7
2393	FW_pair2393	FakeAnc2393	FakeDesc2393	SIMULPF00001	265	269	281	253	16	12
2394	FW_pair2394	FakeAnc2394	FakeDesc2394	SIMULPF00001	24	21	25	20	1	4
2395	FW_pair2395	FakeAnc2395	FakeDesc2395	SIMULPF00001	741	758	811	688	70	53
2396	FW_pair2396	FakeAnc2396	FakeDesc2396	SIMULPF00001	308	298	336	270	28	38
2397	FW_pair2397	FakeAnc2397	FakeDesc2397	SIMULPF00001	66	63	69	60	3	6
2398	FW_pair2398	FakeAnc2398	FakeDesc2398	SIMULPF00001	210	201	226	185	16	25
2399	FW_pair2399	FakeAnc2399	FakeDesc2399	SIMULPF00001	658	666	725	599	67	59
2400	FW_pair2400	FakeAnc2400	FakeDesc2400	SIMULPF00001	135	140	148	127	13	8
2401	FW_pair2401	FakeAnc2401	FakeDesc2401	SIMULPF00001	652	635	704	583	52	69
2402	FW_pair2402	FakeAnc2402	FakeDesc2402	SIMULPF00001	227	231	258	200	31	27
2403	FW_pair2403	FakeAnc2403	FakeDesc2403	SIMULPF00001	165	164	177	152	12	13
2404	FW_pair2404	FakeAnc2404	FakeDesc2404	SIMULPF00001	175	179	188	166	13	9
2405	FW_pair2405	FakeAnc2405	FakeDesc2405	SIMULPF00001	179	185	199	165	20	14
2406	FW_pair2406	FakeAnc2406	FakeDesc2406	SIMULPF00001	42	44	47	39	5	3
2407	FW_pair2407	FakeAnc2407	FakeDesc2407	SIMULPF00001	86	89	91	84	5	2
2408	FW_pair2408	FakeAnc2408	FakeDesc2408	SIMULPF00001	32	32	34	30	2	2
2409	FW_pair2409	FakeAnc2409	FakeDesc2409	SIMULPF00001	93	87	101	79	8	14
2410	FW_pair2410	FakeAnc2410	FakeDesc2410	SIMULPF00001	507	526	576	457	69	50
2411	FW_pair2411	FakeAnc2411	FakeDesc2411	SIMULPF00001	117	115	129	103	12	14
2412	FW_pair2412	FakeAnc2412	FakeDesc2412	SIMULPF00001	109	112	115	106	6	3
2413	FW_pair2413	FakeAnc2413	FakeDesc2413	SIMULPF00001	84	81	92	73	8	11
2414	FW_pair2414	FakeAnc2414	FakeDesc2414	SIMULPF00001	141	155	158	138	17	3
2415	FW_pair2415	FakeAnc2415	FakeDesc2415	SIMULPF00001	133	135	147	121	14	12
2416	FW_pair2416	FakeAnc2416	FakeDesc2416	SIMULPF00001	187	185	207	165	20	22
2417	FW_pair2417	FakeAnc2417	FakeDesc2417	SIMULPF00001	36	35	37	34	1	2
2418	FW_pair2418	FakeAnc2418	FakeDesc2418	SIMULPF00001	169	164	185	148	16	21
2419	FW_pair2419	FakeAnc2419	FakeDesc2419	SIMULPF00001	320	310	341	289	21	31
2420	FW_pair2420	FakeAnc2420	FakeDesc2420	SIMULPF00001	68	69	75	62	7	6
2421	FW_pair2421	FakeAnc2421	FakeDesc2421	SIMULPF00001	371	374	413	332	42	39
2422	FW_pair2422	FakeAnc2422	FakeDesc2422	SIMULPF00001	24	26	27	23	3	1
2423	FW_pair2423	FakeAnc2423	FakeDesc2423	SIMULPF00001	227	224	246	205	19	22
2424	FW_pair2424	FakeAnc2424	FakeDesc2424	SIMULPF00001	8	7	10	5	2	3
2425	FW_pair2425	FakeAnc2425	FakeDesc2425	SIMULPF00001	3	3	3	3	0	0
2426	FW_pair2426	FakeAnc2426	FakeDesc2426	SIMULPF00001	120	118	131	107	11	13
2427	FW_pair2427	FakeAnc2427	FakeDesc2427	SIMULPF00001	358	364	398	324	40	34
2428	FW_pair2428	FakeAnc2428	FakeDesc2428	SIMULPF00001	229	224	239	214	10	15
2429	FW_pair2429	FakeAnc2429	FakeDesc2429	SIMULPF00001	232	241	259	214	27	18
2430	FW_pair2430	FakeAnc2430	FakeDesc2430	SIMULPF00001	375	362	408	329	33	46
2431	FW_pair2431	FakeAnc2431	FakeDesc2431	SIMULPF00001	190	191	215	166	25	24
2432	FW_pair2432	FakeAnc2432	FakeDesc2432	SIMULPF00001	136	142	151	127	15	9
2433	FW_pair2433	FakeAnc2433	FakeDesc2433	SIMULPF00001	112	113	122	103	10	9
2434	FW_pair2434	FakeAnc2434	FakeDesc2434	SIMULPF00001	538	555	605	488	67	50
2435	FW_pair2435	FakeAnc2435	FakeDesc2435	SIMULPF00001	706	731	790	647	84	59
2436	FW_pair2436	FakeAnc2436	FakeDesc2436	SIMULPF00001	215	217	238	194	23	21
2437	FW_pair2437	FakeAnc2437	FakeDesc2437	SIMULPF00001	226	245	264	207	38	19
2438	FW_pair2438	FakeAnc2438	FakeDesc2438	SIMULPF00001	362	343	387	318	25	44
2439	FW_pair2439	FakeAnc2439	FakeDesc2439	SIMULPF00001	177	173	189	161	12	16
2440	FW_pair2440	FakeAnc2440	FakeDesc2440	SIMULPF00001	53	53	60	46	7	7
2441	FW_pair2441	FakeAnc2441	FakeDesc2441	SIMULPF00001	456	453	497	412	41	44
2442	FW_pair2442	FakeAnc2442	FakeDesc2442	SIMULPF00001	58	58	64	52	6	6
2443	FW_pair2443	FakeAnc2443	FakeDesc2443	SIMULPF00001	278	279	299	258	21	20
2444	FW_pair2444	FakeAnc2444	FakeDesc2444	SIMULPF00001	119	109	130	98	11	21
2445	FW_pair2445	FakeAnc2445	FakeDesc2445	SIMULPF00001	42	45	47	40	5	2
2446	FW_pair2446	FakeAnc2446	FakeDesc2446	SIMULPF00001	238	245	262	221	24	17
2447	FW_pair2447	FakeAnc2447	FakeDesc2447	SIMULPF00001	172	186	193	165	21	7
2448	FW_pair2448	FakeAnc2448	FakeDesc2448	SIMULPF00001	211	219	233	197	22	14
2449	FW_pair2449	FakeAnc2449	FakeDesc2449	SIMULPF00001	896	914	985	825	89	71
2450	FW_pair2450	FakeAnc2450	FakeDesc2450	SIMULPF00001	258	251	279	230	21	28
2451	FW_pair2451	FakeAnc2451	FakeDesc2451	SIMULPF00001	44	45	47	42	3	2
2452	FW_pair2452	FakeAnc2452	FakeDesc2452	SIMULPF00001	257	273	290	240	33	17
2453	FW_pair2453	FakeAnc2453	FakeDesc2453	SIMULPF00001	526	520	569	477	43	49
2454	FW_pair2454	FakeAnc2454	FakeDesc2454	SIMULPF00001	176	173	182	167	6	9
2455	FW_pair2455	FakeAnc2455	FakeDesc2455	SIMULPF00001	176	182	192	166	16	10
2456	FW_pair2456	FakeAnc2456	FakeDesc2456	SIMULPF00001	645	657	713	589	68	56
2457	FW_pair2457	FakeAnc2457	FakeDesc2457	SIMULPF00001	36	36	40	32	4	4
2458	FW_pair2458	FakeAnc2458	FakeDesc2458	SIMULPF00001	337	344	368	313	31	24
2459	FW_pair2459	FakeAnc2459	FakeDesc2459	SIMULPF00001	152	152	168	136	16	16
2460	FW_pair2460	FakeAnc2460	FakeDesc2460	SIMULPF00001	372	370	396	346	24	26
2461	FW_pair2461	FakeAnc2461	FakeDesc2461	SIMULPF00001	503	497	560	440	57	63
2462	FW_pair2462	FakeAnc2462	FakeDesc2462	SIMULPF00001	502	485	539	448	37	54
2463	FW_pair2463	FakeAnc2463	FakeDesc2463	SIMULPF00001	97	97	104	90	7	7
2464	FW_pair2464	FakeAnc2464	FakeDesc2464	SIMULPF00001	181	187	200	168	19	13
2465	FW_pair2465	FakeAnc2465	FakeDesc2465	SIMULPF00001	87	90	93	84	6	3
2466	FW_pair2466	FakeAnc2466	FakeDesc2466	SIMULPF00001	28	29	30	27	2	1
2467	FW_pair2467	FakeAnc2467	FakeDesc2467	SIMULPF00001	322	326	359	289	37	33
2468	FW_pair2468	FakeAnc2468	FakeDesc2468	SIMULPF00001	72	77	79	70	7	2
2469	FW_pair2469	FakeAnc2469	FakeDesc2469	SIMULPF00001	15	15	16	14	1	1
2470	FW_pair2470	FakeAnc2470	FakeDesc2470	SIMULPF00001	253	262	280	235	27	18
2471	FW_pair2471	FakeAnc2471	FakeDesc2471	SIMULPF00001	247	244	266	225	19	22
2472	FW_pair2472	FakeAnc2472	FakeDesc2472	SIMULPF00001	639	640	699	580	60	59
2473	FW_pair2473	FakeAnc2473	FakeDesc2473	SIMULPF00001	74	85	86	73	12	1
2474	FW_pair2474	FakeAnc2474	FakeDesc2474	SIMULPF00001	476	498	536	438	60	38
2475	FW_pair2475	FakeAnc2475	FakeDesc2475	SIMULPF00001	154	158	166	146	12	8
2476	FW_pair2476	FakeAnc2476	FakeDesc2476	SIMULPF00001	167	182	197	152	30	15
2477	FW_pair2477	FakeAnc2477	FakeDesc2477	SIMULPF00001	145	152	163	134	18	11
2478	FW_pair2478	FakeAnc2478	FakeDesc2478	SIMULPF00001	78	76	82	72	4	6
2479	FW_pair2479	FakeAnc2479	FakeDesc2479	SIMULPF00001	258	250	277	231	19	27
2480	FW_pair2480	FakeAnc2480	FakeDesc2480	SIMULPF00001	125	129	142	112	17	13
2481	FW_pair2481	FakeAnc2481	FakeDesc2481	SIMULPF00001	52	47	54	45	2	7
2482	FW_pair2482	FakeAnc2482	FakeDesc2482	SIMULPF00001	116	112	125	103	9	13
2483	FW_pair2483	FakeAnc2483	FakeDesc2483	SIMULPF00001	39	39	41	37	2	2
2484	FW_pair2484	FakeAnc2484	FakeDesc2484	SIMULPF00001	71	79	82	68	11	3
2485	FW_pair2485	FakeAnc2485	FakeDesc2485	SIMULPF00001	270	270	292	248	22	22
2486	FW_pair2486	FakeAnc2486	FakeDesc2486	SIMULPF00001	27	26	27	26	0	1
2487	FW_pair2487	FakeAnc2487	FakeDesc2487	SIMULPF00001	121	120	132	109	11	12
2488	FW_pair2488	FakeAnc2488	FakeDesc2488	SIMULPF00001	276	286	312	250	36	26
2489	FW_pair2489	FakeAnc2489	FakeDesc2489	SIMULPF00001	93	93	99	87	6	6
2490	FW_pair2490	FakeAnc2490	FakeDesc2490	SIMULPF00001	144	140	154	130	10	14
2491	FW_pair2491	FakeAnc2491	FakeDesc2491	SIMULPF00001	203	194	214	183	11	20
2492	FW_pair2492	FakeAnc2492	FakeDesc2492	SIMULPF00001	113	116	123	106	10	7
2493	FW_pair2493	FakeAnc2493	FakeDesc2493	SIMULPF00001	76	68	79	65	3	11
2494	FW_pair2494	FakeAnc2494	FakeDesc2494	SIMULPF00001	660	648	716	592	56	68
2495	FW_pair2495	FakeAnc2495	FakeDesc2495	SIMULPF00001	47	42	49	40	2	7
2496	FW_pair2496	FakeAnc2496	FakeDesc2496	SIMULPF00001	217	218	234	201	17	16
2497	FW_pair2497	FakeAnc2497	FakeDesc2497	SIMULPF00001	24	20	24	20	0	4
2498	FW_pair2498	FakeAnc2498	FakeDesc2498	SIMULPF00001	310	300	332	278	22	32
2499	FW_pair2499	FakeAnc2499	FakeDesc2499	SIMULPF00001	117	108	123	102	6	15
2500	FW_pair2500	FakeAnc2500	FakeDesc2500	SIMULPF00001	252	250	282	220	30	32
2501	FW_pair2501	FakeAnc2501	FakeDesc2501	SIMULPF00001	862	874	955	781	93	81
2502	FW_pair2502	FakeAnc2502	FakeDesc2502	SIMULPF00001	6	6	6	6	0	0
2503	FW_pair2503	FakeAnc2503	FakeDesc2503	SIMULPF00001	88	88	97	79	9	9
2504	FW_pair2504	FakeAnc2504	FakeDesc2504	SIMULPF00001	727	726	791	662	64	65
2505	FW_pair2505	FakeAnc2505	FakeDesc2505	SIMULPF00001	328	321	356	293	28	35
2506	FW_pair2506	FakeAnc2506	FakeDesc2506	SIMULPF00001	88	89	98	79	10	9
2507	FW_pair2507	FakeAnc2507	FakeDesc2507	SIMULPF00001	105	95	113	87	8	18
2508	FW_pair2508	FakeAnc2508	FakeDesc2508	SIMULPF00001	293	302	327	268	34	25
2509	FW_pair2509	FakeAnc2509	FakeDesc2509	SIMULPF00001	157	157	170	144	13	13
2510	FW_pair2510	FakeAnc2510	FakeDesc2510	SIMULPF00001	114	118	125	107	11	7
2511	FW_pair2511	FakeAnc2511	FakeDesc2511	SIMULPF00001	767	769	842	694	75	73
2512	FW_pair2512	FakeAnc2512	FakeDesc2512	SIMULPF00001	50	51	57	44	7	6
2513	FW_pair2513	FakeAnc2513	FakeDesc2513	SIMULPF00001	446	454	495	405	49	41
2514	FW_pair2514	FakeAnc2514	FakeDesc2514	SIMULPF00001	16	15	16	15	0	1
2515	FW_pair2515	FakeAnc2515	FakeDesc2515	SIMULPF00001	132	126	138	120	6	12
2516	FW_pair2516	FakeAnc2516	FakeDesc2516	SIMULPF00001	79	77	82	74	3	5
2517	FW_pair2517	FakeAnc2517	FakeDesc2517	SIMULPF00001	242	234	268	208	26	34
2518	FW_pair2518	FakeAnc2518	FakeDesc2518	SIMULPF00001	793	763	842	714	49	79
2519	FW_pair2519	FakeAnc2519	FakeDesc2519	SIMULPF00001	22	22	24	20	2	2
2520	FW_pair2520	FakeAnc2520	FakeDesc2520	SIMULPF00001	28	24	30	22	2	6
2521	FW_pair2521	FakeAnc2521	FakeDesc2521	SIMULPF00001	207	203	225	185	18	22
2522	FW_pair2522	FakeAnc2522	FakeDesc2522	SIMULPF00001	25	24	26	23	1	2
2523	FW_pair2523	FakeAnc2523	FakeDesc2523	SIMULPF00001	246	247	264	229	18	17
2524	FW_pair2524	FakeAnc2524	FakeDesc2524	SIMULPF00001	1	1	1	1	0	0
2525	FW_pair2525	FakeAnc2525	FakeDesc2525	SIMULPF00001	82	80	86	76	4	6
2526	FW_pair2526	FakeAnc2526	FakeDesc2526	SIMULPF00001	301	286	325	262	24	39
2527	FW_pair2527	FakeAnc2527	FakeDesc2527	SIMULPF00001	477	485	529	433	52	44
2528	FW_pair2528	FakeAnc2528	FakeDesc2528	SIMULPF00001	56	57	60	53	4	3
2529	FW_pair2529	FakeAnc2529	FakeDesc2529	SIMULPF00001	66	68	74	60	8	6
2530	FW_pair2530	FakeAnc2530	FakeDesc2530	SIMULPF00001	43	42	46	39	3	4
2531	FW_pair2531	FakeAnc2531	FakeDesc2531	SIMULPF00001	79	82	86	75	7	4
2532	FW_pair2532	FakeAnc2532	FakeDesc2532	SIMULPF00001	145	161	170	136	25	9
2533	FW_pair2533	FakeAnc2533	FakeDesc2533	SIMULPF00001	6	7	7	6	1	0
2534	FW_pair2534	FakeAnc2534	FakeDesc2534	SIMULPF00001	596	617	668	545	72	51
2535	FW_pair2535	FakeAnc2535	FakeDesc2535	SIMULPF00001	338	353	377	314	39	24
2536	FW_pair2536	FakeAnc2536	FakeDesc2536	SIMULPF00001	60	57	67	50	7	10
2537	FW_pair2537	FakeAnc2537	FakeDesc2537	SIMULPF00001	426	429	456	399	30	27
2538	FW_pair2538	FakeAnc2538	FakeDesc2538	SIMULPF00001	200	193	215	178	15	22
2539	FW_pair2539	FakeAnc2539	FakeDesc2539	SIMULPF00001	159	158	170	147	11	12
2540	FW_pair2540	FakeAnc2540	FakeDesc2540	SIMULPF00001	498	512	551	459	53	39
2541	FW_pair2541	FakeAnc2541	FakeDesc2541	SIMULPF00001	69	71	76	64	7	5
2542	FW_pair2542	FakeAnc2542	FakeDesc2542	SIMULPF00001	189	199	212	176	23	13
2543	FW_pair2543	FakeAnc2543	FakeDesc2543	SIMULPF00001	97	94	107	84	10	13
2544	FW_pair2544	FakeAnc2544	FakeDesc2544	SIMULPF00001	676	692	748	620	72	56
2545	FW_pair2545	FakeAnc2545	FakeDesc2545	SIMULPF00001	58	54	59	53	1	5
2546	FW_pair2546	FakeAnc2546	FakeDesc2546	SIMULPF00001	386	389	426	349	40	37
2547	FW_pair2547	FakeAnc2547	FakeDesc2547	SIMULPF00001	539	542	590	491	51	48
2548	FW_pair2548	FakeAnc2548	FakeDesc2548	SIMULPF00001	724	726	787	663	63	61
2549	FW_pair2549	FakeAnc2549	FakeDesc2549	SIMULPF00001	200	208	219	189	19	11
2550	FW_pair2550	FakeAnc2550	FakeDesc2550	SIMULPF00001	254	251	278	227	24	27
2551	FW_pair2551	FakeAnc2551	FakeDesc2551	SIMULPF00001	228	230	247	211	19	17
2552	FW_pair2552	FakeAnc2552	FakeDesc2552	SIMULPF00001	151	151	165	137	14	14
2553	FW_pair2553	FakeAnc2553	FakeDesc2553	SIMULPF00001	249	251	271	229	22	20
2554	FW_pair2554	FakeAnc2554	FakeDesc2554	SIMULPF00001	7	7	7	7	0	0
2555	FW_pair2555	FakeAnc2555	FakeDesc2555	SIMULPF00001	254	251	278	227	24	27
2556	FW_pair2556	FakeAnc2556	FakeDesc2556	SIMULPF00001	380	390	423	347	43	33
2557	FW_pair2557	FakeAnc2557	FakeDesc2557	SIMULPF00001	682	699	754	627	72	55
2558	FW_pair2558	FakeAnc2558	FakeDesc2558	SIMULPF00001	637	638	693	582	56	55
2559	FW_pair2559	FakeAnc2559	FakeDesc2559	SIMULPF00001	398	378	439	337	41	61
2560	FW_pair2560	FakeAnc2560	FakeDesc2560	SIMULPF00001	136	127	144	119	8	17
2561	FW_pair2561	FakeAnc2561	FakeDesc2561	SIMULPF00001	222	222	247	197	25	25
2562	FW_pair2562	FakeAnc2562	FakeDesc2562	SIMULPF00001	343	339	372	310	29	33
2563	FW_pair2563	FakeAnc2563	FakeDesc2563	SIMULPF00001	567	570	613	524	46	43
2564	FW_pair2564	FakeAnc2564	FakeDesc2564	SIMULPF00001	707	704	780	631	73	76
2565	FW_pair2565	FakeAnc2565	FakeDesc2565	SIMULPF00001	164	168	183	149	19	15
2566	FW_pair2566	FakeAnc2566	FakeDesc2566	SIMULPF00001	641	619	684	576	43	65
2567	FW_pair2567	FakeAnc2567	FakeDesc2567	SIMULPF00001	54	55	58	51	4	3
2568	FW_pair2568	FakeAnc2568	FakeDesc2568	SIMULPF00001	448	460	499	409	51	39
2569	FW_pair2569	FakeAnc2569	FakeDesc2569	SIMULPF00001	177	168	180	165	3	12
2570	FW_pair2570	FakeAnc2570	FakeDesc2570	SIMULPF00001	54	54	58	50	4	4
2571	FW_pair2571	FakeAnc2571	FakeDesc2571	SIMULPF00001	69	72	78	63	9	6
2572	FW_pair2572	FakeAnc2572	FakeDesc2572	SIMULPF00001	77	75	81	71	4	6
2573	FW_pair2573	FakeAnc2573	FakeDesc2573	SIMULPF00001	254	246	272	228	18	26
2574	FW_pair2574	FakeAnc2574	FakeDesc2574	SIMULPF00001	85	88	92	81	7	4
2575	FW_pair2575	FakeAnc2575	FakeDesc2575	SIMULPF00001	162	162	181	143	19	19
2576	FW_pair2576	FakeAnc2576	FakeDesc2576	SIMULPF00001	196	199	219	176	23	20
2577	FW_pair2577	FakeAnc2577	FakeDesc2577	SIMULPF00001	165	163	178	150	13	15
2578	FW_pair2578	FakeAnc2578	FakeDesc2578	SIMULPF00001	142	150	159	133	17	9
2579	FW_pair2579	FakeAnc2579	FakeDesc2579	SIMULPF00001	384	380	415	349	31	35
2580	FW_pair2580	FakeAnc2580	FakeDesc2580	SIMULPF00001	239	259	272	226	33	13
2581	FW_pair2581	FakeAnc2581	FakeDesc2581	SIMULPF00001	149	145	163	131	14	18
2582	FW_pair2582	FakeAnc2582	FakeDesc2582	SIMULPF00001	248	236	273	211	25	37
2583	FW_pair2583	FakeAnc2583	FakeDesc2583	SIMULPF00001	894	905	984	815	90	79
2584	FW_pair2584	FakeAnc2584	FakeDesc2584	SIMULPF00001	183	191	198	176	15	7
2585	FW_pair2585	FakeAnc2585	FakeDesc2585	SIMULPF00001	181	176	192	165	11	16
2586	FW_pair2586	FakeAnc2586	FakeDesc2586	SIMULPF00001	514	527	575	466	61	48
2587	FW_pair2587	FakeAnc2587	FakeDesc2587	SIMULPF00001	277	275	301	251	24	26
2588	FW_pair2588	FakeAnc2588	FakeDesc2588	SIMULPF00001	53	61	64	50	11	3
2589	FW_pair2589	FakeAnc2589	FakeDesc2589	SIMULPF00001	207	208	226	189	19	18
2590	FW_pair2590	FakeAnc2590	FakeDesc2590	SIMULPF00001	46	47	49	44	3	2
2591	FW_pair2591	FakeAnc2591	FakeDesc2591	SIMULPF00001	287	291	318	260	31	27
2592	FW_pair2592	FakeAnc2592	FakeDesc2592	SIMULPF00001	917	914	991	840	74	77
2593	FW_pair2593	FakeAnc2593	FakeDesc2593	SIMULPF00001	15	15	16	14	1	1
2594	FW_pair2594	FakeAnc2594	FakeDesc2594	SIMULPF00001	96	95	103	88	7	8
2595	FW_pair2595	FakeAnc2595	FakeDesc2595	SIMULPF00001	65	67	71	61	6	4
2596	FW_pair2596	FakeAnc2596	FakeDesc2596	SIMULPF00001	230	251	269	212	39	18
2597	FW_pair2597	FakeAnc2597	FakeDesc2597	SIMULPF00001	15	15	15	15	0	0
2598	FW_pair2598	FakeAnc2598	FakeDesc2598	SIMULPF00001	578	587	639	526	61	52
2599	FW_pair2599	FakeAnc2599	FakeDesc2599	SIMULPF00001	19	19	21	17	2	2
2600	FW_pair2600	FakeAnc2600	FakeDesc2600	SIMULPF00001	155	143	162	136	7	19
2601	FW_pair2601	FakeAnc2601	FakeDesc2601	SIMULPF00001	263	247	289	221	26	42
2602	FW_pair2602	FakeAnc2602	FakeDesc2602	SIMULPF00001	96	101	105	92	9	4
2603	FW_pair2603	FakeAnc2603	FakeDesc2603	SIMULPF00001	500	480	550	430	50	70
2604	FW_pair2604	FakeAnc2604	FakeDesc2604	SIMULPF00001	333	335	362	306	29	27
2605	FW_pair2605	FakeAnc2605	FakeDesc2605	SIMULPF00001	131	134	146	119	15	12
2606	FW_pair2606	FakeAnc2606	FakeDesc2606	SIMULPF00001	391	379	417	353	26	38
2607	FW_pair2607	FakeAnc2607	FakeDesc2607	SIMULPF00001	30	28	31	27	1	3
2608	FW_pair2608	FakeAnc2608	FakeDesc2608	SIMULPF00001	66	59	70	55	4	11
2609	FW_pair2609	FakeAnc2609	FakeDesc2609	SIMULPF00001	29	30	31	28	2	1
2610	FW_pair2610	FakeAnc2610	FakeDesc2610	SIMULPF00001	877	912	973	816	96	61
2611	FW_pair2611	FakeAnc2611	FakeDesc2611	SIMULPF00001	87	87	95	79	8	8
2612	FW_pair2612	FakeAnc2612	FakeDesc2612	SIMULPF00001	284	272	304	252	20	32
2613	FW_pair2613	FakeAnc2613	FakeDesc2613	SIMULPF00001	92	95	105	82	13	10
2614	FW_pair2614	FakeAnc2614	FakeDesc2614	SIMULPF00001	455	447	483	419	28	36
2615	FW_pair2615	FakeAnc2615	FakeDesc2615	SIMULPF00001	663	670	742	591	79	72
2616	FW_pair2616	FakeAnc2616	FakeDesc2616	SIMULPF00001	27	26	29	24	2	3
2617	FW_pair2617	FakeAnc2617	FakeDesc2617	SIMULPF00001	134	136	144	126	10	8
2618	FW_pair2618	FakeAnc2618	FakeDesc2618	SIMULPF00001	144	145	155	134	11	10
2619	FW_pair2619	FakeAnc2619	FakeDesc2619	SIMULPF00001	402	382	428	356	26	46
2620	FW_pair2620	FakeAnc2620	FakeDesc2620	SIMULPF00001	468	467	513	422	45	46
2621	FW_pair2621	FakeAnc2621	FakeDesc2621	SIMULPF00001	405	411	454	362	49	43
2622	FW_pair2622	FakeAnc2622	FakeDesc2622	SIMULPF00001	167	170	183	154	16	13
2623	FW_pair2623	FakeAnc2623	FakeDesc2623	SIMULPF00001	43	42	48	37	5	6
2624	FW_pair2624	FakeAnc2624	FakeDesc2624	SIMULPF00001	14	13	14	13	0	1
2625	FW_pair2625	FakeAnc2625	FakeDesc2625	SIMULPF00001	181	186	196	171	15	10
2626	FW_pair2626	FakeAnc2626	FakeDesc2626	SIMULPF00001	195	192	213	174	18	21
2627	FW_pair2627	FakeAnc2627	FakeDesc2627	SIMULPF00001	54	56	59	51	5	3
2628	FW_pair2628	FakeAnc2628	FakeDesc2628	SIMULPF00001	33	34	36	31	3	2
2629	FW_pair2629	FakeAnc2629	FakeDesc2629	SIMULPF00001	95	96	103	88	8	7
2630	FW_pair2630	FakeAnc2630	FakeDesc2630	SIMULPF00001	296	291	322	265	26	31
2631	FW_pair2631	FakeAnc2631	FakeDesc2631	SIMULPF00001	184	191	204	171	20	13
2632	FW_pair2632	FakeAnc2632	FakeDesc2632	SIMULPF00001	417	427	465	379	48	38
2633	FW_pair2633	FakeAnc2633	FakeDesc2633	SIMULPF00001	87	87	95	79	8	8
2634	FW_pair2634	FakeAnc2634	FakeDesc2634	SIMULPF00001	113	105	121	97	8	16
2635	FW_pair2635	FakeAnc2635	FakeDesc2635	SIMULPF00001	68	66	70	64	2	4
2636	FW_pair2636	FakeAnc2636	FakeDesc2636	SIMULPF00001	325	322	358	289	33	36
2637	FW_pair2637	FakeAnc2637	FakeDesc2637	SIMULPF00001	116	116	126	106	10	10
2638	FW_pair2638	FakeAnc2638	FakeDesc2638	SIMULPF00001	275	273	295	253	20	22
2639	FW_pair2639	FakeAnc2639	FakeDesc2639	SIMULPF00001	238	225	250	213	12	25
2640	FW_pair2640	FakeAnc2640	FakeDesc2640	SIMULPF00001	211	211	228	194	17	17
2641	FW_pair2641	FakeAnc2641	FakeDesc2641	SIMULPF00001	20	17	21	16	1	4
2642	FW_pair2642	FakeAnc2642	FakeDesc2642	SIMULPF00001	119	117	133	103	14	16
2643	FW_pair2643	FakeAnc2643	FakeDesc2643	SIMULPF00001	790	794	882	702	92	88
2644	FW_pair2644	FakeAnc2644	FakeDesc2644	SIMULPF00001	181	189	201	169	20	12
2645	FW_pair2645	FakeAnc2645	FakeDesc2645	SIMULPF00001	74	73	79	68	5	6
2646	FW_pair2646	FakeAnc2646	FakeDesc2646	SIMULPF00001	49	48	50	47	1	2
2647	FW_pair2647	FakeAnc2647	FakeDesc2647	SIMULPF00001	29	32	34	27	5	2
2648	FW_pair2648	FakeAnc2648	FakeDesc2648	SIMULPF00001	43	48	50	41	7	2
2649	FW_pair2649	FakeAnc2649	FakeDesc2649	SIMULPF00001	817	822	897	742	80	75
2650	FW_pair2650	FakeAnc2650	FakeDesc2650	SIMULPF00001	346	354	383	317	37	29
2651	FW_pair2651	FakeAnc2651	FakeDesc2651	SIMULPF00001	61	56	64	53	3	8
2652	FW_pair2652	FakeAnc2652	FakeDesc2652	SIMULPF00001	55	57	62	50	7	5
2653	FW_pair2653	FakeAnc2653	FakeDesc2653	SIMULPF00001	115	121	127	109	12	6
2654	FW_pair2654	FakeAnc2654	FakeDesc2654	SIMULPF00001	220	202	237	185	17	35
2655	FW_pair2655	FakeAnc2655	FakeDesc2655	SIMULPF00001	135	140	150	125	15	10
2656	FW_pair2656	FakeAnc2656	FakeDesc2656	SIMULPF00001	27	27	29	25	2	2
2657	FW_pair2657	FakeAnc2657	FakeDesc2657	SIMULPF00001	157	159	172	144	15	13
2658	FW_pair2658	FakeAnc2658	FakeDesc2658	SIMULPF00001	270	275	297	248	27	22
2659	FW_pair2659	FakeAnc2659	FakeDesc2659	SIMULPF00001	296	294	321	269	25	27
2660	FW_pair2660	FakeAnc2660	FakeDesc2660	SIMULPF00001	108	111	121	98	13	10
2661	FW_pair2661	FakeAnc2661	FakeDesc2661	SIMULPF00001	10	10	12	8	2	2
2662	FW_pair2662	FakeAnc2662	FakeDesc2662	SIMULPF00001	176	166	183	159	7	17
2663	FW_pair2663	FakeAnc2663	FakeDesc2663	SIMULPF00001	66	69	77	58	11	8
2664	FW_pair2664	FakeAnc2664	FakeDesc2664	SIMULPF00001	83	78	89	72	6	11
2665	FW_pair2665	FakeAnc2665	FakeDesc2665	SIMULPF00001	344	345	376	313	32	31
2666	FW_pair2666	FakeAnc2666	FakeDesc2666	SIMULPF00001	41	42	48	35	7	6
2667	FW_pair2667	FakeAnc2667	FakeDesc2667	SIMULPF00001	67	70	74	63	7	4
2668	FW_pair2668	FakeAnc2668	FakeDesc2668	SIMULPF00001	321	322	346	297	25	24
2669	FW_pair2669	FakeAnc2669	FakeDesc2669	SIMULPF00001	283	294	310	267	27	16
2670	FW_pair2670	FakeAnc2670	FakeDesc2670	SIMULPF00001	164	165	174	155	10	9
2671	FW_pair2671	FakeAnc2671	FakeDesc2671	SIMULPF00001	820	813	890	743	70	77
2672	FW_pair2672	FakeAnc2672	FakeDesc2672	SIMULPF00001	302	290	323	269	21	33
2673	FW_pair2673	FakeAnc2673	FakeDesc2673	SIMULPF00001	46	45	48	43	2	3
2674	FW_pair2674	FakeAnc2674	FakeDesc2674	SIMULPF00001	49	48	56	41	7	8
2675	FW_pair2675	FakeAnc2675	FakeDesc2675	SIMULPF00001	260	254	284	230	24	30
2676	FW_pair2676	FakeAnc2676	FakeDesc2676	SIMULPF00001	99	100	110	89	11	10
2677	FW_pair2677	FakeAnc2677	FakeDesc2677	SIMULPF00001	50	51	51	50	1	0
2678	FW_pair2678	FakeAnc2678	FakeDesc2678	SIMULPF00001	399	394	436	357	37	42
2679	FW_pair2679	FakeAnc2679	FakeDesc2679	SIMULPF00001	600	590	661	529	61	71
2680	FW_pair2680	FakeAnc2680	FakeDesc2680	SIMULPF00001	154	154	169	139	15	15
2681	FW_pair2681	FakeAnc2681	FakeDesc2681	SIMULPF00001	706	716	778	644	72	62
2682	FW_pair2682	FakeAnc2682	FakeDesc2682	SIMULPF00001	124	132	142	114	18	10
2683	FW_pair2683	FakeAnc2683	FakeDesc2683	SIMULPF00001	123	115	131	107	8	16
2684	FW_pair2684	FakeAnc2684	FakeDesc2684	SIMULPF00001	450	465	502	413	52	37
2685	FW_pair2685	FakeAnc2685	FakeDesc2685	SIMULPF00001	51	52	57	46	6	5
2686	FW_pair2686	FakeAnc2686	FakeDesc2686	SIMULPF00001	106	115	121	100	15	6
2687	FW_pair2687	FakeAnc2687	FakeDesc2687	SIMULPF00001	266	256	280	242	14	24
2688	FW_pair2688	FakeAnc2688	FakeDesc2688	SIMULPF00001	283	279	304	258	21	25
2689	FW_pair2689	FakeAnc2689	FakeDesc2689	SIMULPF00001	333	329	357	305	24	28
2690	FW_pair2690	FakeAnc2690	FakeDesc2690	SIMULPF00001	25	31	36	20	11	5
2691	FW_pair2691	FakeAnc2691	FakeDesc2691	SIMULPF00001	173	176	195	154	22	19
2692	FW_pair2692	FakeAnc2692	FakeDesc2692	SIMULPF00001	151	163	178	136	27	15
2693	FW_pair2693	FakeAnc2693	FakeDesc2693	SIMULPF00001	108	104	116	96	8	12
2694	FW_pair2694	FakeAnc2694	FakeDesc2694	SIMULPF00001	61	61	67	55	6	6
2695	FW_pair2695	FakeAnc2695	FakeDesc2695	SIMULPF00001	244	230	261	213	17	31
2696	FW_pair2696	FakeAnc2696	FakeDesc2696	SIMULPF00001	145	152	171	126	26	19
2697	FW_pair2697	FakeAnc2697	FakeDesc2697	SIMULPF00001	178	185	201	162	23	16
2698	FW_pair2698	FakeAnc2698	FakeDesc2698	SIMULPF00001	43	44	48	39	5	4
2699	FW_pair2699	FakeAnc2699	FakeDesc2699	SIMULPF00001	106	104	111	99	5	7
2700	FW_pair2700	FakeAnc2700	FakeDesc2700	SIMULPF00001	29	30	35	24	6	5
2701	FW_pair2701	FakeAnc2701	FakeDesc2701	SIMULPF00001	445	416	471	390	26	55
2702	FW_pair2702	FakeAnc2702	FakeDesc2702	SIMULPF00001	119	114	128	105	9	14
2703	FW_pair2703	FakeAnc2703	FakeDesc2703	SIMULPF00001	59	52	61	50	2	9
2704	FW_pair2704	FakeAnc2704	FakeDesc2704	SIMULPF00001	601	601	663	539	62	62
2705	FW_pair2705	FakeAnc2705	FakeDesc2705	SIMULPF00001	193	190	209	174	16	19
2706	FW_pair2706	FakeAnc2706	FakeDesc2706	SIMULPF00001	116	114	126	104	10	12
2707	FW_pair2707	FakeAnc2707	FakeDesc2707	SIMULPF00001	208	192	222	178	14	30
2708	FW_pair2708	FakeAnc2708	FakeDesc2708	SIMULPF00001	183	192	201	174	18	9
2709	FW_pair2709	FakeAnc2709	FakeDesc2709	SIMULPF00001	193	184	201	176	8	17
2710	FW_pair2710	FakeAnc2710	FakeDesc2710	SIMULPF00001	46	45	51	40	5	6
2711	FW_pair2711	FakeAnc2711	FakeDesc2711	SIMULPF00001	275	267	292	250	17	25
2712	FW_pair2712	FakeAnc2712	FakeDesc2712	SIMULPF00001	258	260	284	234	26	24
2713	FW_pair2713	FakeAnc2713	FakeDesc2713	SIMULPF00001	44	38	44	38	0	6
2714	FW_pair2714	FakeAnc2714	FakeDesc2714	SIMULPF00001	269	252	291	230	22	39
2715	FW_pair2715	FakeAnc2715	FakeDesc2715	SIMULPF00001	250	251	275	226	25	24
2716	FW_pair2716	FakeAnc2716	FakeDesc2716	SIMULPF00001	32	33	35	30	3	2
2717	FW_pair2717	FakeAnc2717	FakeDesc2717	SIMULPF00001	135	123	139	119	4	16
2718	FW_pair2718	FakeAnc2718	FakeDesc2718	SIMULPF00001	165	172	183	154	18	11
2719	FW_pair2719	FakeAnc2719	FakeDesc2719	SIMULPF00001	12	18	19	11	7	1
2720	FW_pair2720	FakeAnc2720	FakeDesc2720	SIMULPF00001	384	383	423	344	39	40
2721	FW_pair2721	FakeAnc2721	FakeDesc2721	SIMULPF00001	610	638	698	550	88	60
2722	FW_pair2722	FakeAnc2722	FakeDesc2722	SIMULPF00001	128	127	138	117	10	11
2723	FW_pair2723	FakeAnc2723	FakeDesc2723	SIMULPF00001	109	104	120	93	11	16
2724	FW_pair2724	FakeAnc2724	FakeDesc2724	SIMULPF00001	139	138	148	129	9	10
2725	FW_pair2725	FakeAnc2725	FakeDesc2725	SIMULPF00001	118	125	132	111	14	7
2726	FW_pair2726	FakeAnc2726	FakeDesc2726	SIMULPF00001	219	225	245	199	26	20
2727	FW_pair2727	FakeAnc2727	FakeDesc2727	SIMULPF00001	253	270	288	235	35	18
2728	FW_pair2728	FakeAnc2728	FakeDesc2728	SIMULPF00001	220	224	243	201	23	19
2729	FW_pair2729	FakeAnc2729	FakeDesc2729	SIMULPF00001	80	87	89	78	9	2
2730	FW_pair2730	FakeAnc2730	FakeDesc2730	SIMULPF00001	221	228	244	205	23	16
2731	FW_pair2731	FakeAnc2731	FakeDesc2731	SIMULPF00001	443	430	473	400	30	43
2732	FW_pair2732	FakeAnc2732	FakeDesc2732	SIMULPF00001	491	486	527	450	36	41
2733	FW_pair2733	FakeAnc2733	FakeDesc2733	SIMULPF00001	26	29	33	22	7	4
2734	FW_pair2734	FakeAnc2734	FakeDesc2734	SIMULPF00001	39	42	45	36	6	3
2735	FW_pair2735	FakeAnc2735	FakeDesc2735	SIMULPF00001	420	416	458	378	38	42
2736	FW_pair2736	FakeAnc2736	FakeDesc2736	SIMULPF00001	302	307	330	279	28	23
2737	FW_pair2737	FakeAnc2737	FakeDesc2737	SIMULPF00001	296	296	317	275	21	21
2738	FW_pair2738	FakeAnc2738	FakeDesc2738	SIMULPF00001	525	529	582	472	57	53
2739	FW_pair2739	FakeAnc2739	FakeDesc2739	SIMULPF00001	166	159	181	144	15	22
2740	FW_pair2740	FakeAnc2740	FakeDesc2740	SIMULPF00001	440	422	466	396	26	44
2741	FW_pair2741	FakeAnc2741	FakeDesc2741	SIMULPF00001	35	37	40	32	5	3
2742	FW_pair2742	FakeAnc2742	FakeDesc2742	SIMULPF00001	251	247	268	230	17	21
2743	FW_pair2743	FakeAnc2743	FakeDesc2743	SIMULPF00001	525	519	564	480	39	45
2744	FW_pair2744	FakeAnc2744	FakeDesc2744	SIMULPF00001	6	6	6	6	0	0
2745	FW_pair2745	FakeAnc2745	FakeDesc2745	SIMULPF00001	93	92	99	86	6	7
2746	FW_pair2746	FakeAnc2746	FakeDesc2746	SIMULPF00001	222	226	243	205	21	17
2747	FW_pair2747	FakeAnc2747	FakeDesc2747	SIMULPF00001	144	140	155	129	11	15
2748	FW_pair2748	FakeAnc2748	FakeDesc2748	SIMULPF00001	11	11	11	11	0	0
2749	FW_pair2749	FakeAnc2749	FakeDesc2749	SIMULPF00001	526	533	576	483	50	43
2750	FW_pair2750	FakeAnc2750	FakeDesc2750	SIMULPF00001	258	248	281	225	23	33
2751	FW_pair2751	FakeAnc2751	FakeDesc2751	SIMULPF00001	303	296	336	263	33	40
2752	FW_pair2752	FakeAnc2752	FakeDesc2752	SIMULPF00001	380	383	418	345	38	35
2753	FW_pair2753	FakeAnc2753	FakeDesc2753	SIMULPF00001	364	362	401	325	37	39
2754	FW_pair2754	FakeAnc2754	FakeDesc2754	SIMULPF00001	57	56	63	50	6	7
2755	FW_pair2755	FakeAnc2755	FakeDesc2755	SIMULPF00001	228	222	245	205	17	23
2756	FW_pair2756	FakeAnc2756	FakeDesc2756	SIMULPF00001	87	83	94	76	7	11
2757	FW_pair2757	FakeAnc2757	FakeDesc2757	SIMULPF00001	373	364	404	333	31	40
2758	FW_pair2758	FakeAnc2758	FakeDesc2758	SIMULPF00001	61	57	65	53	4	8
2759	FW_pair2759	FakeAnc2759	FakeDesc2759	SIMULPF00001	29	28	32	25	3	4
2760	FW_pair2760	FakeAnc2760	FakeDesc2760	SIMULPF00001	907	912	999	820	92	87
2761	FW_pair2761	FakeAnc2761	FakeDesc2761	SIMULPF00001	114	119	123	110	9	4
2762	FW_pair2762	FakeAnc2762	FakeDesc2762	SIMULPF00001	29	31	32	28	3	1
2763	FW_pair2763	FakeAnc2763	FakeDesc2763	SIMULPF00001	244	225	255	214	11	30
2764	FW_pair2764	FakeAnc2764	FakeDesc2764	SIMULPF00001	504	502	542	464	38	40
2765	FW_pair2765	FakeAnc2765	FakeDesc2765	SIMULPF00001	192	192	210	174	18	18
2766	FW_pair2766	FakeAnc2766	FakeDesc2766	SIMULPF00001	107	116	128	95	21	12
2767	FW_pair2767	FakeAnc2767	FakeDesc2767	SIMULPF00001	71	68	73	66	2	5
2768	FW_pair2768	FakeAnc2768	FakeDesc2768	SIMULPF00001	79	75	82	72	3	7
2769	FW_pair2769	FakeAnc2769	FakeDesc2769	SIMULPF00001	12	10	13	9	1	3
2770	FW_pair2770	FakeAnc2770	FakeDesc2770	SIMULPF00001	642	658	712	588	70	54
2771	FW_pair2771	FakeAnc2771	FakeDesc2771	SIMULPF00001	206	207	222	191	16	15
2772	FW_pair2772	FakeAnc2772	FakeDesc2772	SIMULPF00001	292	288	319	261	27	31
2773	FW_pair2773	FakeAnc2773	FakeDesc2773	SIMULPF00001	37	39	40	36	3	1
2774	FW_pair2774	FakeAnc2774	FakeDesc2774	SIMULPF00001	154	150	167	137	13	17
2775	FW_pair2775	FakeAnc2775	FakeDesc2775	SIMULPF00001	21	22	22	21	1	0
2776	FW_pair2776	FakeAnc2776	FakeDesc2776	SIMULPF00001	233	234	253	214	20	19
2777	FW_pair2777	FakeAnc2777	FakeDesc2777	SIMULPF00001	46	44	50	40	4	6
2778	FW_pair2778	FakeAnc2778	FakeDesc2778	SIMULPF00001	156	156	170	142	14	14
2779	FW_pair2779	FakeAnc2779	FakeDesc2779	SIMULPF00001	338	338	370	306	32	32
2780	FW_pair2780	FakeAnc2780	FakeDesc2780	SIMULPF00001	634	640	681	593	47	41
2781	FW_pair2781	FakeAnc2781	FakeDesc2781	SIMULPF00001	78	84	88	74	10	4
2782	FW_pair2782	FakeAnc2782	FakeDesc2782	SIMULPF00001	81	89	96	74	15	7
2783	FW_pair2783	FakeAnc2783	FakeDesc2783	SIMULPF00001	120	126	134	112	14	8
2784	FW_pair2784	FakeAnc2784	FakeDesc2784	SIMULPF00001	36	36	38	34	2	2
2785	FW_pair2785	FakeAnc2785	FakeDesc2785	SIMULPF00001	198	190	209	179	11	19
2786	FW_pair2786	FakeAnc2786	FakeDesc2786	SIMULPF00001	511	500	567	444	56	67
2787	FW_pair2787	FakeAnc2787	FakeDesc2787	SIMULPF00001	301	308	337	272	36	29
2788	FW_pair2788	FakeAnc2788	FakeDesc2788	SIMULPF00001	376	363	409	330	33	46
2789	FW_pair2789	FakeAnc2789	FakeDesc2789	SIMULPF00001	638	659	720	577	82	61
2790	FW_pair2790	FakeAnc2790	FakeDesc2790	SIMULPF00001	94	96	99	91	5	3
2791	FW_pair2791	FakeAnc2791	FakeDesc2791	SIMULPF00001	265	272	296	241	31	24
2792	FW_pair2792	FakeAnc2792	FakeDesc2792	SIMULPF00001	2	2	2	2	0	0
2793	FW_pair2793	FakeAnc2793	FakeDesc2793	SIMULPF00001	56	54	61	49	5	7
2794	FW_pair2794	FakeAnc2794	FakeDesc2794	SIMULPF00001	16	15	17	14	1	2
2795	FW_pair2795	FakeAnc2795	FakeDesc2795	SIMULPF00001	142	138	152	128	10	14
2796	FW_pair2796	FakeAnc2796	FakeDesc2796	SIMULPF00001	50	45	52	43	2	7
2797	FW_pair2797	FakeAnc2797	FakeDesc2797	SIMULPF00001	123	119	135	107	12	16
2798	FW_pair2798	FakeAnc2798	FakeDesc2798	SIMULPF00001	344	361	393	312	49	32
2799	FW_pair2799	FakeAnc2799	FakeDesc2799	SIMULPF00001	339	332	366	305	27	34
2800	FW_pair2800	FakeAnc2800	FakeDesc2800	SIMULPF00001	22	19	22	19	0	3
2801	FW_pair2801	FakeAnc2801	FakeDesc2801	SIMULPF00001	10	9	10	9	0	1
2802	FW_pair2802	FakeAnc2802	FakeDesc2802	SIMULPF00001	536	543	592	487	56	49
2803	FW_pair2803	FakeAnc2803	FakeDesc2803	SIMULPF00001	284	292	318	258	34	26
2804	FW_pair2804	FakeAnc2804	FakeDesc2804	SIMULPF00001	135	130	146	119	11	16
2805	FW_pair2805	FakeAnc2805	FakeDesc2805	SIMULPF00001	31	33	35	29	4	2
2806	FW_pair2806	FakeAnc2806	FakeDesc2806	SIMULPF00001	81	80	87	74	6	7
2807	FW_pair2807	FakeAnc2807	FakeDesc2807	SIMULPF00001	113	101	117	97	4	16
2808	FW_pair2808	FakeAnc2808	FakeDesc2808	SIMULPF00001	354	349	389	314	35	40
2809	FW_pair2809	FakeAnc2809	FakeDesc2809	SIMULPF00001	358	341	387	312	29	46
2810	FW_pair2810	FakeAnc2810	FakeDesc2810	SIMULPF00001	358	357	389	326	31	32
2811	FW_pair2811	FakeAnc2811	FakeDesc2811	SIMULPF00001	68	63	70	61	2	7
2812	FW_pair2812	FakeAnc2812	FakeDesc2812	SIMULPF00001	145	148	159	134	14	11
2813	FW_pair2813	FakeAnc2813	FakeDesc2813	SIMULPF00001	10	8	10	8	0	2
2814	FW_pair2814	FakeAnc2814	FakeDesc2814	SIMULPF00001	233	232	254	211	21	22
2815	FW_pair2815	FakeAnc2815	FakeDesc2815	SIMULPF00001	797	794	876	715	79	82
2816	FW_pair2816	FakeAnc2816	FakeDesc2816	SIMULPF00001	151	147	164	134	13	17
2817	FW_pair2817	FakeAnc2817	FakeDesc2817	SIMULPF00001	355	350	383	322	28	33
2818	FW_pair2818	FakeAnc2818	FakeDesc2818	SIMULPF00001	25	25	28	22	3	3
2819	FW_pair2819	FakeAnc2819	FakeDesc2819	SIMULPF00001	339	340	367	312	28	27
2820	FW_pair2820	FakeAnc2820	FakeDesc2820	SIMULPF00001	400	392	435	357	35	43
2821	FW_pair2821	FakeAnc2821	FakeDesc2821	SIMULPF00001	163	162	176	149	13	14
2822	FW_pair2822	FakeAnc2822	FakeDesc2822	SIMULPF00001	152	156	169	139	17	13
2823	FW_pair2823	FakeAnc2823	FakeDesc2823	SIMULPF00001	32	34	35	31	3	1
2824	FW_pair2824	FakeAnc2824	FakeDesc2824	SIMULPF00001	23	24	24	23	1	0
2825	FW_pair2825	FakeAnc2825	FakeDesc2825	SIMULPF00001	364	347	390	321	26	43
2826	FW_pair2826	FakeAnc2826	FakeDesc2826	SIMULPF00001	198	192	212	178	14	20
2827	FW_pair2827	FakeAnc2827	FakeDesc2827	SIMULPF00001	98	95	105	88	7	10
2828	FW_pair2828	FakeAnc2828	FakeDesc2828	SIMULPF00001	1	1	1	1	0	0
2829	FW_pair2829	FakeAnc2829	FakeDesc2829	SIMULPF00001	97	98	106	89	9	8
2830	FW_pair2830	FakeAnc2830	FakeDesc2830	SIMULPF00001	374	363	400	337	26	37
2831	FW_pair2831	FakeAnc2831	FakeDesc2831	SIMULPF00001	190	185	211	164	21	26
2832	FW_pair2832	FakeAnc2832	FakeDesc2832	SIMULPF00001	233	231	256	208	23	25
2833	FW_pair2833	FakeAnc2833	FakeDesc2833	SIMULPF00001	494	486	540	440	46	54
2834	FW_pair2834	FakeAnc2834	FakeDesc2834	SIMULPF00001	841	842	923	760	82	81
2835	FW_pair2835	FakeAnc2835	FakeDesc2835	SIMULPF00001	12	13	13	12	1	0
2836	FW_pair2836	FakeAnc2836	FakeDesc2836	SIMULPF00001	5	4	5	4	0	1
2837	FW_pair2837	FakeAnc2837	FakeDesc2837	SIMULPF00001	44	46	47	43	3	1
2838	FW_pair2838	FakeAnc2838	FakeDesc2838	SIMULPF00001	409	417	449	377	40	32
2839	FW_pair2839	FakeAnc2839	FakeDesc2839	SIMULPF00001	96	97	102	91	6	5
2840	FW_pair2840	FakeAnc2840	FakeDesc2840	SIMULPF00001	215	230	253	192	38	23
2841	FW_pair2841	FakeAnc2841	FakeDesc2841	SIMULPF00001	41	33	43	31	2	10
2842	FW_pair2842	FakeAnc2842	FakeDesc2842	SIMULPF00001	48	50	55	43	7	5
2843	FW_pair2843	FakeAnc2843	FakeDesc2843	SIMULPF00001	88	84	89	83	1	5
2844	FW_pair2844	FakeAnc2844	FakeDesc2844	SIMULPF00001	4	4	4	4	0	0
2845	FW_pair2845	FakeAnc2845	FakeDesc2845	SIMULPF00001	427	428	473	382	46	45
2846	FW_pair2846	FakeAnc2846	FakeDesc2846	SIMULPF00001	185	185	208	162	23	23
2847	FW_pair2847	FakeAnc2847	FakeDesc2847	SIMULPF00001	23	24	24	23	1	0
2848	FW_pair2848	FakeAnc2848	FakeDesc2848	SIMULPF00001	159	156	169	146	10	13
2849	FW_pair2849	FakeAnc2849	FakeDesc2849	SIMULPF00001	516	523	558	481	42	35
2850	FW_pair2850	FakeAnc2850	FakeDesc2850	SIMULPF00001	34	39	39	34	5	0
2851	FW_pair2851	FakeAnc2851	FakeDesc2851	SIMULPF00001	149	144	159	134	10	15
2852	FW_pair2852	FakeAnc2852	FakeDesc2852	SIMULPF00001	598	603	661	540	63	58
2853	FW_pair2853	FakeAnc2853	FakeDesc2853	SIMULPF00001	174	163	182	155	8	19
2854	FW_pair2854	FakeAnc2854	FakeDesc2854	SIMULPF00001	22	18	24	16	2	6
2855	FW_pair2855	FakeAnc2855	FakeDesc2855	SIMULPF00001	244	240	261	223	17	21
2856	FW_pair2856	FakeAnc2856	FakeDesc2856	SIMULPF00001	57	56	58	55	1	2
2857	FW_pair2857	FakeAnc2857	FakeDesc2857	SIMULPF00001	640	618	677	581	37	59
2858	FW_pair2858	FakeAnc2858	FakeDesc2858	SIMULPF00001	414	434	471	377	57	37
2859	FW_pair2859	FakeAnc2859	FakeDesc2859	SIMULPF00001	6	9	9	6	3	0
2860	FW_pair2860	FakeAnc2860	FakeDesc2860	SIMULPF00001	23	19	28	14	5	9
2861	FW_pair2861	FakeAnc2861	FakeDesc2861	SIMULPF00001	81	87	90	78	9	3
2862	FW_pair2862	FakeAnc2862	FakeDesc2862	SIMULPF00001	20	22	23	19	3	1
2863	FW_pair2863	FakeAnc2863	FakeDesc2863	SIMULPF00001	112	117	121	108	9	4
2864	FW_pair2864	FakeAnc2864	FakeDesc2864	SIMULPF00001	76	71	79	68	3	8
2865	FW_pair2865	FakeAnc2865	FakeDesc2865	SIMULPF00001	142	137	156	123	14	19
2866	FW_pair2866	FakeAnc2866	FakeDesc2866	SIMULPF00001	13	12	13	12	0	1
2867	FW_pair2867	FakeAnc2867	FakeDesc2867	SIMULPF00001	186	184	200	170	14	16
2868	FW_pair2868	FakeAnc2868	FakeDesc2868	SIMULPF00001	410	423	468	365	58	45
2869	FW_pair2869	FakeAnc2869	FakeDesc2869	SIMULPF00001	231	225	249	207	18	24
2870	FW_pair2870	FakeAnc2870	FakeDesc2870	SIMULPF00001	300	307	330	277	30	23
2871	FW_pair2871	FakeAnc2871	FakeDesc2871	SIMULPF00001	67	79	81	65	14	2
2872	FW_pair2872	FakeAnc2872	FakeDesc2872	SIMULPF00001	84	85	97	72	13	12
2873	FW_pair2873	FakeAnc2873	FakeDesc2873	SIMULPF00001	20	24	24	20	4	0
2874	FW_pair2874	FakeAnc2874	FakeDesc2874	SIMULPF00001	349	333	369	313	20	36
2875	FW_pair2875	FakeAnc2875	FakeDesc2875	SIMULPF00001	496	495	549	442	53	54
2876	FW_pair2876	FakeAnc2876	FakeDesc2876	SIMULPF00001	44	37	51	30	7	14
2877	FW_pair2877	FakeAnc2877	FakeDesc2877	SIMULPF00001	138	140	155	123	17	15
2878	FW_pair2878	FakeAnc2878	FakeDesc2878	SIMULPF00001	35	36	38	33	3	2
2879	FW_pair2879	FakeAnc2879	FakeDesc2879	SIMULPF00001	4	4	4	4	0	0
2880	FW_pair2880	FakeAnc2880	FakeDesc2880	SIMULPF00001	83	94	99	78	16	5
2881	FW_pair2881	FakeAnc2881	FakeDesc2881	SIMULPF00001	260	259	280	239	20	21
2882	FW_pair2882	FakeAnc2882	FakeDesc2882	SIMULPF00001	156	159	166	149	10	7
2883	FW_pair2883	FakeAnc2883	FakeDesc2883	SIMULPF00001	6	6	6	6	0	0
2884	FW_pair2884	FakeAnc2884	FakeDesc2884	SIMULPF00001	613	607	667	553	54	60
2885	FW_pair2885	FakeAnc2885	FakeDesc2885	SIMULPF00001	144	146	158	132	14	12
2886	FW_pair2886	FakeAnc2886	FakeDesc2886	SIMULPF00001	127	122	138	111	11	16
2887	FW_pair2887	FakeAnc2887	FakeDesc2887	SIMULPF00001	27	27	30	24	3	3
2888	FW_pair2888	FakeAnc2888	FakeDesc2888	SIMULPF00001	157	149	165	141	8	16
2889	FW_pair2889	FakeAnc2889	FakeDesc2889	SIMULPF00001	241	236	268	209	27	32
2890	FW_pair2890	FakeAnc2890	FakeDesc2890	SIMULPF00001	196	191	217	170	21	26
2891	FW_pair2891	FakeAnc2891	FakeDesc2891	SIMULPF00001	3	3	4	2	1	1
2892	FW_pair2892	FakeAnc2892	FakeDesc2892	SIMULPF00001	87	85	96	76	9	11
2893	FW_pair2893	FakeAnc2893	FakeDesc2893	SIMULPF00001	302	295	327	270	25	32
2894	FW_pair2894	FakeAnc2894	FakeDesc2894	SIMULPF00001	125	129	143	111	18	14
2895	FW_pair2895	FakeAnc2895	FakeDesc2895	SIMULPF00001	10	8	10	8	0	2
2896	FW_pair2896	FakeAnc2896	FakeDesc2896	SIMULPF00001	141	139	153	127	12	14
2897	FW_pair2897	FakeAnc2897	FakeDesc2897	SIMULPF00001	125	135	144	116	19	9
2898	FW_pair2898	FakeAnc2898	FakeDesc2898	SIMULPF00001	241	248	265	224	24	17
2899	FW_pair2899	FakeAnc2899	FakeDesc2899	SIMULPF00001	78	72	79	71	1	7
2900	FW_pair2900	FakeAnc2900	FakeDesc2900	SIMULPF00001	237	228	253	212	16	25
2901	FW_pair2901	FakeAnc2901	FakeDesc2901	SIMULPF00001	811	822	897	736	86	75
2902	FW_pair2902	FakeAnc2902	FakeDesc2902	SIMULPF00001	343	331	372	302	29	41
2903	FW_pair2903	FakeAnc2903	FakeDesc2903	SIMULPF00001	444	462	492	414	48	30
2904	FW_pair2904	FakeAnc2904	FakeDesc2904	SIMULPF00001	20	20	21	19	1	1
2905	FW_pair2905	FakeAnc2905	FakeDesc2905	SIMULPF00001	337	353	384	306	47	31
2906	FW_pair2906	FakeAnc2906	FakeDesc2906	SIMULPF00001	102	99	115	86	13	16
2907	FW_pair2907	FakeAnc2907	FakeDesc2907	SIMULPF00001	142	139	148	133	6	9
2908	FW_pair2908	FakeAnc2908	FakeDesc2908	SIMULPF00001	2	2	2	2	0	0
2909	FW_pair2909	FakeAnc2909	FakeDesc2909	SIMULPF00001	543	523	587	479	44	64
2910	FW_pair2910	FakeAnc2910	FakeDesc2910	SIMULPF00001	190	173	200	163	10	27
2911	FW_pair2911	FakeAnc2911	FakeDesc2911	SIMULPF00001	564	562	622	504	58	60
2912	FW_pair2912	FakeAnc2912	FakeDesc2912	SIMULPF00001	240	237	266	211	26	29
2913	FW_pair2913	FakeAnc2913	FakeDesc2913	SIMULPF00001	25	26	27	24	2	1
2914	FW_pair2914	FakeAnc2914	FakeDesc2914	SIMULPF00001	43	40	46	37	3	6
2915	FW_pair2915	FakeAnc2915	FakeDesc2915	SIMULPF00001	419	417	463	373	44	46
2916	FW_pair2916	FakeAnc2916	FakeDesc2916	SIMULPF00001	33	32	36	29	3	4
2917	FW_pair2917	FakeAnc2917	FakeDesc2917	SIMULPF00001	10	10	10	10	0	0
2918	FW_pair2918	FakeAnc2918	FakeDesc2918	SIMULPF00001	45	44	48	41	3	4
2919	FW_pair2919	FakeAnc2919	FakeDesc2919	SIMULPF00001	187	188	210	165	23	22
2920	FW_pair2920	FakeAnc2920	FakeDesc2920	SIMULPF00001	268	267	288	247	20	21
2921	FW_pair2921	FakeAnc2921	FakeDesc2921	SIMULPF00001	287	317	331	273	44	14
2922	FW_pair2922	FakeAnc2922	FakeDesc2922	SIMULPF00001	53	53	58	48	5	5
2923	FW_pair2923	FakeAnc2923	FakeDesc2923	SIMULPF00001	32	35	37	30	5	2
2924	FW_pair2924	FakeAnc2924	FakeDesc2924	SIMULPF00001	292	307	324	275	32	17
2925	FW_pair2925	FakeAnc2925	FakeDesc2925	SIMULPF00001	428	422	463	387	35	41
2926	FW_pair2926	FakeAnc2926	FakeDesc2926	SIMULPF00001	77	79	84	72	7	5
2927	FW_pair2927	FakeAnc2927	FakeDesc2927	SIMULPF00001	14	18	18	14	4	0
2928	FW_pair2928	FakeAnc2928	FakeDesc2928	SIMULPF00001	698	706	767	637	69	61
2929	FW_pair2929	FakeAnc2929	FakeDesc2929	SIMULPF00001	413	409	451	371	38	42
2930	FW_pair2930	FakeAnc2930	FakeDesc2930	SIMULPF00001	246	242	275	213	29	33
2931	FW_pair2931	FakeAnc2931	FakeDesc2931	SIMULPF00001	267	265	286	246	19	21
2932	FW_pair2932	FakeAnc2932	FakeDesc2932	SIMULPF00001	11	9	11	9	0	2
2933	FW_pair2933	FakeAnc2933	FakeDesc2933	SIMULPF00001	278	287	301	264	23	14
2934	FW_pair2934	FakeAnc2934	FakeDesc2934	SIMULPF00001	162	158	173	147	11	15
2935	FW_pair2935	FakeAnc2935	FakeDesc2935	SIMULPF00001	50	47	53	44	3	6
2936	FW_pair2936	FakeAnc2936	FakeDesc2936	SIMULPF00001	83	87	92	78	9	5
2937	FW_pair2937	FakeAnc2937	FakeDesc2937	SIMULPF00001	96	86	101	81	5	15
2938	FW_pair2938	FakeAnc2938	FakeDesc2938	SIMULPF00001	69	72	72	69	3	0
2939	FW_pair2939	FakeAnc2939	FakeDesc2939	SIMULPF00001	118	111	122	107	4	11
2940	FW_pair2940	FakeAnc2940	FakeDesc2940	SIMULPF00001	416	417	450	383	34	33
2941	FW_pair2941	FakeAnc2941	FakeDesc2941	SIMULPF00001	91	86	97	80	6	11
2942	FW_pair2942	FakeAnc2942	FakeDesc2942	SIMULPF00001	812	801	882	731	70	81
2943	FW_pair2943	FakeAnc2943	FakeDesc2943	SIMULPF00001	771	784	844	711	73	60
2944	FW_pair2944	FakeAnc2944	FakeDesc2944	SIMULPF00001	335	344	374	305	39	30
2945	FW_pair2945	FakeAnc2945	FakeDesc2945	SIMULPF00001	307	319	339	287	32	20
2946	FW_pair2946	FakeAnc2946	FakeDesc2946	SIMULPF00001	501	503	554	450	53	51
2947	FW_pair2947	FakeAnc2947	FakeDesc2947	SIMULPF00001	126	127	135	118	9	8
2948	FW_pair2948	FakeAnc2948	FakeDesc2948	SIMULPF00001	13	12	13	12	0	1
2949	FW_pair2949	FakeAnc2949	FakeDesc2949	SIMULPF00001	381	373	412	342	31	39
2950	FW_pair2950	FakeAnc2950	FakeDesc2950	SIMULPF00001	68	67	74	61	6	7
2951	FW_pair2951	FakeAnc2951	FakeDesc2951	SIMULPF00001	29	31	34	26	5	3
2952	FW_pair2952	FakeAnc2952	FakeDesc2952	SIMULPF00001	406	397	436	367	30	39
2953	FW_pair2953	FakeAnc2953	FakeDesc2953	SIMULPF00001	215	214	233	196	18	19
2954	FW_pair2954	FakeAnc2954	FakeDesc2954	SIMULPF00001	231	226	249	208	18	23
2955	FW_pair2955	FakeAnc2955	FakeDesc2955	SIMULPF00001	313	313	339	287	26	26
2956	FW_pair2956	FakeAnc2956	FakeDesc2956	SIMULPF00001	96	96	105	87	9	9
2957	FW_pair2957	FakeAnc2957	FakeDesc2957	SIMULPF00001	247	251	271	227	24	20
2958	FW_pair2958	FakeAnc2958	FakeDesc2958	SIMULPF00001	221	234	244	211	23	10
2959	FW_pair2959	FakeAnc2959	FakeDesc2959	SIMULPF00001	486	470	516	440	30	46
2960	FW_pair2960	FakeAnc2960	FakeDesc2960	SIMULPF00001	216	217	233	200	17	16
2961	FW_pair2961	FakeAnc2961	FakeDesc2961	SIMULPF00001	200	195	223	172	23	28
2962	FW_pair2962	FakeAnc2962	FakeDesc2962	SIMULPF00001	360	341	385	316	25	44
2963	FW_pair2963	FakeAnc2963	FakeDesc2963	SIMULPF00001	7	6	8	5	1	2
2964	FW_pair2964	FakeAnc2964	FakeDesc2964	SIMULPF00001	12	13	13	12	1	0
2965	FW_pair2965	FakeAnc2965	FakeDesc2965	SIMULPF00001	70	66	76	60	6	10
2966	FW_pair2966	FakeAnc2966	FakeDesc2966	SIMULPF00001	621	639	686	574	65	47
2967	FW_pair2967	FakeAnc2967	FakeDesc2967	SIMULPF00001	132	145	153	124	21	8
2968	FW_pair2968	FakeAnc2968	FakeDesc2968	SIMULPF00001	496	494	547	443	51	53
2969	FW_pair2969	FakeAnc2969	FakeDesc2969	SIMULPF00001	163	173	183	153	20	10
2970	FW_pair2970	FakeAnc2970	FakeDesc2970	SIMULPF00001	10	10	10	10	0	0
2971	FW_pair2971	FakeAnc2971	FakeDesc2971	SIMULPF00001	540	542	593	489	53	51
2972	FW_pair2972	FakeAnc2972	FakeDesc2972	SIMULPF00001	53	49	55	47	2	6
2973	FW_pair2973	FakeAnc2973	FakeDesc2973	SIMULPF00001	80	73	84	69	4	11
2974	FW_pair2974	FakeAnc2974	FakeDesc2974	SIMULPF00001	147	141	158	130	11	17
2975	FW_pair2975	FakeAnc2975	FakeDesc2975	SIMULPF00001	52	51	58	45	6	7
2976	FW_pair2976	FakeAnc2976	FakeDesc2976	SIMULPF00001	70	70	72	68	2	2
2977	FW_pair2977	FakeAnc2977	FakeDesc2977	SIMULPF00001	188	198	213	173	25	15
2978	FW_pair2978	FakeAnc2978	FakeDesc2978	SIMULPF00001	131	140	144	127	13	4
2979	FW_pair2979	FakeAnc2979	FakeDesc2979	SIMULPF00001	84	85	91	78	7	6
2980	FW_pair2980	FakeAnc2980	FakeDesc2980	SIMULPF00001	257	284	294	247	37	10
2981	FW_pair2981	FakeAnc2981	FakeDesc2981	SIMULPF00001	452	460	501	411	49	41
2982	FW_pair2982	FakeAnc2982	FakeDesc2982	SIMULPF00001	8	11	11	8	3	0
2983	FW_pair2983	FakeAnc2983	FakeDesc2983	SIMULPF00001	184	186	202	168	18	16
2984	FW_pair2984	FakeAnc2984	FakeDesc2984	SIMULPF00001	283	287	314	256	31	27
2985	FW_pair2985	FakeAnc2985	FakeDesc2985	SIMULPF00001	108	112	124	96	16	12
2986	FW_pair2986	FakeAnc2986	FakeDesc2986	SIMULPF00001	82	81	88	75	6	7
2987	FW_pair2987	FakeAnc2987	FakeDesc2987	SIMULPF00001	27	25	27	25	0	2
2988	FW_pair2988	FakeAnc2988	FakeDesc2988	SIMULPF00001	1	1	1	1	0	0
2989	FW_pair2989	FakeAnc2989	FakeDesc2989	SIMULPF00001	43	47	47	43	4	0
2990	FW_pair2990	FakeAnc2990	FakeDesc2990	SIMULPF00001	151	141	161	131	10	20
2991	FW_pair2991	FakeAnc2991	FakeDesc2991	SIMULPF00001	264	271	287	248	23	16
2992	FW_pair2992	FakeAnc2992	FakeDesc2992	SIMULPF00001	13	12	16	9	3	4
2993	FW_pair2993	FakeAnc2993	FakeDesc2993	SIMULPF00001	118	109	123	104	5	14
2994	FW_pair2994	FakeAnc2994	FakeDesc2994	SIMULPF00001	547	549	602	494	55	53
2995	FW_pair2995	FakeAnc2995	FakeDesc2995	SIMULPF00001	291	291	312	270	21	21
2996	FW_pair2996	FakeAnc2996	FakeDesc2996	SIMULPF00001	282	273	302	253	20	29
2997	FW_pair2997	FakeAnc2997	FakeDesc2997	SIMULPF00001	235	241	263	213	28	22
2998	FW_pair2998	FakeAnc2998	FakeDesc2998	SIMULPF00001	576	569	627	518	51	58
2999	FW_pair2999	FakeAnc2999	FakeDesc2999	SIMULPF00001	468	467	521	414	53	54
3000	FW_pair3000	FakeAnc3000	FakeDesc3000	SIMULPF00001	254	281	295	240	41	14
3001	FW_pair3001	FakeAnc3001	FakeDesc3001	SIMULPF00001	358	346	385	319	27	39
3002	FW_pair3002	FakeAnc3002	FakeDesc3002	SIMULPF00001	136	138	151	123	15	13
3003	FW_pair3003	FakeAnc3003	FakeDesc3003	SIMULPF00001	740	742	811	671	71	69
3004	FW_pair3004	FakeAnc3004	FakeDesc3004	SIMULPF00001	276	276	298	254	22	22
3005	FW_pair3005	FakeAnc3005	FakeDesc3005	SIMULPF00001	67	74	81	60	14	7
3006	FW_pair3006	FakeAnc3006	FakeDesc3006	SIMULPF00001	304	317	341	280	37	24
3007	FW_pair3007	FakeAnc3007	FakeDesc3007	SIMULPF00001	43	44	47	40	4	3
3008	FW_pair3008	FakeAnc3008	FakeDesc3008	SIMULPF00001	422	427	468	381	46	41
3009	FW_pair3009	FakeAnc3009	FakeDesc3009	SIMULPF00001	220	224	243	201	23	19
3010	FW_pair3010	FakeAnc3010	FakeDesc3010	SIMULPF00001	240	240	265	215	25	25
3011	FW_pair3011	FakeAnc3011	FakeDesc3011	SIMULPF00001	310	295	327	278	17	32
3012	FW_pair3012	FakeAnc3012	FakeDesc3012	SIMULPF00001	188	201	209	180	21	8
3013	FW_pair3013	FakeAnc3013	FakeDesc3013	SIMULPF00001	107	103	121	89	14	18
3014	FW_pair3014	FakeAnc3014	FakeDesc3014	SIMULPF00001	303	301	336	268	33	35
3015	FW_pair3015	FakeAnc3015	FakeDesc3015	SIMULPF00001	34	31	34	31	0	3
3016	FW_pair3016	FakeAnc3016	FakeDesc3016	SIMULPF00001	128	141	144	125	16	3
3017	FW_pair3017	FakeAnc3017	FakeDesc3017	SIMULPF00001	486	493	535	444	49	42
3018	FW_pair3018	FakeAnc3018	FakeDesc3018	SIMULPF00001	370	381	406	345	36	25
3019	FW_pair3019	FakeAnc3019	FakeDesc3019	SIMULPF00001	320	330	362	288	42	32
3020	FW_pair3020	FakeAnc3020	FakeDesc3020	SIMULPF00001	32	36	37	31	5	1
3021	FW_pair3021	FakeAnc3021	FakeDesc3021	SIMULPF00001	284	285	308	261	24	23
3022	FW_pair3022	FakeAnc3022	FakeDesc3022	SIMULPF00001	177	168	191	154	14	23
3023	FW_pair3023	FakeAnc3023	FakeDesc3023	SIMULPF00001	181	171	201	151	20	30
3024	FW_pair3024	FakeAnc3024	FakeDesc3024	SIMULPF00001	428	433	475	386	47	42
3025	FW_pair3025	FakeAnc3025	FakeDesc3025	SIMULPF00001	441	423	475	389	34	52
3026	FW_pair3026	FakeAnc3026	FakeDesc3026	SIMULPF00001	245	252	273	224	28	21
3027	FW_pair3027	FakeAnc3027	FakeDesc3027	SIMULPF00001	21	24	24	21	3	0
3028	FW_pair3028	FakeAnc3028	FakeDesc3028	SIMULPF00001	266	264	288	242	22	24
3029	FW_pair3029	FakeAnc3029	FakeDesc3029	SIMULPF00001	82	91	95	78	13	4
3030	FW_pair3030	FakeAnc3030	FakeDesc3030	SIMULPF00001	26	29	30	25	4	1
3031	FW_pair3031	FakeAnc3031	FakeDesc3031	SIMULPF00001	394	385	422	357	28	37
3032	FW_pair3032	FakeAnc3032	FakeDesc3032	SIMULPF00001	239	247	271	215	32	24
3033	FW_pair3033	FakeAnc3033	FakeDesc3033	SIMULPF00001	81	86	89	78	8	3
3034	FW_pair3034	FakeAnc3034	FakeDesc3034	SIMULPF00001	172	172	196	148	24	24
3035	FW_pair3035	FakeAnc3035	FakeDesc3035	SIMULPF00001	10	9	10	9	0	1
3036	FW_pair3036	FakeAnc3036	FakeDesc3036	SIMULPF00001	314	328	367	275	53	39
3037	FW_pair3037	FakeAnc3037	FakeDesc3037	SIMULPF00001	630	642	699	573	69	57
3038	FW_pair3038	FakeAnc3038	FakeDesc3038	SIMULPF00001	36	35	40	31	4	5
3039	FW_pair3039	FakeAnc3039	FakeDesc3039	SIMULPF00001	565	566	622	509	57	56
3040	FW_pair3040	FakeAnc3040	FakeDesc3040	SIMULPF00001	10	10	11	9	1	1
3041	FW_pair3041	FakeAnc3041	FakeDesc3041	SIMULPF00001	76	75	81	70	5	6
3042	FW_pair3042	FakeAnc3042	FakeDesc3042	SIMULPF00001	9	11	11	9	2	0
3043	FW_pair3043	FakeAnc3043	FakeDesc3043	SIMULPF00001	46	46	50	42	4	4
3044	FW_pair3044	FakeAnc3044	FakeDesc3044	SIMULPF00001	3	3	3	3	0	0
3045	FW_pair3045	FakeAnc3045	FakeDesc3045	SIMULPF00001	249	244	271	222	22	27
3046	FW_pair3046	FakeAnc3046	FakeDesc3046	SIMULPF00001	119	111	124	106	5	13
3047	FW_pair3047	FakeAnc3047	FakeDesc3047	SIMULPF00001	567	552	604	515	37	52
3048	FW_pair3048	FakeAnc3048	FakeDesc3048	SIMULPF00001	101	95	110	86	9	15
3049	FW_pair3049	FakeAnc3049	FakeDesc3049	SIMULPF00001	147	140	157	130	10	17
3050	FW_pair3050	FakeAnc3050	FakeDesc3050	SIMULPF00001	352	353	380	325	28	27
3051	FW_pair3051	FakeAnc3051	FakeDesc3051	SIMULPF00001	386	393	425	354	39	32
3052	FW_pair3052	FakeAnc3052	FakeDesc3052	SIMULPF00001	69	76	83	62	14	7
3053	FW_pair3053	FakeAnc3053	FakeDesc3053	SIMULPF00001	24	21	25	20	1	4
3054	FW_pair3054	FakeAnc3054	FakeDesc3054	SIMULPF00001	56	62	66	52	10	4
3055	FW_pair3055	FakeAnc3055	FakeDesc3055	SIMULPF00001	101	103	115	89	14	12
3056	FW_pair3056	FakeAnc3056	FakeDesc3056	SIMULPF00001	93	89	102	80	9	13
3057	FW_pair3057	FakeAnc3057	FakeDesc3057	SIMULPF00001	406	415	458	363	52	43
3058	FW_pair3058	FakeAnc3058	FakeDesc3058	SIMULPF00001	105	109	113	101	8	4
3059	FW_pair3059	FakeAnc3059	FakeDesc3059	SIMULPF00001	249	276	295	230	46	19
3060	FW_pair3060	FakeAnc3060	FakeDesc3060	SIMULPF00001	229	220	248	201	19	28
3061	FW_pair3061	FakeAnc3061	FakeDesc3061	SIMULPF00001	54	53	57	50	3	4
3062	FW_pair3062	FakeAnc3062	FakeDesc3062	SIMULPF00001	633	630	704	559	71	74
3063	FW_pair3063	FakeAnc3063	FakeDesc3063	SIMULPF00001	184	176	198	162	14	22
3064	FW_pair3064	FakeAnc3064	FakeDesc3064	SIMULPF00001	94	95	104	85	10	9
3065	FW_pair3065	FakeAnc3065	FakeDesc3065	SIMULPF00001	317	322	356	283	39	34
3066	FW_pair3066	FakeAnc3066	FakeDesc3066	SIMULPF00001	609	617	672	554	63	55
3067	FW_pair3067	FakeAnc3067	FakeDesc3067	SIMULPF00001	1	2	2	1	1	0
3068	FW_pair3068	FakeAnc3068	FakeDesc3068	SIMULPF00001	187	187	205	169	18	18
3069	FW_pair3069	FakeAnc3069	FakeDesc3069	SIMULPF00001	146	153	162	137	16	9
3070	FW_pair3070	FakeAnc3070	FakeDesc3070	SIMULPF00001	5	6	6	5	1	0
3071	FW_pair3071	FakeAnc3071	FakeDesc3071	SIMULPF00001	17	17	18	16	1	1
3072	FW_pair3072	FakeAnc3072	FakeDesc3072	SIMULPF00001	39	36	39	36	0	3
3073	FW_pair3073	FakeAnc3073	FakeDesc3073	SIMULPF00001	558	538	605	491	47	67
3074	FW_pair3074	FakeAnc3074	FakeDesc3074	SIMULPF00001	411	428	458	381	47	30
3075	FW_pair3075	FakeAnc3075	FakeDesc3075	SIMULPF00001	334	335	369	300	35	34
3076	FW_pair3076	FakeAnc3076	FakeDesc3076	SIMULPF00001	537	533	582	488	45	49
3077	FW_pair3077	FakeAnc3077	FakeDesc3077	SIMULPF00001	21	16	21	16	0	5
3078	FW_pair3078	FakeAnc3078	FakeDesc3078	SIMULPF00001	49	52	55	46	6	3
3079	FW_pair3079	FakeAnc3079	FakeDesc3079	SIMULPF00001	216	199	232	183	16	33
3080	FW_pair3080	FakeAnc3080	FakeDesc3080	SIMULPF00001	915	894	988	821	73	94
3081	FW_pair3081	FakeAnc3081	FakeDesc3081	SIMULPF00001	151	148	165	134	14	17
3082	FW_pair3082	FakeAnc3082	FakeDesc3082	SIMULPF00001	192	203	217	178	25	14
3083	FW_pair3083	FakeAnc3083	FakeDesc3083	SIMULPF00001	815	793	886	722	71	93
3084	FW_pair3084	FakeAnc3084	FakeDesc3084	SIMULPF00001	70	68	76	62	6	8
3085	FW_pair3085	FakeAnc3085	FakeDesc3085	SIMULPF00001	411	403	455	359	44	52
3086	FW_pair3086	FakeAnc3086	FakeDesc3086	SIMULPF00001	53	54	57	50	4	3
3087	FW_pair3087	FakeAnc3087	FakeDesc3087	SIMULPF00001	7	7	7	7	0	0
3088	FW_pair3088	FakeAnc3088	FakeDesc3088	SIMULPF00001	191	194	215	170	24	21
3089	FW_pair3089	FakeAnc3089	FakeDesc3089	SIMULPF00001	75	73	77	71	2	4
3090	FW_pair3090	FakeAnc3090	FakeDesc3090	SIMULPF00001	21	21	23	19	2	2
3091	FW_pair3091	FakeAnc3091	FakeDesc3091	SIMULPF00001	5	5	5	5	0	0
3092	FW_pair3092	FakeAnc3092	FakeDesc3092	SIMULPF00001	236	248	266	218	30	18
3093	FW_pair3093	FakeAnc3093	FakeDesc3093	SIMULPF00001	82	80	83	79	1	3
3094	FW_pair3094	FakeAnc3094	FakeDesc3094	SIMULPF00001	38	33	39	32	1	6
3095	FW_pair3095	FakeAnc3095	FakeDesc3095	SIMULPF00001	233	219	252	200	19	33
3096	FW_pair3096	FakeAnc3096	FakeDesc3096	SIMULPF00001	146	142	154	134	8	12
3097	FW_pair3097	FakeAnc3097	FakeDesc3097	SIMULPF00001	89	85	93	81	4	8
3098	FW_pair3098	FakeAnc3098	FakeDesc3098	SIMULPF00001	236	248	264	220	28	16
3099	FW_pair3099	FakeAnc3099	FakeDesc3099	SIMULPF00001	26	23	26	23	0	3
3100	FW_pair3100	FakeAnc3100	FakeDesc3100	SIMULPF00001	31	33	39	25	8	6
3101	FW_pair3101	FakeAnc3101	FakeDesc3101	SIMULPF00001	820	837	908	749	88	71
3102	FW_pair3102	FakeAnc3102	FakeDesc3102	SIMULPF00001	113	117	128	102	15	11
3103	FW_pair3103	FakeAnc3103	FakeDesc3103	SIMULPF00001	338	315	357	296	19	42
3104	FW_pair3104	FakeAnc3104	FakeDesc3104	SIMULPF00001	19	18	20	17	1	2
3105	FW_pair3105	FakeAnc3105	FakeDesc3105	SIMULPF00001	320	305	338	287	18	33
3106	FW_pair3106	FakeAnc3106	FakeDesc3106	SIMULPF00001	398	414	439	373	41	25
3107	FW_pair3107	FakeAnc3107	FakeDesc3107	SIMULPF00001	491	486	524	453	33	38
3108	FW_pair3108	FakeAnc3108	FakeDesc3108	SIMULPF00001	26	29	30	25	4	1
3109	FW_pair3109	FakeAnc3109	FakeDesc3109	SIMULPF00001	52	60	65	47	13	5
3110	FW_pair3110	FakeAnc3110	FakeDesc3110	SIMULPF00001	499	494	542	451	43	48
3111	FW_pair3111	FakeAnc3111	FakeDesc3111	SIMULPF00001	630	631	693	568	63	62
3112	FW_pair3112	FakeAnc3112	FakeDesc3112	SIMULPF00001	12	15	16	11	4	1
3113	FW_pair3113	FakeAnc3113	FakeDesc3113	SIMULPF00001	104	99	110	93	6	11
3114	FW_pair3114	FakeAnc3114	FakeDesc3114	SIMULPF00001	450	463	499	414	49	36
3115	FW_pair3115	FakeAnc3115	FakeDesc3115	SIMULPF00001	96	98	107	87	11	9
3116	FW_pair3116	FakeAnc3116	FakeDesc3116	SIMULPF00001	24	26	26	24	2	0
3117	FW_pair3117	FakeAnc3117	FakeDesc3117	SIMULPF00001	99	93	104	88	5	11
3118	FW_pair3118	FakeAnc3118	FakeDesc3118	SIMULPF00001	502	493	540	455	38	47
3119	FW_pair3119	FakeAnc3119	FakeDesc3119	SIMULPF00001	119	120	131	108	12	11
3120	FW_pair3120	FakeAnc3120	FakeDesc3120	SIMULPF00001	158	164	170	152	12	6
3121	FW_pair3121	FakeAnc3121	FakeDesc3121	SIMULPF00001	443	476	503	416	60	27
3122	FW_pair3122	FakeAnc3122	FakeDesc3122	SIMULPF00001	54	56	61	49	7	5
3123	FW_pair3123	FakeAnc3123	FakeDesc3123	SIMULPF00001	131	121	139	113	8	18
3124	FW_pair3124	FakeAnc3124	FakeDesc3124	SIMULPF00001	125	131	141	115	16	10
3125	FW_pair3125	FakeAnc3125	FakeDesc3125	SIMULPF00001	616	641	696	561	80	55
3126	FW_pair3126	FakeAnc3126	FakeDesc3126	SIMULPF00001	308	314	346	276	38	32
3127	FW_pair3127	FakeAnc3127	FakeDesc3127	SIMULPF00001	28	25	29	24	1	4
3128	FW_pair3128	FakeAnc3128	FakeDesc3128	SIMULPF00001	71	72	81	62	10	9
3129	FW_pair3129	FakeAnc3129	FakeDesc3129	SIMULPF00001	238	238	254	222	16	16
3130	FW_pair3130	FakeAnc3130	FakeDesc3130	SIMULPF00001	172	160	183	149	11	23
3131	FW_pair3131	FakeAnc3131	FakeDesc3131	SIMULPF00001	170	168	182	156	12	14
3132	FW_pair3132	FakeAnc3132	FakeDesc3132	SIMULPF00001	96	87	103	80	7	16
3133	FW_pair3133	FakeAnc3133	FakeDesc3133	SIMULPF00001	54	57	61	50	7	4
3134	FW_pair3134	FakeAnc3134	FakeDesc3134	SIMULPF00001	84	88	92	80	8	4
3135	FW_pair3135	FakeAnc3135	FakeDesc3135	SIMULPF00001	186	191	206	171	20	15
3136	FW_pair3136	FakeAnc3136	FakeDesc3136	SIMULPF00001	217	202	236	183	19	34
3137	FW_pair3137	FakeAnc3137	FakeDesc3137	SIMULPF00001	194	199	217	176	23	18
3138	FW_pair3138	FakeAnc3138	FakeDesc3138	SIMULPF00001	74	74	80	68	6	6
3139	FW_pair3139	FakeAnc3139	FakeDesc3139	SIMULPF00001	221	217	241	197	20	24
3140	FW_pair3140	FakeAnc3140	FakeDesc3140	SIMULPF00001	475	471	516	430	41	45
3141	FW_pair3141	FakeAnc3141	FakeDesc3141	SIMULPF00001	43	43	46	40	3	3
3142	FW_pair3142	FakeAnc3142	FakeDesc3142	SIMULPF00001	176	173	191	158	15	18
3143	FW_pair3143	FakeAnc3143	FakeDesc3143	SIMULPF00001	153	152	167	138	14	15
3144	FW_pair3144	FakeAnc3144	FakeDesc3144	SIMULPF00001	351	351	390	312	39	39
3145	FW_pair3145	FakeAnc3145	FakeDesc3145	SIMULPF00001	320	331	353	298	33	22
3146	FW_pair3146	FakeAnc3146	FakeDesc3146	SIMULPF00001	65	65	70	60	5	5
3147	FW_pair3147	FakeAnc3147	FakeDesc3147	SIMULPF00001	261	267	286	242	25	19
3148	FW_pair3148	FakeAnc3148	FakeDesc3148	SIMULPF00001	296	305	330	271	34	25
3149	FW_pair3149	FakeAnc3149	FakeDesc3149	SIMULPF00001	165	163	179	149	14	16
3150	FW_pair3150	FakeAnc3150	FakeDesc3150	SIMULPF00001	10	10	10	10	0	0
3151	FW_pair3151	FakeAnc3151	FakeDesc3151	SIMULPF00001	256	261	283	234	27	22
3152	FW_pair3152	FakeAnc3152	FakeDesc3152	SIMULPF00001	254	249	279	224	25	30
3153	FW_pair3153	FakeAnc3153	FakeDesc3153	SIMULPF00001	822	813	897	738	75	84
3154	FW_pair3154	FakeAnc3154	FakeDesc3154	SIMULPF00001	28	27	30	25	2	3
3155	FW_pair3155	FakeAnc3155	FakeDesc3155	SIMULPF00001	201	208	221	188	20	13
3156	FW_pair3156	FakeAnc3156	FakeDesc3156	SIMULPF00001	113	106	121	98	8	15
3157	FW_pair3157	FakeAnc3157	FakeDesc3157	SIMULPF00001	315	337	358	294	43	21
3158	FW_pair3158	FakeAnc3158	FakeDesc3158	SIMULPF00001	91	99	103	87	12	4
3159	FW_pair3159	FakeAnc3159	FakeDesc3159	SIMULPF00001	98	104	114	88	16	10
3160	FW_pair3160	FakeAnc3160	FakeDesc3160	SIMULPF00001	30	32	32	30	2	0
3161	FW_pair3161	FakeAnc3161	FakeDesc3161	SIMULPF00001	33	34	39	28	6	5
3162	FW_pair3162	FakeAnc3162	FakeDesc3162	SIMULPF00001	170	180	191	159	21	11
3163	FW_pair3163	FakeAnc3163	FakeDesc3163	SIMULPF00001	104	97	112	89	8	15
3164	FW_pair3164	FakeAnc3164	FakeDesc3164	SIMULPF00001	65	68	75	58	10	7
3165	FW_pair3165	FakeAnc3165	FakeDesc3165	SIMULPF00001	44	43	48	39	4	5
3166	FW_pair3166	FakeAnc3166	FakeDesc3166	SIMULPF00001	303	301	336	268	33	35
3167	FW_pair3167	FakeAnc3167	FakeDesc3167	SIMULPF00001	152	150	160	142	8	10
3168	FW_pair3168	FakeAnc3168	FakeDesc3168	SIMULPF00001	520	528	570	478	50	42
3169	FW_pair3169	FakeAnc3169	FakeDesc3169	SIMULPF00001	333	318	359	292	26	41
3170	FW_pair3170	FakeAnc3170	FakeDesc3170	SIMULPF00001	116	127	129	114	13	2
3171	FW_pair3171	FakeAnc3171	FakeDesc3171	SIMULPF00001	293	290	311	272	18	21
3172	FW_pair3172	FakeAnc3172	FakeDesc3172	SIMULPF00001	328	322	352	298	24	30
3173	FW_pair3173	FakeAnc3173	FakeDesc3173	SIMULPF00001	348	357	385	320	37	28
3174	FW_pair3174	FakeAnc3174	FakeDesc3174	SIMULPF00001	453	485	520	418	67	35
3175	FW_pair3175	FakeAnc3175	FakeDesc3175	SIMULPF00001	264	265	284	245	20	19
3176	FW_pair3176	FakeAnc3176	FakeDesc3176	SIMULPF00001	177	182	196	163	19	14
3177	FW_pair3177	FakeAnc3177	FakeDesc3177	SIMULPF00001	118	115	124	109	6	9
3178	FW_pair3178	FakeAnc3178	FakeDesc3178	SIMULPF00001	237	237	257	217	20	20
3179	FW_pair3179	FakeAnc3179	FakeDesc3179	SIMULPF00001	230	229	251	208	21	22
3180	FW_pair3180	FakeAnc3180	FakeDesc3180	SIMULPF00001	751	747	817	681	66	70
3181	FW_pair3181	FakeAnc3181	FakeDesc3181	SIMULPF00001	96	88	99	85	3	11
3182	FW_pair3182	FakeAnc3182	FakeDesc3182	SIMULPF00001	511	510	548	473	37	38
3183	FW_pair3183	FakeAnc3183	FakeDesc3183	SIMULPF00001	288	276	310	254	22	34
3184	FW_pair3184	FakeAnc3184	FakeDesc3184	SIMULPF00001	90	101	106	85	16	5
3185	FW_pair3185	FakeAnc3185	FakeDesc3185	SIMULPF00001	7	7	7	7	0	0
3186	FW_pair3186	FakeAnc3186	FakeDesc3186	SIMULPF00001	667	676	732	611	65	56
3187	FW_pair3187	FakeAnc3187	FakeDesc3187	SIMULPF00001	80	83	89	74	9	6
3188	FW_pair3188	FakeAnc3188	FakeDesc3188	SIMULPF00001	321	315	344	292	23	29
3189	FW_pair3189	FakeAnc3189	FakeDesc3189	SIMULPF00001	21	17	22	16	1	5
3190	FW_pair3190	FakeAnc3190	FakeDesc3190	SIMULPF00001	157	151	172	136	15	21
3191	FW_pair3191	FakeAnc3191	FakeDesc3191	SIMULPF00001	350	338	382	306	32	44
3192	FW_pair3192	FakeAnc3192	FakeDesc3192	SIMULPF00001	443	429	482	390	39	53
3193	FW_pair3193	FakeAnc3193	FakeDesc3193	SIMULPF00001	386	382	424	344	38	42
3194	FW_pair3194	FakeAnc3194	FakeDesc3194	SIMULPF00001	49	52	55	46	6	3
3195	FW_pair3195	FakeAnc3195	FakeDesc3195	SIMULPF00001	193	198	221	170	28	23
3196	FW_pair3196	FakeAnc3196	FakeDesc3196	SIMULPF00001	481	470	516	435	35	46
3197	FW_pair3197	FakeAnc3197	FakeDesc3197	SIMULPF00001	57	55	58	54	1	3
3198	FW_pair3198	FakeAnc3198	FakeDesc3198	SIMULPF00001	264	265	292	237	28	27
3199	FW_pair3199	FakeAnc3199	FakeDesc3199	SIMULPF00001	141	151	165	127	24	14
3200	FW_pair3200	FakeAnc3200	FakeDesc3200	SIMULPF00001	101	108	118	91	17	10
3201	FW_pair3201	FakeAnc3201	FakeDesc3201	SIMULPF00001	78	76	90	64	12	14
3202	FW_pair3202	FakeAnc3202	FakeDesc3202	SIMULPF00001	292	291	316	267	24	25
3203	FW_pair3203	FakeAnc3203	FakeDesc3203	SIMULPF00001	64	69	69	64	5	0
3204	FW_pair3204	FakeAnc3204	FakeDesc3204	SIMULPF00001	70	71	75	66	5	4
3205	FW_pair3205	FakeAnc3205	FakeDesc3205	SIMULPF00001	56	59	65	50	9	6
3206	FW_pair3206	FakeAnc3206	FakeDesc3206	SIMULPF00001	57	54	61	50	4	7
3207	FW_pair3207	FakeAnc3207	FakeDesc3207	SIMULPF00001	321	301	345	277	24	44
3208	FW_pair3208	FakeAnc3208	FakeDesc3208	SIMULPF00001	477	475	520	432	43	45
3209	FW_pair3209	FakeAnc3209	FakeDesc3209	SIMULPF00001	89	86	98	77	9	12
3210	FW_pair3210	FakeAnc3210	FakeDesc3210	SIMULPF00001	84	96	97	83	13	1
3211	FW_pair3211	FakeAnc3211	FakeDesc3211	SIMULPF00001	207	203	222	188	15	19
3212	FW_pair3212	FakeAnc3212	FakeDesc3212	SIMULPF00001	242	242	267	217	25	25
3213	FW_pair3213	FakeAnc3213	FakeDesc3213	SIMULPF00001	486	478	524	440	38	46
3214	FW_pair3214	FakeAnc3214	FakeDesc3214	SIMULPF00001	309	316	348	277	39	32
3215	FW_pair3215	FakeAnc3215	FakeDesc3215	SIMULPF00001	70	64	73	61	3	9
3216	FW_pair3216	FakeAnc3216	FakeDesc3216	SIMULPF00001	33	33	37	29	4	4
3217	FW_pair3217	FakeAnc3217	FakeDesc3217	SIMULPF00001	117	119	127	109	10	8
3218	FW_pair3218	FakeAnc3218	FakeDesc3218	SIMULPF00001	94	98	105	87	11	7
3219	FW_pair3219	FakeAnc3219	FakeDesc3219	SIMULPF00001	254	242	268	228	14	26
3220	FW_pair3220	FakeAnc3220	FakeDesc3220	SIMULPF00001	77	80	88	69	11	8
3221	FW_pair3221	FakeAnc3221	FakeDesc3221	SIMULPF00001	50	57	57	50	7	0
3222	FW_pair3222	FakeAnc3222	FakeDesc3222	SIMULPF00001	417	412	460	369	43	48
3223	FW_pair3223	FakeAnc3223	FakeDesc3223	SIMULPF00001	287	293	313	267	26	20
3224	FW_pair3224	FakeAnc3224	FakeDesc3224	SIMULPF00001	630	630	691	569	61	61
3225	FW_pair3225	FakeAnc3225	FakeDesc3225	SIMULPF00001	132	133	144	121	12	11
3226	FW_pair3226	FakeAnc3226	FakeDesc3226	SIMULPF00001	299	276	319	256	20	43
3227	FW_pair3227	FakeAnc3227	FakeDesc3227	SIMULPF00001	31	32	32	31	1	0
3228	FW_pair3228	FakeAnc3228	FakeDesc3228	SIMULPF00001	645	651	711	585	66	60
3229	FW_pair3229	FakeAnc3229	FakeDesc3229	SIMULPF00001	200	202	221	181	21	19
3230	FW_pair3230	FakeAnc3230	FakeDesc3230	SIMULPF00001	83	86	92	77	9	6
3231	FW_pair3231	FakeAnc3231	FakeDesc3231	SIMULPF00001	141	145	157	129	16	12
3232	FW_pair3232	FakeAnc3232	FakeDesc3232	SIMULPF00001	115	107	124	98	9	17
3233	FW_pair3233	FakeAnc3233	FakeDesc3233	SIMULPF00001	34	32	35	31	1	3
3234	FW_pair3234	FakeAnc3234	FakeDesc3234	SIMULPF00001	232	242	260	214	28	18
3235	FW_pair3235	FakeAnc3235	FakeDesc3235	SIMULPF00001	90	91	102	79	12	11
3236	FW_pair3236	FakeAnc3236	FakeDesc3236	SIMULPF00001	54	55	58	51	4	3
3237	FW_pair3237	FakeAnc3237	FakeDesc3237	SIMULPF00001	201	198	215	184	14	17
3238	FW_pair3238	FakeAnc3238	FakeDesc3238	SIMULPF00001	270	271	289	252	19	18
3239	FW_pair3239	FakeAnc3239	FakeDesc3239	SIMULPF00001	62	62	70	54	8	8
3240	FW_pair3240	FakeAnc3240	FakeDesc3240	SIMULPF00001	295	304	327	272	32	23
3241	FW_pair3241	FakeAnc3241	FakeDesc3241	SIMULPF00001	292	287	313	266	21	26
3242	FW_pair3242	FakeAnc3242	FakeDesc3242	SIMULPF00001	52	53	58	47	6	5
3243	FW_pair3243	FakeAnc3243	FakeDesc3243	SIMULPF00001	375	365	401	339	26	36
3244	FW_pair3244	FakeAnc3244	FakeDesc3244	SIMULPF00001	127	128	136	119	9	8
3245	FW_pair3245	FakeAnc3245	FakeDesc3245	SIMULPF00001	419	403	438	384	19	35
3246	FW_pair3246	FakeAnc3246	FakeDesc3246	SIMULPF00001	317	315	351	281	34	36
3247	FW_pair3247	FakeAnc3247	FakeDesc3247	SIMULPF00001	2	1	2	1	0	1
3248	FW_pair3248	FakeAnc3248	FakeDesc3248	SIMULPF00001	132	133	144	121	12	11
3249	FW_pair3249	FakeAnc3249	FakeDesc3249	SIMULPF00001	363	368	400	331	37	32
3250	FW_pair3250	FakeAnc3250	FakeDesc3250	SIMULPF00001	360	381	405	336	45	24
3251	FW_pair3251	FakeAnc3251	FakeDesc3251	SIMULPF00001	96	95	107	84	11	12
3252	FW_pair3252	FakeAnc3252	FakeDesc3252	SIMULPF00001	70	62	71	61	1	9
3253	FW_pair3253	FakeAnc3253	FakeDesc3253	SIMULPF00001	156	153	172	137	16	19
3254	FW_pair3254	FakeAnc3254	FakeDesc3254	SIMULPF00001	69	71	74	66	5	3
3255	FW_pair3255	FakeAnc3255	FakeDesc3255	SIMULPF00001	60	55	66	49	6	11
3256	FW_pair3256	FakeAnc3256	FakeDesc3256	SIMULPF00001	647	623	700	570	53	77
3257	FW_pair3257	FakeAnc3257	FakeDesc3257	SIMULPF00001	199	197	213	183	14	16
3258	FW_pair3258	FakeAnc3258	FakeDesc3258	SIMULPF00001	188	184	198	174	10	14
3259	FW_pair3259	FakeAnc3259	FakeDesc3259	SIMULPF00001	101	113	116	98	15	3
3260	FW_pair3260	FakeAnc3260	FakeDesc3260	SIMULPF00001	148	148	162	134	14	14
3261	FW_pair3261	FakeAnc3261	FakeDesc3261	SIMULPF00001	222	225	243	204	21	18
3262	FW_pair3262	FakeAnc3262	FakeDesc3262	SIMULPF00001	265	267	289	243	24	22
3263	FW_pair3263	FakeAnc3263	FakeDesc3263	SIMULPF00001	313	302	342	273	29	40
3264	FW_pair3264	FakeAnc3264	FakeDesc3264	SIMULPF00001	505	522	560	467	55	38
3265	FW_pair3265	FakeAnc3265	FakeDesc3265	SIMULPF00001	277	262	293	246	16	31
3266	FW_pair3266	FakeAnc3266	FakeDesc3266	SIMULPF00001	109	108	118	99	9	10
3267	FW_pair3267	FakeAnc3267	FakeDesc3267	SIMULPF00001	207	213	231	189	24	18
3268	FW_pair3268	FakeAnc3268	FakeDesc3268	SIMULPF00001	35	36	39	32	4	3
3269	FW_pair3269	FakeAnc3269	FakeDesc3269	SIMULPF00001	33	32	34	31	1	2
3270	FW_pair3270	FakeAnc3270	FakeDesc3270	SIMULPF00001	642	681	728	595	86	47
3271	FW_pair3271	FakeAnc3271	FakeDesc3271	SIMULPF00001	277	285	311	251	34	26
3272	FW_pair3272	FakeAnc3272	FakeDesc3272	SIMULPF00001	18	20	20	18	2	0
3273	FW_pair3273	FakeAnc3273	FakeDesc3273	SIMULPF00001	376	373	414	335	38	41
3274	FW_pair3274	FakeAnc3274	FakeDesc3274	SIMULPF00001	244	256	275	225	31	19
3275	FW_pair3275	FakeAnc3275	FakeDesc3275	SIMULPF00001	345	352	381	316	36	29
3276	FW_pair3276	FakeAnc3276	FakeDesc3276	SIMULPF00001	160	149	169	140	9	20
3277	FW_pair3277	FakeAnc3277	FakeDesc3277	SIMULPF00001	411	421	447	385	36	26
3278	FW_pair3278	FakeAnc3278	FakeDesc3278	SIMULPF00001	156	161	172	145	16	11
3279	FW_pair3279	FakeAnc3279	FakeDesc3279	SIMULPF00001	214	211	232	193	18	21
3280	FW_pair3280	FakeAnc3280	FakeDesc3280	SIMULPF00001	76	83	87	72	11	4
3281	FW_pair3281	FakeAnc3281	FakeDesc3281	SIMULPF00001	347	323	363	307	16	40
3282	FW_pair3282	FakeAnc3282	FakeDesc3282	SIMULPF00001	207	207	225	189	18	18
3283	FW_pair3283	FakeAnc3283	FakeDesc3283	SIMULPF00001	406	409	446	369	40	37
3284	FW_pair3284	FakeAnc3284	FakeDesc3284	SIMULPF00001	139	134	144	129	5	10
3285	FW_pair3285	FakeAnc3285	FakeDesc3285	SIMULPF00001	29	33	35	27	6	2
3286	FW_pair3286	FakeAnc3286	FakeDesc3286	SIMULPF00001	128	122	138	112	10	16
3287	FW_pair3287	FakeAnc3287	FakeDesc3287	SIMULPF00001	96	99	107	88	11	8
3288	FW_pair3288	FakeAnc3288	FakeDesc3288	SIMULPF00001	66	62	69	59	3	7
3289	FW_pair3289	FakeAnc3289	FakeDesc3289	SIMULPF00001	568	578	623	523	55	45
3290	FW_pair3290	FakeAnc3290	FakeDesc3290	SIMULPF00001	691	669	760	600	69	91
3291	FW_pair3291	FakeAnc3291	FakeDesc3291	SIMULPF00001	61	68	69	60	8	1
3292	FW_pair3292	FakeAnc3292	FakeDesc3292	SIMULPF00001	60	61	63	58	3	2
3293	FW_pair3293	FakeAnc3293	FakeDesc3293	SIMULPF00001	763	760	835	688	72	75
3294	FW_pair3294	FakeAnc3294	FakeDesc3294	SIMULPF00001	337	339	372	304	35	33
3295	FW_pair3295	FakeAnc3295	FakeDesc3295	SIMULPF00001	274	283	303	254	29	20
3296	FW_pair3296	FakeAnc3296	FakeDesc3296	SIMULPF00001	296	304	334	266	38	30
3297	FW_pair3297	FakeAnc3297	FakeDesc3297	SIMULPF00001	267	265	286	246	19	21
3298	FW_pair3298	FakeAnc3298	FakeDesc3298	SIMULPF00001	156	156	171	141	15	15
3299	FW_pair3299	FakeAnc3299	FakeDesc3299	SIMULPF00001	164	158	177	145	13	19
3300	FW_pair3300	FakeAnc3300	FakeDesc3300	SIMULPF00001	121	121	137	105	16	16
3301	FW_pair3301	FakeAnc3301	FakeDesc3301	SIMULPF00001	687	679	756	610	69	77
3302	FW_pair3302	FakeAnc3302	FakeDesc3302	SIMULPF00001	552	544	604	492	52	60
3303	FW_pair3303	FakeAnc3303	FakeDesc3303	SIMULPF00001	31	35	36	30	5	1
3304	FW_pair3304	FakeAnc3304	FakeDesc3304	SIMULPF00001	162	156	175	143	13	19
3305	FW_pair3305	FakeAnc3305	FakeDesc3305	SIMULPF00001	498	510	551	457	53	41
3306	FW_pair3306	FakeAnc3306	FakeDesc3306	SIMULPF00001	535	534	582	487	47	48
3307	FW_pair3307	FakeAnc3307	FakeDesc3307	SIMULPF00001	405	407	444	368	39	37
3308	FW_pair3308	FakeAnc3308	FakeDesc3308	SIMULPF00001	56	60	64	52	8	4
3309	FW_pair3309	FakeAnc3309	FakeDesc3309	SIMULPF00001	369	367	411	325	42	44
3310	FW_pair3310	FakeAnc3310	FakeDesc3310	SIMULPF00001	361	350	388	323	27	38
3311	FW_pair3311	FakeAnc3311	FakeDesc3311	SIMULPF00001	233	224	255	202	22	31
3312	FW_pair3312	FakeAnc3312	FakeDesc3312	SIMULPF00001	237	238	252	223	15	14
3313	FW_pair3313	FakeAnc3313	FakeDesc3313	SIMULPF00001	11	12	13	10	2	1
3314	FW_pair3314	FakeAnc3314	FakeDesc3314	SIMULPF00001	157	149	166	140	9	17
3315	FW_pair3315	FakeAnc3315	FakeDesc3315	SIMULPF00001	142	140	154	128	12	14
3316	FW_pair3316	FakeAnc3316	FakeDesc3316	SIMULPF00001	155	157	170	142	15	13
3317	FW_pair3317	FakeAnc3317	FakeDesc3317	SIMULPF00001	91	93	101	83	10	8
3318	FW_pair3318	FakeAnc3318	FakeDesc3318	SIMULPF00001	294	289	316	267	22	27
3319	FW_pair3319	FakeAnc3319	FakeDesc3319	SIMULPF00001	283	283	309	257	26	26
3320	FW_pair3320	FakeAnc3320	FakeDesc3320	SIMULPF00001	477	465	514	428	37	49
3321	FW_pair3321	FakeAnc3321	FakeDesc3321	SIMULPF00001	480	494	531	443	51	37
3322	FW_pair3322	FakeAnc3322	FakeDesc3322	SIMULPF00001	435	438	491	382	56	53
3323	FW_pair3323	FakeAnc3323	FakeDesc3323	SIMULPF00001	154	151	162	143	8	11
3324	FW_pair3324	FakeAnc3324	FakeDesc3324	SIMULPF00001	115	125	135	105	20	10
3325	FW_pair3325	FakeAnc3325	FakeDesc3325	SIMULPF00001	166	165	181	150	15	16
3326	FW_pair3326	FakeAnc3326	FakeDesc3326	SIMULPF00001	852	834	914	772	62	80
3327	FW_pair3327	FakeAnc3327	FakeDesc3327	SIMULPF00001	493	484	527	450	34	43
3328	FW_pair3328	FakeAnc3328	FakeDesc3328	SIMULPF00001	41	42	43	40	2	1
3329	FW_pair3329	FakeAnc3329	FakeDesc3329	SIMULPF00001	66	62	69	59	3	7
3330	FW_pair3330	FakeAnc3330	FakeDesc3330	SIMULPF00001	485	511	545	451	60	34
3331	FW_pair3331	FakeAnc3331	FakeDesc3331	SIMULPF00001	136	135	153	118	17	18
3332	FW_pair3332	FakeAnc3332	FakeDesc3332	SIMULPF00001	120	123	132	111	12	9
3333	FW_pair3333	FakeAnc3333	FakeDesc3333	SIMULPF00001	141	142	153	130	12	11
3334	FW_pair3334	FakeAnc3334	FakeDesc3334	SIMULPF00001	36	36	38	34	2	2
3335	FW_pair3335	FakeAnc3335	FakeDesc3335	SIMULPF00001	157	155	173	139	16	18
3336	FW_pair3336	FakeAnc3336	FakeDesc3336	SIMULPF00001	108	100	116	92	8	16
3337	FW_pair3337	FakeAnc3337	FakeDesc3337	SIMULPF00001	112	114	126	100	14	12
3338	FW_pair3338	FakeAnc3338	FakeDesc3338	SIMULPF00001	59	64	71	52	12	7
3339	FW_pair3339	FakeAnc3339	FakeDesc3339	SIMULPF00001	534	527	583	478	49	56
3340	FW_pair3340	FakeAnc3340	FakeDesc3340	SIMULPF00001	40	46	48	38	8	2
3341	FW_pair3341	FakeAnc3341	FakeDesc3341	SIMULPF00001	219	221	239	201	20	18
3342	FW_pair3342	FakeAnc3342	FakeDesc3342	SIMULPF00001	605	604	659	550	54	55
3343	FW_pair3343	FakeAnc3343	FakeDesc3343	SIMULPF00001	366	358	394	330	28	36
3344	FW_pair3344	FakeAnc3344	FakeDesc3344	SIMULPF00001	110	115	119	106	9	4
3345	FW_pair3345	FakeAnc3345	FakeDesc3345	SIMULPF00001	44	41	46	39	2	5
3346	FW_pair3346	FakeAnc3346	FakeDesc3346	SIMULPF00001	109	121	126	104	17	5
3347	FW_pair3347	FakeAnc3347	FakeDesc3347	SIMULPF00001	533	543	593	483	60	50
3348	FW_pair3348	FakeAnc3348	FakeDesc3348	SIMULPF00001	24	21	27	18	3	6
3349	FW_pair3349	FakeAnc3349	FakeDesc3349	SIMULPF00001	144	156	164	136	20	8
3350	FW_pair3350	FakeAnc3350	FakeDesc3350	SIMULPF00001	434	424	467	391	33	43
3351	FW_pair3351	FakeAnc3351	FakeDesc3351	SIMULPF00001	253	263	281	235	28	18
3352	FW_pair3352	FakeAnc3352	FakeDesc3352	SIMULPF00001	567	581	630	518	63	49
3353	FW_pair3353	FakeAnc3353	FakeDesc3353	SIMULPF00001	40	47	50	37	10	3
3354	FW_pair3354	FakeAnc3354	FakeDesc3354	SIMULPF00001	58	57	65	50	7	8
3355	FW_pair3355	FakeAnc3355	FakeDesc3355	SIMULPF00001	301	304	329	276	28	25
3356	FW_pair3356	FakeAnc3356	FakeDesc3356	SIMULPF00001	85	93	98	80	13	5
3357	FW_pair3357	FakeAnc3357	FakeDesc3357	SIMULPF00001	241	243	270	214	29	27
3358	FW_pair3358	FakeAnc3358	FakeDesc3358	SIMULPF00001	309	310	343	276	34	33
3359	FW_pair3359	FakeAnc3359	FakeDesc3359	SIMULPF00001	98	92	105	85	7	13
3360	FW_pair3360	FakeAnc3360	FakeDesc3360	SIMULPF00001	264	270	296	238	32	26
3361	FW_pair3361	FakeAnc3361	FakeDesc3361	SIMULPF00001	18	17	18	17	0	1
3362	FW_pair3362	FakeAnc3362	FakeDesc3362	SIMULPF00001	422	428	459	391	37	31
3363	FW_pair3363	FakeAnc3363	FakeDesc3363	SIMULPF00001	241	243	265	219	24	22
3364	FW_pair3364	FakeAnc3364	FakeDesc3364	SIMULPF00001	433	440	477	396	44	37
3365	FW_pair3365	FakeAnc3365	FakeDesc3365	SIMULPF00001	93	98	102	89	9	4
3366	FW_pair3366	FakeAnc3366	FakeDesc3366	SIMULPF00001	832	840	911	761	79	71
3367	FW_pair3367	FakeAnc3367	FakeDesc3367	SIMULPF00001	197	192	210	179	13	18
3368	FW_pair3368	FakeAnc3368	FakeDesc3368	SIMULPF00001	28	22	29	21	1	7
3369	FW_pair3369	FakeAnc3369	FakeDesc3369	SIMULPF00001	267	248	285	230	18	37
3370	FW_pair3370	FakeAnc3370	FakeDesc3370	SIMULPF00001	278	259	296	241	18	37
3371	FW_pair3371	FakeAnc3371	FakeDesc3371	SIMULPF00001	11	14	14	11	3	0
3372	FW_pair3372	FakeAnc3372	FakeDesc3372	SIMULPF00001	38	34	38	34	0	4
3373	FW_pair3373	FakeAnc3373	FakeDesc3373	SIMULPF00001	80	74	82	72	2	8
3374	FW_pair3374	FakeAnc3374	FakeDesc3374	SIMULPF00001	51	51	57	45	6	6
3375	FW_pair3375	FakeAnc3375	FakeDesc3375	SIMULPF00001	709	695	780	624	71	85
3376	FW_pair3376	FakeAnc3376	FakeDesc3376	SIMULPF00001	149	157	166	140	17	9
3377	FW_pair3377	FakeAnc3377	FakeDesc3377	SIMULPF00001	91	92	98	85	7	6
3378	FW_pair3378	FakeAnc3378	FakeDesc3378	SIMULPF00001	209	189	225	173	16	36
3379	FW_pair3379	FakeAnc3379	FakeDesc3379	SIMULPF00001	529	537	582	484	53	45
3380	FW_pair3380	FakeAnc3380	FakeDesc3380	SIMULPF00001	286	290	315	261	29	25
3381	FW_pair3381	FakeAnc3381	FakeDesc3381	SIMULPF00001	26	31	33	24	7	2
3382	FW_pair3382	FakeAnc3382	FakeDesc3382	SIMULPF00001	17	16	18	15	1	2
3383	FW_pair3383	FakeAnc3383	FakeDesc3383	SIMULPF00001	419	412	465	366	46	53
3384	FW_pair3384	FakeAnc3384	FakeDesc3384	SIMULPF00001	41	41	47	35	6	6
3385	FW_pair3385	FakeAnc3385	FakeDesc3385	SIMULPF00001	513	518	562	469	49	44
3386	FW_pair3386	FakeAnc3386	FakeDesc3386	SIMULPF00001	261	260	285	236	24	25
3387	FW_pair3387	FakeAnc3387	FakeDesc3387	SIMULPF00001	352	348	381	319	29	33
3388	FW_pair3388	FakeAnc3388	FakeDesc3388	SIMULPF00001	159	158	175	142	16	17
3389	FW_pair3389	FakeAnc3389	FakeDesc3389	SIMULPF00001	37	39	43	33	6	4
3390	FW_pair3390	FakeAnc3390	FakeDesc3390	SIMULPF00001	150	145	163	132	13	18
3391	FW_pair3391	FakeAnc3391	FakeDesc3391	SIMULPF00001	442	428	476	394	34	48
3392	FW_pair3392	FakeAnc3392	FakeDesc3392	SIMULPF00001	219	227	246	200	27	19
3393	FW_pair3393	FakeAnc3393	FakeDesc3393	SIMULPF00001	163	165	177	151	14	12
3394	FW_pair3394	FakeAnc3394	FakeDesc3394	SIMULPF00001	134	142	157	119	23	15
3395	FW_pair3395	FakeAnc3395	FakeDesc3395	SIMULPF00001	240	232	261	211	21	29
3396	FW_pair3396	FakeAnc3396	FakeDesc3396	SIMULPF00001	320	332	354	298	34	22
3397	FW_pair3397	FakeAnc3397	FakeDesc3397	SIMULPF00001	96	101	113	84	17	12
3398	FW_pair3398	FakeAnc3398	FakeDesc3398	SIMULPF00001	896	888	972	812	76	84
3399	FW_pair3399	FakeAnc3399	FakeDesc3399	SIMULPF00001	280	276	299	257	19	23
3400	FW_pair3400	FakeAnc3400	FakeDesc3400	SIMULPF00001	52	49	54	47	2	5
3401	FW_pair3401	FakeAnc3401	FakeDesc3401	SIMULPF00001	11	10	11	10	0	1
3402	FW_pair3402	FakeAnc3402	FakeDesc3402	SIMULPF00001	322	322	349	295	27	27
3403	FW_pair3403	FakeAnc3403	FakeDesc3403	SIMULPF00001	8	6	8	6	0	2
3404	FW_pair3404	FakeAnc3404	FakeDesc3404	SIMULPF00001	252	239	274	217	22	35
3405	FW_pair3405	FakeAnc3405	FakeDesc3405	SIMULPF00001	212	204	225	191	13	21
3406	FW_pair3406	FakeAnc3406	FakeDesc3406	SIMULPF00001	96	90	97	89	1	7
3407	FW_pair3407	FakeAnc3407	FakeDesc3407	SIMULPF00001	375	376	407	344	32	31
3408	FW_pair3408	FakeAnc3408	FakeDesc3408	SIMULPF00001	449	461	496	414	47	35
3409	FW_pair3409	FakeAnc3409	FakeDesc3409	SIMULPF00001	773	776	833	716	60	57
3410	FW_pair3410	FakeAnc3410	FakeDesc3410	SIMULPF00001	78	78	83	73	5	5
3411	FW_pair3411	FakeAnc3411	FakeDesc3411	SIMULPF00001	122	113	125	110	3	12
3412	FW_pair3412	FakeAnc3412	FakeDesc3412	SIMULPF00001	196	195	215	176	19	20
3413	FW_pair3413	FakeAnc3413	FakeDesc3413	SIMULPF00001	438	449	471	416	33	22
3414	FW_pair3414	FakeAnc3414	FakeDesc3414	SIMULPF00001	43	44	46	41	3	2
3415	FW_pair3415	FakeAnc3415	FakeDesc3415	SIMULPF00001	85	82	93	74	8	11
3416	FW_pair3416	FakeAnc3416	FakeDesc3416	SIMULPF00001	144	156	165	135	21	9
3417	FW_pair3417	FakeAnc3417	FakeDesc3417	SIMULPF00001	202	198	221	179	19	23
3418	FW_pair3418	FakeAnc3418	FakeDesc3418	SIMULPF00001	501	505	542	464	41	37
3419	FW_pair3419	FakeAnc3419	FakeDesc3419	SIMULPF00001	58	68	71	55	13	3
3420	FW_pair3420	FakeAnc3420	FakeDesc3420	SIMULPF00001	71	70	75	66	4	5
3421	FW_pair3421	FakeAnc3421	FakeDesc3421	SIMULPF00001	501	515	553	463	52	38
3422	FW_pair3422	FakeAnc3422	FakeDesc3422	SIMULPF00001	95	91	100	86	5	9
3423	FW_pair3423	FakeAnc3423	FakeDesc3423	SIMULPF00001	476	473	507	442	31	34
3424	FW_pair3424	FakeAnc3424	FakeDesc3424	SIMULPF00001	86	89	92	83	6	3
3425	FW_pair3425	FakeAnc3425	FakeDesc3425	SIMULPF00001	5	5	6	4	1	1
3426	FW_pair3426	FakeAnc3426	FakeDesc3426	SIMULPF00001	101	99	105	95	4	6
3427	FW_pair3427	FakeAnc3427	FakeDesc3427	SIMULPF00001	221	227	248	200	27	21
3428	FW_pair3428	FakeAnc3428	FakeDesc3428	SIMULPF00001	38	36	40	34	2	4
3429	FW_pair3429	FakeAnc3429	FakeDesc3429	SIMULPF00001	5	4	5	4	0	1
3430	FW_pair3430	FakeAnc3430	FakeDesc3430	SIMULPF00001	110	115	124	101	14	9
3431	FW_pair3431	FakeAnc3431	FakeDesc3431	SIMULPF00001	35	31	36	30	1	5
3432	FW_pair3432	FakeAnc3432	FakeDesc3432	SIMULPF00001	194	188	215	167	21	27
3433	FW_pair3433	FakeAnc3433	FakeDesc3433	SIMULPF00001	212	214	234	192	22	20
3434	FW_pair3434	FakeAnc3434	FakeDesc3434	SIMULPF00001	160	153	166	147	6	13
3435	FW_pair3435	FakeAnc3435	FakeDesc3435	SIMULPF00001	146	150	160	136	14	10
3436	FW_pair3436	FakeAnc3436	FakeDesc3436	SIMULPF00001	271	266	288	249	17	22
3437	FW_pair3437	FakeAnc3437	FakeDesc3437	SIMULPF00001	95	96	103	88	8	7
3438	FW_pair3438	FakeAnc3438	FakeDesc3438	SIMULPF00001	36	33	36	33	0	3
3439	FW_pair3439	FakeAnc3439	FakeDesc3439	SIMULPF00001	597	599	661	535	64	62
3440	FW_pair3440	FakeAnc3440	FakeDesc3440	SIMULPF00001	16	19	19	16	3	0
3441	FW_pair3441	FakeAnc3441	FakeDesc3441	SIMULPF00001	136	130	142	124	6	12
3442	FW_pair3442	FakeAnc3442	FakeDesc3442	SIMULPF00001	170	156	183	143	13	27
3443	FW_pair3443	FakeAnc3443	FakeDesc3443	SIMULPF00001	294	300	325	269	31	25
3444	FW_pair3444	FakeAnc3444	FakeDesc3444	SIMULPF00001	206	201	221	186	15	20
3445	FW_pair3445	FakeAnc3445	FakeDesc3445	SIMULPF00001	359	347	383	323	24	36
3446	FW_pair3446	FakeAnc3446	FakeDesc3446	SIMULPF00001	46	48	50	44	4	2
3447	FW_pair3447	FakeAnc3447	FakeDesc3447	SIMULPF00001	677	666	741	602	64	75
3448	FW_pair3448	FakeAnc3448	FakeDesc3448	SIMULPF00001	335	331	372	294	37	41
3449	FW_pair3449	FakeAnc3449	FakeDesc3449	SIMULPF00001	73	69	77	65	4	8
3450	FW_pair3450	FakeAnc3450	FakeDesc3450	SIMULPF00001	486	479	532	433	46	53
3451	FW_pair3451	FakeAnc3451	FakeDesc3451	SIMULPF00001	260	259	292	227	32	33
3452	FW_pair3452	FakeAnc3452	FakeDesc3452	SIMULPF00001	158	170	177	151	19	7
3453	FW_pair3453	FakeAnc3453	FakeDesc3453	SIMULPF00001	12	12	12	12	0	0
3454	FW_pair3454	FakeAnc3454	FakeDesc3454	SIMULPF00001	125	121	138	108	13	17
3455	FW_pair3455	FakeAnc3455	FakeDesc3455	SIMULPF00001	252	241	284	209	32	43
3456	FW_pair3456	FakeAnc3456	FakeDesc3456	SIMULPF00001	23	23	24	22	1	1
3457	FW_pair3457	FakeAnc3457	FakeDesc3457	SIMULPF00001	87	93	102	78	15	9
3458	FW_pair3458	FakeAnc3458	FakeDesc3458	SIMULPF00001	614	617	674	557	60	57
3459	FW_pair3459	FakeAnc3459	FakeDesc3459	SIMULPF00001	110	108	116	102	6	8
3460	FW_pair3460	FakeAnc3460	FakeDesc3460	SIMULPF00001	420	425	459	386	39	34
3461	FW_pair3461	FakeAnc3461	FakeDesc3461	SIMULPF00001	121	119	132	108	11	13
3462	FW_pair3462	FakeAnc3462	FakeDesc3462	SIMULPF00001	193	204	222	175	29	18
3463	FW_pair3463	FakeAnc3463	FakeDesc3463	SIMULPF00001	39	38	40	37	1	2
3464	FW_pair3464	FakeAnc3464	FakeDesc3464	SIMULPF00001	586	590	644	532	58	54
3465	FW_pair3465	FakeAnc3465	FakeDesc3465	SIMULPF00001	217	210	233	194	16	23
3466	FW_pair3466	FakeAnc3466	FakeDesc3466	SIMULPF00001	186	186	198	174	12	12
3467	FW_pair3467	FakeAnc3467	FakeDesc3467	SIMULPF00001	305	314	335	284	30	21
3468	FW_pair3468	FakeAnc3468	FakeDesc3468	SIMULPF00001	254	263	286	231	32	23
3469	FW_pair3469	FakeAnc3469	FakeDesc3469	SIMULPF00001	154	165	176	143	22	11
3470	FW_pair3470	FakeAnc3470	FakeDesc3470	SIMULPF00001	87	95	99	83	12	4
3471	FW_pair3471	FakeAnc3471	FakeDesc3471	SIMULPF00001	457	445	497	405	40	52
3472	FW_pair3472	FakeAnc3472	FakeDesc3472	SIMULPF00001	51	49	57	43	6	8
3473	FW_pair3473	FakeAnc3473	FakeDesc3473	SIMULPF00001	169	158	178	149	9	20
3474	FW_pair3474	FakeAnc3474	FakeDesc3474	SIMULPF00001	653	654	713	594	60	59
3475	FW_pair3475	FakeAnc3475	FakeDesc3475	SIMULPF00001	141	138	148	131	7	10
3476	FW_pair3476	FakeAnc3476	FakeDesc3476	SIMULPF00001	73	77	81	69	8	4
3477	FW_pair3477	FakeAnc3477	FakeDesc3477	SIMULPF00001	815	816	888	743	73	72
3478	FW_pair3478	FakeAnc3478	FakeDesc3478	SIMULPF00001	350	355	386	319	36	31
3479	FW_pair3479	FakeAnc3479	FakeDesc3479	SIMULPF00001	82	83	95	70	13	12
3480	FW_pair3480	FakeAnc3480	FakeDesc3480	SIMULPF00001	214	214	237	191	23	23
3481	FW_pair3481	FakeAnc3481	FakeDesc3481	SIMULPF00001	78	78	83	73	5	5
3482	FW_pair3482	FakeAnc3482	FakeDesc3482	SIMULPF00001	232	216	246	202	14	30
3483	FW_pair3483	FakeAnc3483	FakeDesc3483	SIMULPF00001	45	46	46	45	1	0
3484	FW_pair3484	FakeAnc3484	FakeDesc3484	SIMULPF00001	434	434	464	404	30	30
3485	FW_pair3485	FakeAnc3485	FakeDesc3485	SIMULPF00001	58	57	65	50	7	8
3486	FW_pair3486	FakeAnc3486	FakeDesc3486	SIMULPF00001	473	480	514	439	41	34
3487	FW_pair3487	FakeAnc3487	FakeDesc3487	SIMULPF00001	213	204	227	190	14	23
3488	FW_pair3488	FakeAnc3488	FakeDesc3488	SIMULPF00001	31	29	31	29	0	2
3489	FW_pair3489	FakeAnc3489	FakeDesc3489	SIMULPF00001	228	224	251	201	23	27
3490	FW_pair3490	FakeAnc3490	FakeDesc3490	SIMULPF00001	206	205	228	183	22	23
3491	FW_pair3491	FakeAnc3491	FakeDesc3491	SIMULPF00001	29	32	34	27	5	2
3492	FW_pair3492	FakeAnc3492	FakeDesc3492	SIMULPF00001	791	779	863	707	72	84
3493	FW_pair3493	FakeAnc3493	FakeDesc3493	SIMULPF00001	80	71	81	70	1	10
3494	FW_pair3494	FakeAnc3494	FakeDesc3494	SIMULPF00001	29	31	31	29	2	0
3495	FW_pair3495	FakeAnc3495	FakeDesc3495	SIMULPF00001	25	24	30	19	5	6
3496	FW_pair3496	FakeAnc3496	FakeDesc3496	SIMULPF00001	76	75	85	66	9	10
3497	FW_pair3497	FakeAnc3497	FakeDesc3497	SIMULPF00001	633	648	697	584	64	49
3498	FW_pair3498	FakeAnc3498	FakeDesc3498	SIMULPF00001	113	112	126	99	13	14
3499	FW_pair3499	FakeAnc3499	FakeDesc3499	SIMULPF00001	173	164	181	156	8	17
3500	FW_pair3500	FakeAnc3500	FakeDesc3500	SIMULPF00001	173	164	187	150	14	23
3501	FW_pair3501	FakeAnc3501	FakeDesc3501	SIMULPF00001	32	32	35	29	3	3
3502	FW_pair3502	FakeAnc3502	FakeDesc3502	SIMULPF00001	5	5	5	5	0	0
3503	FW_pair3503	FakeAnc3503	FakeDesc3503	SIMULPF00001	133	137	147	123	14	10
3504	FW_pair3504	FakeAnc3504	FakeDesc3504	SIMULPF00001	77	75	82	70	5	7
3505	FW_pair3505	FakeAnc3505	FakeDesc3505	SIMULPF00001	408	409	448	369	40	39
3506	FW_pair3506	FakeAnc3506	FakeDesc3506	SIMULPF00001	145	140	151	134	6	11
3507	FW_pair3507	FakeAnc3507	FakeDesc3507	SIMULPF00001	285	290	307	268	22	17
3508	FW_pair3508	FakeAnc3508	FakeDesc3508	SIMULPF00001	181	176	196	161	15	20
3509	FW_pair3509	FakeAnc3509	FakeDesc3509	SIMULPF00001	212	208	230	190	18	22
3510	FW_pair3510	FakeAnc3510	FakeDesc3510	SIMULPF00001	517	517	553	481	36	36
3511	FW_pair3511	FakeAnc3511	FakeDesc3511	SIMULPF00001	460	475	521	414	61	46
3512	FW_pair3512	FakeAnc3512	FakeDesc3512	SIMULPF00001	22	24	24	22	2	0
3513	FW_pair3513	FakeAnc3513	FakeDesc3513	SIMULPF00001	358	381	402	337	44	21
3514	FW_pair3514	FakeAnc3514	FakeDesc3514	SIMULPF00001	233	227	255	205	22	28
3515	FW_pair3515	FakeAnc3515	FakeDesc3515	SIMULPF00001	65	65	74	56	9	9
3516	FW_pair3516	FakeAnc3516	FakeDesc3516	SIMULPF00001	7	7	7	7	0	0
3517	FW_pair3517	FakeAnc3517	FakeDesc3517	SIMULPF00001	55	57	60	52	5	3
3518	FW_pair3518	FakeAnc3518	FakeDesc3518	SIMULPF00001	70	64	71	63	1	7
3519	FW_pair3519	FakeAnc3519	FakeDesc3519	SIMULPF00001	884	891	975	800	91	84
3520	FW_pair3520	FakeAnc3520	FakeDesc3520	SIMULPF00001	156	151	171	136	15	20
3521	FW_pair3521	FakeAnc3521	FakeDesc3521	SIMULPF00001	123	107	131	99	8	24
3522	FW_pair3522	FakeAnc3522	FakeDesc3522	SIMULPF00001	8	8	10	6	2	2
3523	FW_pair3523	FakeAnc3523	FakeDesc3523	SIMULPF00001	444	449	484	409	40	35
3524	FW_pair3524	FakeAnc3524	FakeDesc3524	SIMULPF00001	135	138	149	124	14	11
3525	FW_pair3525	FakeAnc3525	FakeDesc3525	SIMULPF00001	25	27	28	24	3	1
3526	FW_pair3526	FakeAnc3526	FakeDesc3526	SIMULPF00001	111	109	121	99	10	12
3527	FW_pair3527	FakeAnc3527	FakeDesc3527	SIMULPF00001	170	187	196	161	26	9
3528	FW_pair3528	FakeAnc3528	FakeDesc3528	SIMULPF00001	63	67	70	60	7	3
3529	FW_pair3529	FakeAnc3529	FakeDesc3529	SIMULPF00001	264	260	285	239	21	25
3530	FW_pair3530	FakeAnc3530	FakeDesc3530	SIMULPF00001	701	683	746	638	45	63
3531	FW_pair3531	FakeAnc3531	FakeDesc3531	SIMULPF00001	138	133	149	122	11	16
3532	FW_pair3532	FakeAnc3532	FakeDesc3532	SIMULPF00001	1	1	1	1	0	0
3533	FW_pair3533	FakeAnc3533	FakeDesc3533	SIMULPF00001	42	43	44	41	2	1
3534	FW_pair3534	FakeAnc3534	FakeDesc3534	SIMULPF00001	225	219	243	201	18	24
3535	FW_pair3535	FakeAnc3535	FakeDesc3535	SIMULPF00001	239	248	265	222	26	17
3536	FW_pair3536	FakeAnc3536	FakeDesc3536	SIMULPF00001	444	435	484	395	40	49
3537	FW_pair3537	FakeAnc3537	FakeDesc3537	SIMULPF00001	802	780	873	709	71	93
3538	FW_pair3538	FakeAnc3538	FakeDesc3538	SIMULPF00001	160	149	169	140	9	20
3539	FW_pair3539	FakeAnc3539	FakeDesc3539	SIMULPF00001	166	164	179	151	13	15
3540	FW_pair3540	FakeAnc3540	FakeDesc3540	SIMULPF00001	9	10	11	8	2	1
3541	FW_pair3541	FakeAnc3541	FakeDesc3541	SIMULPF00001	654	650	720	584	66	70
3542	FW_pair3542	FakeAnc3542	FakeDesc3542	SIMULPF00001	559	550	605	504	46	55
3543	FW_pair3543	FakeAnc3543	FakeDesc3543	SIMULPF00001	45	43	48	40	3	5
3544	FW_pair3544	FakeAnc3544	FakeDesc3544	SIMULPF00001	35	34	40	29	5	6
3545	FW_pair3545	FakeAnc3545	FakeDesc3545	SIMULPF00001	162	162	171	153	9	9
3546	FW_pair3546	FakeAnc3546	FakeDesc3546	SIMULPF00001	152	145	164	133	12	19
3547	FW_pair3547	FakeAnc3547	FakeDesc3547	SIMULPF00001	694	682	760	616	66	78
3548	FW_pair3548	FakeAnc3548	FakeDesc3548	SIMULPF00001	363	351	402	312	39	51
3549	FW_pair3549	FakeAnc3549	FakeDesc3549	SIMULPF00001	24	27	27	24	3	0
3550	FW_pair3550	FakeAnc3550	FakeDesc3550	SIMULPF00001	623	633	702	554	79	69
3551	FW_pair3551	FakeAnc3551	FakeDesc3551	SIMULPF00001	293	279	311	261	18	32
3552	FW_pair3552	FakeAnc3552	FakeDesc3552	SIMULPF00001	211	213	224	200	13	11
3553	FW_pair3553	FakeAnc3553	FakeDesc3553	SIMULPF00001	538	534	590	482	52	56
3554	FW_pair3554	FakeAnc3554	FakeDesc3554	SIMULPF00001	151	162	172	141	21	10
3555	FW_pair3555	FakeAnc3555	FakeDesc3555	SIMULPF00001	81	78	90	69	9	12
3556	FW_pair3556	FakeAnc3556	FakeDesc3556	SIMULPF00001	31	30	33	28	2	3
3557	FW_pair3557	FakeAnc3557	FakeDesc3557	SIMULPF00001	229	232	250	211	21	18
3558	FW_pair3558	FakeAnc3558	FakeDesc3558	SIMULPF00001	126	135	146	115	20	11
3559	FW_pair3559	FakeAnc3559	FakeDesc3559	SIMULPF00001	100	106	110	96	10	4
3560	FW_pair3560	FakeAnc3560	FakeDesc3560	SIMULPF00001	254	242	273	223	19	31
3561	FW_pair3561	FakeAnc3561	FakeDesc3561	SIMULPF00001	406	422	455	373	49	33
3562	FW_pair3562	FakeAnc3562	FakeDesc3562	SIMULPF00001	47	42	47	42	0	5
3563	FW_pair3563	FakeAnc3563	FakeDesc3563	SIMULPF00001	129	144	155	118	26	11
3564	FW_pair3564	FakeAnc3564	FakeDesc3564	SIMULPF00001	29	23	29	23	0	6
3565	FW_pair3565	FakeAnc3565	FakeDesc3565	SIMULPF00001	72	81	85	68	13	4
3566	FW_pair3566	FakeAnc3566	FakeDesc3566	SIMULPF00001	127	124	137	114	10	13
3567	FW_pair3567	FakeAnc3567	FakeDesc3567	SIMULPF00001	392	398	430	360	38	32
3568	FW_pair3568	FakeAnc3568	FakeDesc3568	SIMULPF00001	437	452	482	407	45	30
3569	FW_pair3569	FakeAnc3569	FakeDesc3569	SIMULPF00001	796	807	875	728	79	68
3570	FW_pair3570	FakeAnc3570	FakeDesc3570	SIMULPF00001	12	12	13	11	1	1
3571	FW_pair3571	FakeAnc3571	FakeDesc3571	SIMULPF00001	527	518	570	475	43	52
3572	FW_pair3572	FakeAnc3572	FakeDesc3572	SIMULPF00001	341	362	382	321	41	20
3573	FW_pair3573	FakeAnc3573	FakeDesc3573	SIMULPF00001	95	94	104	85	9	10
3574	FW_pair3574	FakeAnc3574	FakeDesc3574	SIMULPF00001	204	204	221	187	17	17
3575	FW_pair3575	FakeAnc3575	FakeDesc3575	SIMULPF00001	119	116	133	102	14	17
3576	FW_pair3576	FakeAnc3576	FakeDesc3576	SIMULPF00001	24	27	28	23	4	1
3577	FW_pair3577	FakeAnc3577	FakeDesc3577	SIMULPF00001	93	94	103	84	10	9
3578	FW_pair3578	FakeAnc3578	FakeDesc3578	SIMULPF00001	43	49	53	39	10	4
3579	FW_pair3579	FakeAnc3579	FakeDesc3579	SIMULPF00001	187	187	203	171	16	16
3580	FW_pair3580	FakeAnc3580	FakeDesc3580	SIMULPF00001	102	99	108	93	6	9
3581	FW_pair3581	FakeAnc3581	FakeDesc3581	SIMULPF00001	290	284	315	259	25	31
3582	FW_pair3582	FakeAnc3582	FakeDesc3582	SIMULPF00001	17	20	20	17	3	0
3583	FW_pair3583	FakeAnc3583	FakeDesc3583	SIMULPF00001	63	60	65	58	2	5
3584	FW_pair3584	FakeAnc3584	FakeDesc3584	SIMULPF00001	61	56	65	52	4	9
3585	FW_pair3585	FakeAnc3585	FakeDesc3585	SIMULPF00001	135	136	149	122	14	13
3586	FW_pair3586	FakeAnc3586	FakeDesc3586	SIMULPF00001	562	560	614	508	52	54
3587	FW_pair3587	FakeAnc3587	FakeDesc3587	SIMULPF00001	47	52	54	45	7	2
3588	FW_pair3588	FakeAnc3588	FakeDesc3588	SIMULPF00001	104	103	110	97	6	7
3589	FW_pair3589	FakeAnc3589	FakeDesc3589	SIMULPF00001	206	201	226	181	20	25
3590	FW_pair3590	FakeAnc3590	FakeDesc3590	SIMULPF00001	90	91	101	80	11	10
3591	FW_pair3591	FakeAnc3591	FakeDesc3591	SIMULPF00001	292	294	317	269	25	23
3592	FW_pair3592	FakeAnc3592	FakeDesc3592	SIMULPF00001	357	358	391	324	34	33
3593	FW_pair3593	FakeAnc3593	FakeDesc3593	SIMULPF00001	96	97	111	82	15	14
3594	FW_pair3594	FakeAnc3594	FakeDesc3594	SIMULPF00001	692	675	753	614	61	78
3595	FW_pair3595	FakeAnc3595	FakeDesc3595	SIMULPF00001	38	39	40	37	2	1
3596	FW_pair3596	FakeAnc3596	FakeDesc3596	SIMULPF00001	42	39	43	38	1	4
3597	FW_pair3597	FakeAnc3597	FakeDesc3597	SIMULPF00001	373	375	412	336	39	37
3598	FW_pair3598	FakeAnc3598	FakeDesc3598	SIMULPF00001	133	138	148	123	15	10
3599	FW_pair3599	FakeAnc3599	FakeDesc3599	SIMULPF00001	108	115	123	100	15	8
3600	FW_pair3600	FakeAnc3600	FakeDesc3600	SIMULPF00001	319	316	349	286	30	33
3601	FW_pair3601	FakeAnc3601	FakeDesc3601	SIMULPF00001	587	586	638	535	51	52
3602	FW_pair3602	FakeAnc3602	FakeDesc3602	SIMULPF00001	591	588	653	526	62	65
3603	FW_pair3603	FakeAnc3603	FakeDesc3603	SIMULPF00001	27	30	30	27	3	0
3604	FW_pair3604	FakeAnc3604	FakeDesc3604	SIMULPF00001	88	90	94	84	6	4
3605	FW_pair3605	FakeAnc3605	FakeDesc3605	SIMULPF00001	388	382	423	347	35	41
3606	FW_pair3606	FakeAnc3606	FakeDesc3606	SIMULPF00001	26	29	31	24	5	2
3607	FW_pair3607	FakeAnc3607	FakeDesc3607	SIMULPF00001	22	23	24	21	2	1
3608	FW_pair3608	FakeAnc3608	FakeDesc3608	SIMULPF00001	390	414	447	357	57	33
3609	FW_pair3609	FakeAnc3609	FakeDesc3609	SIMULPF00001	23	22	24	21	1	2
3610	FW_pair3610	FakeAnc3610	FakeDesc3610	SIMULPF00001	165	161	182	144	17	21
3611	FW_pair3611	FakeAnc3611	FakeDesc3611	SIMULPF00001	397	407	433	371	36	26
3612	FW_pair3612	FakeAnc3612	FakeDesc3612	SIMULPF00001	85	88	92	81	7	4
3613	FW_pair3613	FakeAnc3613	FakeDesc3613	SIMULPF00001	462	483	523	422	61	40
3614	FW_pair3614	FakeAnc3614	FakeDesc3614	SIMULPF00001	85	81	93	73	8	12
3615	FW_pair3615	FakeAnc3615	FakeDesc3615	SIMULPF00001	20	17	20	17	0	3
3616	FW_pair3616	FakeAnc3616	FakeDesc3616	SIMULPF00001	28	30	32	26	4	2
3617	FW_pair3617	FakeAnc3617	FakeDesc3617	SIMULPF00001	157	159	170	146	13	11
3618	FW_pair3618	FakeAnc3618	FakeDesc3618	SIMULPF00001	30	28	32	26	2	4
3619	FW_pair3619	FakeAnc3619	FakeDesc3619	SIMULPF00001	59	58	63	54	4	5
3620	FW_pair3620	FakeAnc3620	FakeDesc3620	SIMULPF00001	14	13	15	12	1	2
3621	FW_pair3621	FakeAnc3621	FakeDesc3621	SIMULPF00001	238	231	260	209	22	29
3622	FW_pair3622	FakeAnc3622	FakeDesc3622	SIMULPF00001	421	429	465	385	44	36
3623	FW_pair3623	FakeAnc3623	FakeDesc3623	SIMULPF00001	328	340	367	301	39	27
3624	FW_pair3624	FakeAnc3624	FakeDesc3624	SIMULPF00001	133	137	151	119	18	14
3625	FW_pair3625	FakeAnc3625	FakeDesc3625	SIMULPF00001	460	453	502	411	42	49
3626	FW_pair3626	FakeAnc3626	FakeDesc3626	SIMULPF00001	57	59	65	51	8	6
3627	FW_pair3627	FakeAnc3627	FakeDesc3627	SIMULPF00001	79	85	89	75	10	4
3628	FW_pair3628	FakeAnc3628	FakeDesc3628	SIMULPF00001	219	205	226	198	7	21
3629	FW_pair3629	FakeAnc3629	FakeDesc3629	SIMULPF00001	262	262	287	237	25	25
3630	FW_pair3630	FakeAnc3630	FakeDesc3630	SIMULPF00001	871	846	945	772	74	99
3631	FW_pair3631	FakeAnc3631	FakeDesc3631	SIMULPF00001	472	473	514	431	42	41
3632	FW_pair3632	FakeAnc3632	FakeDesc3632	SIMULPF00001	326	345	371	300	45	26
3633	FW_pair3633	FakeAnc3633	FakeDesc3633	SIMULPF00001	207	216	228	195	21	12
3634	FW_pair3634	FakeAnc3634	FakeDesc3634	SIMULPF00001	397	383	422	358	25	39
3635	FW_pair3635	FakeAnc3635	FakeDesc3635	SIMULPF00001	377	347	408	316	31	61
3636	FW_pair3636	FakeAnc3636	FakeDesc3636	SIMULPF00001	645	648	708	585	63	60
3637	FW_pair3637	FakeAnc3637	FakeDesc3637	SIMULPF00001	527	548	597	478	70	49
3638	FW_pair3638	FakeAnc3638	FakeDesc3638	SIMULPF00001	346	348	385	309	39	37
3639	FW_pair3639	FakeAnc3639	FakeDesc3639	SIMULPF00001	291	281	311	261	20	30
3640	FW_pair3640	FakeAnc3640	FakeDesc3640	SIMULPF00001	177	169	187	159	10	18
3641	FW_pair3641	FakeAnc3641	FakeDesc3641	SIMULPF00001	55	51	57	49	2	6
3642	FW_pair3642	FakeAnc3642	FakeDesc3642	SIMULPF00001	259	254	286	227	27	32
3643	FW_pair3643	FakeAnc3643	FakeDesc3643	SIMULPF00001	37	35	39	33	2	4
3644	FW_pair3644	FakeAnc3644	FakeDesc3644	SIMULPF00001	732	749	823	658	91	74
3645	FW_pair3645	FakeAnc3645	FakeDesc3645	SIMULPF00001	179	170	196	153	17	26
3646	FW_pair3646	FakeAnc3646	FakeDesc3646	SIMULPF00001	275	278	302	251	27	24
3647	FW_pair3647	FakeAnc3647	FakeDesc3647	SIMULPF00001	131	138	150	119	19	12
3648	FW_pair3648	FakeAnc3648	FakeDesc3648	SIMULPF00001	80	82	87	75	7	5
3649	FW_pair3649	FakeAnc3649	FakeDesc3649	SIMULPF00001	496	468	528	436	32	60
3650	FW_pair3650	FakeAnc3650	FakeDesc3650	SIMULPF00001	235	231	253	213	18	22
3651	FW_pair3651	FakeAnc3651	FakeDesc3651	SIMULPF00001	205	207	228	184	23	21
3652	FW_pair3652	FakeAnc3652	FakeDesc3652	SIMULPF00001	64	64	71	57	7	7
3653	FW_pair3653	FakeAnc3653	FakeDesc3653	SIMULPF00001	199	211	225	185	26	14
3654	FW_pair3654	FakeAnc3654	FakeDesc3654	SIMULPF00001	31	35	37	29	6	2
3655	FW_pair3655	FakeAnc3655	FakeDesc3655	SIMULPF00001	43	44	47	40	4	3
3656	FW_pair3656	FakeAnc3656	FakeDesc3656	SIMULPF00001	346	344	378	312	32	34
3657	FW_pair3657	FakeAnc3657	FakeDesc3657	SIMULPF00001	439	424	479	384	40	55
3658	FW_pair3658	FakeAnc3658	FakeDesc3658	SIMULPF00001	428	442	475	395	47	33
3659	FW_pair3659	FakeAnc3659	FakeDesc3659	SIMULPF00001	409	426	456	379	47	30
3660	FW_pair3660	FakeAnc3660	FakeDesc3660	SIMULPF00001	225	228	243	210	18	15
3661	FW_pair3661	FakeAnc3661	FakeDesc3661	SIMULPF00001	288	281	318	251	30	37
3662	FW_pair3662	FakeAnc3662	FakeDesc3662	SIMULPF00001	86	84	93	77	7	9
3663	FW_pair3663	FakeAnc3663	FakeDesc3663	SIMULPF00001	4	4	4	4	0	0
3664	FW_pair3664	FakeAnc3664	FakeDesc3664	SIMULPF00001	342	356	388	310	46	32
3665	FW_pair3665	FakeAnc3665	FakeDesc3665	SIMULPF00001	62	61	70	53	8	9
3666	FW_pair3666	FakeAnc3666	FakeDesc3666	SIMULPF00001	37	37	41	33	4	4
3667	FW_pair3667	FakeAnc3667	FakeDesc3667	SIMULPF00001	141	137	148	130	7	11
3668	FW_pair3668	FakeAnc3668	FakeDesc3668	SIMULPF00001	17	19	20	16	3	1
3669	FW_pair3669	FakeAnc3669	FakeDesc3669	SIMULPF00001	193	190	205	178	12	15
3670	FW_pair3670	FakeAnc3670	FakeDesc3670	SIMULPF00001	137	133	150	120	13	17
3671	FW_pair3671	FakeAnc3671	FakeDesc3671	SIMULPF00001	64	64	69	59	5	5
3672	FW_pair3672	FakeAnc3672	FakeDesc3672	SIMULPF00001	25	24	26	23	1	2
3673	FW_pair3673	FakeAnc3673	FakeDesc3673	SIMULPF00001	119	121	137	103	18	16
3674	FW_pair3674	FakeAnc3674	FakeDesc3674	SIMULPF00001	357	373	413	317	56	40
3675	FW_pair3675	FakeAnc3675	FakeDesc3675	SIMULPF00001	40	36	41	35	1	5
3676	FW_pair3676	FakeAnc3676	FakeDesc3676	SIMULPF00001	8	8	8	8	0	0
3677	FW_pair3677	FakeAnc3677	FakeDesc3677	SIMULPF00001	85	92	94	83	9	2
3678	FW_pair3678	FakeAnc3678	FakeDesc3678	SIMULPF00001	175	169	186	158	11	17
3679	FW_pair3679	FakeAnc3679	FakeDesc3679	SIMULPF00001	89	97	103	83	14	6
3680	FW_pair3680	FakeAnc3680	FakeDesc3680	SIMULPF00001	35	34	40	29	5	6
3681	FW_pair3681	FakeAnc3681	FakeDesc3681	SIMULPF00001	252	236	269	219	17	33
3682	FW_pair3682	FakeAnc3682	FakeDesc3682	SIMULPF00001	94	93	100	87	6	7
3683	FW_pair3683	FakeAnc3683	FakeDesc3683	SIMULPF00001	187	183	203	167	16	20
3684	FW_pair3684	FakeAnc3684	FakeDesc3684	SIMULPF00001	440	426	483	383	43	57
3685	FW_pair3685	FakeAnc3685	FakeDesc3685	SIMULPF00001	79	74	84	69	5	10
3686	FW_pair3686	FakeAnc3686	FakeDesc3686	SIMULPF00001	5	6	6	5	1	0
3687	FW_pair3687	FakeAnc3687	FakeDesc3687	SIMULPF00001	711	688	773	626	62	85
3688	FW_pair3688	FakeAnc3688	FakeDesc3688	SIMULPF00001	406	411	441	376	35	30
3689	FW_pair3689	FakeAnc3689	FakeDesc3689	SIMULPF00001	161	156	176	141	15	20
3690	FW_pair3690	FakeAnc3690	FakeDesc3690	SIMULPF00001	851	829	929	751	78	100
3691	FW_pair3691	FakeAnc3691	FakeDesc3691	SIMULPF00001	83	83	87	79	4	4
3692	FW_pair3692	FakeAnc3692	FakeDesc3692	SIMULPF00001	87	80	92	75	5	12
3693	FW_pair3693	FakeAnc3693	FakeDesc3693	SIMULPF00001	205	196	220	181	15	24
3694	FW_pair3694	FakeAnc3694	FakeDesc3694	SIMULPF00001	33	35	38	30	5	3
3695	FW_pair3695	FakeAnc3695	FakeDesc3695	SIMULPF00001	97	97	106	88	9	9
3696	FW_pair3696	FakeAnc3696	FakeDesc3696	SIMULPF00001	57	68	72	53	15	4
3697	FW_pair3697	FakeAnc3697	FakeDesc3697	SIMULPF00001	339	331	368	302	29	37
3698	FW_pair3698	FakeAnc3698	FakeDesc3698	SIMULPF00001	218	218	242	194	24	24
3699	FW_pair3699	FakeAnc3699	FakeDesc3699	SIMULPF00001	63	58	64	57	1	6
3700	FW_pair3700	FakeAnc3700	FakeDesc3700	SIMULPF00001	298	301	331	268	33	30
3701	FW_pair3701	FakeAnc3701	FakeDesc3701	SIMULPF00001	4	7	7	4	3	0
3702	FW_pair3702	FakeAnc3702	FakeDesc3702	SIMULPF00001	202	200	217	185	15	17
3703	FW_pair3703	FakeAnc3703	FakeDesc3703	SIMULPF00001	706	682	772	616	66	90
3704	FW_pair3704	FakeAnc3704	FakeDesc3704	SIMULPF00001	13	16	16	13	3	0
3705	FW_pair3705	FakeAnc3705	FakeDesc3705	SIMULPF00001	172	167	181	158	9	14
3706	FW_pair3706	FakeAnc3706	FakeDesc3706	SIMULPF00001	28	32	33	27	5	1
3707	FW_pair3707	FakeAnc3707	FakeDesc3707	SIMULPF00001	32	32	33	31	1	1
3708	FW_pair3708	FakeAnc3708	FakeDesc3708	SIMULPF00001	68	65	70	63	2	5
3709	FW_pair3709	FakeAnc3709	FakeDesc3709	SIMULPF00001	326	319	354	291	28	35
3710	FW_pair3710	FakeAnc3710	FakeDesc3710	SIMULPF00001	198	197	215	180	17	18
3711	FW_pair3711	FakeAnc3711	FakeDesc3711	SIMULPF00001	86	99	105	80	19	6
3712	FW_pair3712	FakeAnc3712	FakeDesc3712	SIMULPF00001	350	347	382	315	32	35
3713	FW_pair3713	FakeAnc3713	FakeDesc3713	SIMULPF00001	786	774	840	720	54	66
3714	FW_pair3714	FakeAnc3714	FakeDesc3714	SIMULPF00001	326	310	347	289	21	37
3715	FW_pair3715	FakeAnc3715	FakeDesc3715	SIMULPF00001	494	487	534	447	40	47
3716	FW_pair3716	FakeAnc3716	FakeDesc3716	SIMULPF00001	155	162	171	146	16	9
3717	FW_pair3717	FakeAnc3717	FakeDesc3717	SIMULPF00001	43	45	51	37	8	6
3718	FW_pair3718	FakeAnc3718	FakeDesc3718	SIMULPF00001	84	84	93	75	9	9
3719	FW_pair3719	FakeAnc3719	FakeDesc3719	SIMULPF00001	20	21	22	19	2	1
3720	FW_pair3720	FakeAnc3720	FakeDesc3720	SIMULPF00001	151	145	163	133	12	18
3721	FW_pair3721	FakeAnc3721	FakeDesc3721	SIMULPF00001	241	241	264	218	23	23
3722	FW_pair3722	FakeAnc3722	FakeDesc3722	SIMULPF00001	47	48	52	43	5	4
3723	FW_pair3723	FakeAnc3723	FakeDesc3723	SIMULPF00001	259	243	280	222	21	37
3724	FW_pair3724	FakeAnc3724	FakeDesc3724	SIMULPF00001	367	365	404	328	37	39
3725	FW_pair3725	FakeAnc3725	FakeDesc3725	SIMULPF00001	126	128	144	110	18	16
3726	FW_pair3726	FakeAnc3726	FakeDesc3726	SIMULPF00001	622	617	669	570	47	52
3727	FW_pair3727	FakeAnc3727	FakeDesc3727	SIMULPF00001	251	245	272	224	21	27
3728	FW_pair3728	FakeAnc3728	FakeDesc3728	SIMULPF00001	482	498	540	440	58	42
3729	FW_pair3729	FakeAnc3729	FakeDesc3729	SIMULPF00001	287	284	317	254	30	33
3730	FW_pair3730	FakeAnc3730	FakeDesc3730	SIMULPF00001	26	28	30	24	4	2
3731	FW_pair3731	FakeAnc3731	FakeDesc3731	SIMULPF00001	446	468	511	403	65	43
3732	FW_pair3732	FakeAnc3732	FakeDesc3732	SIMULPF00001	401	414	443	372	42	29
3733	FW_pair3733	FakeAnc3733	FakeDesc3733	SIMULPF00001	38	37	40	35	2	3
3734	FW_pair3734	FakeAnc3734	FakeDesc3734	SIMULPF00001	81	87	92	76	11	5
3735	FW_pair3735	FakeAnc3735	FakeDesc3735	SIMULPF00001	325	334	362	297	37	28
3736	FW_pair3736	FakeAnc3736	FakeDesc3736	SIMULPF00001	280	300	318	262	38	18
3737	FW_pair3737	FakeAnc3737	FakeDesc3737	SIMULPF00001	94	95	105	84	11	10
3738	FW_pair3738	FakeAnc3738	FakeDesc3738	SIMULPF00001	96	95	103	88	7	8
3739	FW_pair3739	FakeAnc3739	FakeDesc3739	SIMULPF00001	522	517	566	473	44	49
3740	FW_pair3740	FakeAnc3740	FakeDesc3740	SIMULPF00001	8	7	8	7	0	1
3741	FW_pair3741	FakeAnc3741	FakeDesc3741	SIMULPF00001	308	304	326	286	18	22
3742	FW_pair3742	FakeAnc3742	FakeDesc3742	SIMULPF00001	122	130	143	109	21	13
3743	FW_pair3743	FakeAnc3743	FakeDesc3743	SIMULPF00001	199	208	220	187	21	12
3744	FW_pair3744	FakeAnc3744	FakeDesc3744	SIMULPF00001	128	128	140	116	12	12
3745	FW_pair3745	FakeAnc3745	FakeDesc3745	SIMULPF00001	77	78	83	72	6	5
3746	FW_pair3746	FakeAnc3746	FakeDesc3746	SIMULPF00001	335	344	371	308	36	27
3747	FW_pair3747	FakeAnc3747	FakeDesc3747	SIMULPF00001	167	168	184	151	17	16
3748	FW_pair3748	FakeAnc3748	FakeDesc3748	SIMULPF00001	264	269	290	243	26	21
3749	FW_pair3749	FakeAnc3749	FakeDesc3749	SIMULPF00001	92	97	101	88	9	4
3750	FW_pair3750	FakeAnc3750	FakeDesc3750	SIMULPF00001	29	31	31	29	2	0
3751	FW_pair3751	FakeAnc3751	FakeDesc3751	SIMULPF00001	150	148	163	135	13	15
3752	FW_pair3752	FakeAnc3752	FakeDesc3752	SIMULPF00001	434	437	471	400	37	34
3753	FW_pair3753	FakeAnc3753	FakeDesc3753	SIMULPF00001	301	308	333	276	32	25
3754	FW_pair3754	FakeAnc3754	FakeDesc3754	SIMULPF00001	119	112	128	103	9	16
3755	FW_pair3755	FakeAnc3755	FakeDesc3755	SIMULPF00001	407	418	450	375	43	32
3756	FW_pair3756	FakeAnc3756	FakeDesc3756	SIMULPF00001	778	781	865	694	87	84
3757	FW_pair3757	FakeAnc3757	FakeDesc3757	SIMULPF00001	235	234	253	216	18	19
3758	FW_pair3758	FakeAnc3758	FakeDesc3758	SIMULPF00001	27	24	27	24	0	3
3759	FW_pair3759	FakeAnc3759	FakeDesc3759	SIMULPF00001	480	499	538	441	58	39
3760	FW_pair3760	FakeAnc3760	FakeDesc3760	SIMULPF00001	42	43	50	35	8	7
3761	FW_pair3761	FakeAnc3761	FakeDesc3761	SIMULPF00001	114	116	129	101	15	13
3762	FW_pair3762	FakeAnc3762	FakeDesc3762	SIMULPF00001	53	55	61	47	8	6
3763	FW_pair3763	FakeAnc3763	FakeDesc3763	SIMULPF00001	53	53	57	49	4	4
3764	FW_pair3764	FakeAnc3764	FakeDesc3764	SIMULPF00001	25	24	28	21	3	4
3765	FW_pair3765	FakeAnc3765	FakeDesc3765	SIMULPF00001	351	362	385	328	34	23
3766	FW_pair3766	FakeAnc3766	FakeDesc3766	SIMULPF00001	100	101	117	84	17	16
3767	FW_pair3767	FakeAnc3767	FakeDesc3767	SIMULPF00001	47	46	49	44	2	3
3768	FW_pair3768	FakeAnc3768	FakeDesc3768	SIMULPF00001	119	112	127	104	8	15
3769	FW_pair3769	FakeAnc3769	FakeDesc3769	SIMULPF00001	39	40	45	34	6	5
3770	FW_pair3770	FakeAnc3770	FakeDesc3770	SIMULPF00001	353	355	395	313	42	40
3771	FW_pair3771	FakeAnc3771	FakeDesc3771	SIMULPF00001	159	163	180	142	21	17
3772	FW_pair3772	FakeAnc3772	FakeDesc3772	SIMULPF00001	188	180	198	170	10	18
3773	FW_pair3773	FakeAnc3773	FakeDesc3773	SIMULPF00001	32	41	41	32	9	0
3774	FW_pair3774	FakeAnc3774	FakeDesc3774	SIMULPF00001	524	548	586	486	62	38
3775	FW_pair3775	FakeAnc3775	FakeDesc3775	SIMULPF00001	663	689	742	610	79	53
3776	FW_pair3776	FakeAnc3776	FakeDesc3776	SIMULPF00001	54	49	57	46	3	8
3777	FW_pair3777	FakeAnc3777	FakeDesc3777	SIMULPF00001	175	179	186	168	11	7
3778	FW_pair3778	FakeAnc3778	FakeDesc3778	SIMULPF00001	9	12	12	9	3	0
3779	FW_pair3779	FakeAnc3779	FakeDesc3779	SIMULPF00001	11	11	11	11	0	0
3780	FW_pair3780	FakeAnc3780	FakeDesc3780	SIMULPF00001	244	233	261	216	17	28
3781	FW_pair3781	FakeAnc3781	FakeDesc3781	SIMULPF00001	107	113	122	98	15	9
3782	FW_pair3782	FakeAnc3782	FakeDesc3782	SIMULPF00001	174	172	189	157	15	17
3783	FW_pair3783	FakeAnc3783	FakeDesc3783	SIMULPF00001	94	106	113	87	19	7
3784	FW_pair3784	FakeAnc3784	FakeDesc3784	SIMULPF00001	19	21	22	18	3	1
3785	FW_pair3785	FakeAnc3785	FakeDesc3785	SIMULPF00001	17	21	21	17	4	0
3786	FW_pair3786	FakeAnc3786	FakeDesc3786	SIMULPF00001	502	509	553	458	51	44
3787	FW_pair3787	FakeAnc3787	FakeDesc3787	SIMULPF00001	591	593	649	535	58	56
3788	FW_pair3788	FakeAnc3788	FakeDesc3788	SIMULPF00001	534	519	582	471	48	63
3789	FW_pair3789	FakeAnc3789	FakeDesc3789	SIMULPF00001	145	142	157	130	12	15
3790	FW_pair3790	FakeAnc3790	FakeDesc3790	SIMULPF00001	298	289	314	273	16	25
3791	FW_pair3791	FakeAnc3791	FakeDesc3791	SIMULPF00001	313	310	338	285	25	28
3792	FW_pair3792	FakeAnc3792	FakeDesc3792	SIMULPF00001	8	9	9	8	1	0
3793	FW_pair3793	FakeAnc3793	FakeDesc3793	SIMULPF00001	22	24	25	21	3	1
3794	FW_pair3794	FakeAnc3794	FakeDesc3794	SIMULPF00001	174	182	201	155	27	19
3795	FW_pair3795	FakeAnc3795	FakeDesc3795	SIMULPF00001	125	125	136	114	11	11
3796	FW_pair3796	FakeAnc3796	FakeDesc3796	SIMULPF00001	165	183	196	152	31	13
3797	FW_pair3797	FakeAnc3797	FakeDesc3797	SIMULPF00001	695	697	764	628	69	67
3798	FW_pair3798	FakeAnc3798	FakeDesc3798	SIMULPF00001	196	201	221	176	25	20
3799	FW_pair3799	FakeAnc3799	FakeDesc3799	SIMULPF00001	121	115	128	108	7	13
3800	FW_pair3800	FakeAnc3800	FakeDesc3800	SIMULPF00001	249	253	272	230	23	19
3801	FW_pair3801	FakeAnc3801	FakeDesc3801	SIMULPF00001	42	41	45	38	3	4
3802	FW_pair3802	FakeAnc3802	FakeDesc3802	SIMULPF00001	45	45	54	36	9	9
3803	FW_pair3803	FakeAnc3803	FakeDesc3803	SIMULPF00001	337	354	387	304	50	33
3804	FW_pair3804	FakeAnc3804	FakeDesc3804	SIMULPF00001	462	457	498	421	36	41
3805	FW_pair3805	FakeAnc3805	FakeDesc3805	SIMULPF00001	592	573	649	516	57	76
3806	FW_pair3806	FakeAnc3806	FakeDesc3806	SIMULPF00001	8	9	9	8	1	0
3807	FW_pair3807	FakeAnc3807	FakeDesc3807	SIMULPF00001	148	157	170	135	22	13
3808	FW_pair3808	FakeAnc3808	FakeDesc3808	SIMULPF00001	52	52	56	48	4	4
3809	FW_pair3809	FakeAnc3809	FakeDesc3809	SIMULPF00001	34	33	34	33	0	1
3810	FW_pair3810	FakeAnc3810	FakeDesc3810	SIMULPF00001	221	222	243	200	22	21
3811	FW_pair3811	FakeAnc3811	FakeDesc3811	SIMULPF00001	45	39	47	37	2	8
3812	FW_pair3812	FakeAnc3812	FakeDesc3812	SIMULPF00001	307	300	323	284	16	23
3813	FW_pair3813	FakeAnc3813	FakeDesc3813	SIMULPF00001	185	182	197	170	12	15
3814	FW_pair3814	FakeAnc3814	FakeDesc3814	SIMULPF00001	29	31	32	28	3	1
3815	FW_pair3815	FakeAnc3815	FakeDesc3815	SIMULPF00001	172	161	181	152	9	20
3816	FW_pair3816	FakeAnc3816	FakeDesc3816	SIMULPF00001	842	821	913	750	71	92
3817	FW_pair3817	FakeAnc3817	FakeDesc3817	SIMULPF00001	269	264	294	239	25	30
3818	FW_pair3818	FakeAnc3818	FakeDesc3818	SIMULPF00001	51	43	52	42	1	9
3819	FW_pair3819	FakeAnc3819	FakeDesc3819	SIMULPF00001	350	356	388	318	38	32
3820	FW_pair3820	FakeAnc3820	FakeDesc3820	SIMULPF00001	389	403	432	360	43	29
3821	FW_pair3821	FakeAnc3821	FakeDesc3821	SIMULPF00001	574	586	633	527	59	47
3822	FW_pair3822	FakeAnc3822	FakeDesc3822	SIMULPF00001	54	55	58	51	4	3
3823	FW_pair3823	FakeAnc3823	FakeDesc3823	SIMULPF00001	180	184	204	160	24	20
3824	FW_pair3824	FakeAnc3824	FakeDesc3824	SIMULPF00001	63	56	66	53	3	10
3825	FW_pair3825	FakeAnc3825	FakeDesc3825	SIMULPF00001	77	76	82	71	5	6
3826	FW_pair3826	FakeAnc3826	FakeDesc3826	SIMULPF00001	413	409	443	379	30	34
3827	FW_pair3827	FakeAnc3827	FakeDesc3827	SIMULPF00001	25	24	25	24	0	1
3828	FW_pair3828	FakeAnc3828	FakeDesc3828	SIMULPF00001	123	124	136	111	13	12
3829	FW_pair3829	FakeAnc3829	FakeDesc3829	SIMULPF00001	30	26	31	25	1	5
3830	FW_pair3830	FakeAnc3830	FakeDesc3830	SIMULPF00001	1	3	3	1	2	0
3831	FW_pair3831	FakeAnc3831	FakeDesc3831	SIMULPF00001	79	79	86	72	7	7
3832	FW_pair3832	FakeAnc3832	FakeDesc3832	SIMULPF00001	147	159	171	135	24	12
3833	FW_pair3833	FakeAnc3833	FakeDesc3833	SIMULPF00001	209	206	224	191	15	18
3834	FW_pair3834	FakeAnc3834	FakeDesc3834	SIMULPF00001	544	544	594	494	50	50
3835	FW_pair3835	FakeAnc3835	FakeDesc3835	SIMULPF00001	357	346	376	327	19	30
3836	FW_pair3836	FakeAnc3836	FakeDesc3836	SIMULPF00001	748	744	812	680	64	68
3837	FW_pair3837	FakeAnc3837	FakeDesc3837	SIMULPF00001	44	47	51	40	7	4
3838	FW_pair3838	FakeAnc3838	FakeDesc3838	SIMULPF00001	397	395	442	350	45	47
3839	FW_pair3839	FakeAnc3839	FakeDesc3839	SIMULPF00001	442	456	497	401	55	41
3840	FW_pair3840	FakeAnc3840	FakeDesc3840	SIMULPF00001	50	49	53	46	3	4
3841	FW_pair3841	FakeAnc3841	FakeDesc3841	SIMULPF00001	128	123	142	109	14	19
3842	FW_pair3842	FakeAnc3842	FakeDesc3842	SIMULPF00001	495	504	545	454	50	41
3843	FW_pair3843	FakeAnc3843	FakeDesc3843	SIMULPF00001	87	97	104	80	17	7
3844	FW_pair3844	FakeAnc3844	FakeDesc3844	SIMULPF00001	95	89	99	85	4	10
3845	FW_pair3845	FakeAnc3845	FakeDesc3845	SIMULPF00001	78	72	84	66	6	12
3846	FW_pair3846	FakeAnc3846	FakeDesc3846	SIMULPF00001	269	276	296	249	27	20
3847	FW_pair3847	FakeAnc3847	FakeDesc3847	SIMULPF00001	136	145	157	124	21	12
3848	FW_pair3848	FakeAnc3848	FakeDesc3848	SIMULPF00001	77	80	87	70	10	7
3849	FW_pair3849	FakeAnc3849	FakeDesc3849	SIMULPF00001	128	122	136	114	8	14
3850	FW_pair3850	FakeAnc3850	FakeDesc3850	SIMULPF00001	237	224	257	204	20	33
3851	FW_pair3851	FakeAnc3851	FakeDesc3851	SIMULPF00001	96	88	98	86	2	10
3852	FW_pair3852	FakeAnc3852	FakeDesc3852	SIMULPF00001	240	231	261	210	21	30
3853	FW_pair3853	FakeAnc3853	FakeDesc3853	SIMULPF00001	114	113	123	104	9	10
3854	FW_pair3854	FakeAnc3854	FakeDesc3854	SIMULPF00001	302	294	324	272	22	30
3855	FW_pair3855	FakeAnc3855	FakeDesc3855	SIMULPF00001	24	20	26	18	2	6
3856	FW_pair3856	FakeAnc3856	FakeDesc3856	SIMULPF00001	78	80	90	68	12	10
3857	FW_pair3857	FakeAnc3857	FakeDesc3857	SIMULPF00001	16	17	18	15	2	1
3858	FW_pair3858	FakeAnc3858	FakeDesc3858	SIMULPF00001	29	29	31	27	2	2
3859	FW_pair3859	FakeAnc3859	FakeDesc3859	SIMULPF00001	90	74	91	73	1	17
3860	FW_pair3860	FakeAnc3860	FakeDesc3860	SIMULPF00001	326	331	366	291	40	35
3861	FW_pair3861	FakeAnc3861	FakeDesc3861	SIMULPF00001	487	485	536	436	49	51
3862	FW_pair3862	FakeAnc3862	FakeDesc3862	SIMULPF00001	157	159	168	148	11	9
3863	FW_pair3863	FakeAnc3863	FakeDesc3863	SIMULPF00001	417	406	456	367	39	50
3864	FW_pair3864	FakeAnc3864	FakeDesc3864	SIMULPF00001	483	487	525	445	42	38
3865	FW_pair3865	FakeAnc3865	FakeDesc3865	SIMULPF00001	58	58	62	54	4	4
3866	FW_pair3866	FakeAnc3866	FakeDesc3866	SIMULPF00001	97	86	103	80	6	17
3867	FW_pair3867	FakeAnc3867	FakeDesc3867	SIMULPF00001	396	380	419	357	23	39
3868	FW_pair3868	FakeAnc3868	FakeDesc3868	SIMULPF00001	115	109	121	103	6	12
3869	FW_pair3869	FakeAnc3869	FakeDesc3869	SIMULPF00001	888	915	979	824	91	64
3870	FW_pair3870	FakeAnc3870	FakeDesc3870	SIMULPF00001	130	131	147	114	17	16
3871	FW_pair3871	FakeAnc3871	FakeDesc3871	SIMULPF00001	21	22	24	19	3	2
3872	FW_pair3872	FakeAnc3872	FakeDesc3872	SIMULPF00001	73	85	89	69	16	4
3873	FW_pair3873	FakeAnc3873	FakeDesc3873	SIMULPF00001	9	11	11	9	2	0
3874	FW_pair3874	FakeAnc3874	FakeDesc3874	SIMULPF00001	371	362	401	332	30	39
3875	FW_pair3875	FakeAnc3875	FakeDesc3875	SIMULPF00001	321	327	354	294	33	27
3876	FW_pair3876	FakeAnc3876	FakeDesc3876	SIMULPF00001	122	121	131	112	9	10
3877	FW_pair3877	FakeAnc3877	FakeDesc3877	SIMULPF00001	617	618	676	559	59	58
3878	FW_pair3878	FakeAnc3878	FakeDesc3878	SIMULPF00001	291	307	329	269	38	22
3879	FW_pair3879	FakeAnc3879	FakeDesc3879	SIMULPF00001	225	235	251	209	26	16
3880	FW_pair3880	FakeAnc3880	FakeDesc3880	SIMULPF00001	425	430	463	392	38	33
3881	FW_pair3881	FakeAnc3881	FakeDesc3881	SIMULPF00001	125	134	143	116	18	9
3882	FW_pair3882	FakeAnc3882	FakeDesc3882	SIMULPF00001	503	487	541	449	38	54
3883	FW_pair3883	FakeAnc3883	FakeDesc3883	SIMULPF00001	842	839	919	762	77	80
3884	FW_pair3884	FakeAnc3884	FakeDesc3884	SIMULPF00001	13	10	13	10	0	3
3885	FW_pair3885	FakeAnc3885	FakeDesc3885	SIMULPF00001	240	237	259	218	19	22
3886	FW_pair3886	FakeAnc3886	FakeDesc3886	SIMULPF00001	151	141	165	127	14	24
3887	FW_pair3887	FakeAnc3887	FakeDesc3887	SIMULPF00001	99	96	108	87	9	12
3888	FW_pair3888	FakeAnc3888	FakeDesc3888	SIMULPF00001	158	162	181	139	23	19
3889	FW_pair3889	FakeAnc3889	FakeDesc3889	SIMULPF00001	367	362	407	322	40	45
3890	FW_pair3890	FakeAnc3890	FakeDesc3890	SIMULPF00001	22	22	23	21	1	1
3891	FW_pair3891	FakeAnc3891	FakeDesc3891	SIMULPF00001	3	3	3	3	0	0
3892	FW_pair3892	FakeAnc3892	FakeDesc3892	SIMULPF00001	726	737	813	650	87	76
3893	FW_pair3893	FakeAnc3893	FakeDesc3893	SIMULPF00001	155	156	169	142	14	13
3894	FW_pair3894	FakeAnc3894	FakeDesc3894	SIMULPF00001	367	359	399	327	32	40
3895	FW_pair3895	FakeAnc3895	FakeDesc3895	SIMULPF00001	149	137	156	130	7	19
3896	FW_pair3896	FakeAnc3896	FakeDesc3896	SIMULPF00001	4	4	6	2	2	2
3897	FW_pair3897	FakeAnc3897	FakeDesc3897	SIMULPF00001	20	21	21	20	1	0
3898	FW_pair3898	FakeAnc3898	FakeDesc3898	SIMULPF00001	291	291	324	258	33	33
3899	FW_pair3899	FakeAnc3899	FakeDesc3899	SIMULPF00001	487	491	532	446	45	41
3900	FW_pair3900	FakeAnc3900	FakeDesc3900	SIMULPF00001	433	437	474	396	41	37
3901	FW_pair3901	FakeAnc3901	FakeDesc3901	SIMULPF00001	336	339	371	304	35	32
3902	FW_pair3902	FakeAnc3902	FakeDesc3902	SIMULPF00001	38	38	43	33	5	5
3903	FW_pair3903	FakeAnc3903	FakeDesc3903	SIMULPF00001	216	206	230	192	14	24
3904	FW_pair3904	FakeAnc3904	FakeDesc3904	SIMULPF00001	194	195	212	177	18	17
3905	FW_pair3905	FakeAnc3905	FakeDesc3905	SIMULPF00001	49	49	57	41	8	8
3906	FW_pair3906	FakeAnc3906	FakeDesc3906	SIMULPF00001	113	120	125	108	12	5
3907	FW_pair3907	FakeAnc3907	FakeDesc3907	SIMULPF00001	727	737	802	662	75	65
3908	FW_pair3908	FakeAnc3908	FakeDesc3908	SIMULPF00001	39	44	45	38	6	1
3909	FW_pair3909	FakeAnc3909	FakeDesc3909	SIMULPF00001	401	390	428	363	27	38
3910	FW_pair3910	FakeAnc3910	FakeDesc3910	SIMULPF00001	258	264	286	236	28	22
3911	FW_pair3911	FakeAnc3911	FakeDesc3911	SIMULPF00001	115	113	125	103	10	12
3912	FW_pair3912	FakeAnc3912	FakeDesc3912	SIMULPF00001	99	101	112	88	13	11
3913	FW_pair3913	FakeAnc3913	FakeDesc3913	SIMULPF00001	85	95	102	78	17	7
3914	FW_pair3914	FakeAnc3914	FakeDesc3914	SIMULPF00001	21	19	21	19	0	2
3915	FW_pair3915	FakeAnc3915	FakeDesc3915	SIMULPF00001	315	300	345	270	30	45
3916	FW_pair3916	FakeAnc3916	FakeDesc3916	SIMULPF00001	207	215	227	195	20	12
3917	FW_pair3917	FakeAnc3917	FakeDesc3917	SIMULPF00001	662	645	722	585	60	77
3918	FW_pair3918	FakeAnc3918	FakeDesc3918	SIMULPF00001	52	54	60	46	8	6
3919	FW_pair3919	FakeAnc3919	FakeDesc3919	SIMULPF00001	47	47	52	42	5	5
3920	FW_pair3920	FakeAnc3920	FakeDesc3920	SIMULPF00001	11	8	11	8	0	3
3921	FW_pair3921	FakeAnc3921	FakeDesc3921	SIMULPF00001	62	56	66	52	4	10
3922	FW_pair3922	FakeAnc3922	FakeDesc3922	SIMULPF00001	58	56	61	53	3	5
3923	FW_pair3923	FakeAnc3923	FakeDesc3923	SIMULPF00001	352	346	389	309	37	43
3924	FW_pair3924	FakeAnc3924	FakeDesc3924	SIMULPF00001	457	475	523	409	66	48
3925	FW_pair3925	FakeAnc3925	FakeDesc3925	SIMULPF00001	6	6	6	6	0	0
3926	FW_pair3926	FakeAnc3926	FakeDesc3926	SIMULPF00001	580	578	632	526	52	54
3927	FW_pair3927	FakeAnc3927	FakeDesc3927	SIMULPF00001	347	341	366	322	19	25
3928	FW_pair3928	FakeAnc3928	FakeDesc3928	SIMULPF00001	339	343	371	311	32	28
3929	FW_pair3929	FakeAnc3929	FakeDesc3929	SIMULPF00001	536	530	584	482	48	54
3930	FW_pair3930	FakeAnc3930	FakeDesc3930	SIMULPF00001	491	491	538	444	47	47
3931	FW_pair3931	FakeAnc3931	FakeDesc3931	SIMULPF00001	190	203	213	180	23	10
3932	FW_pair3932	FakeAnc3932	FakeDesc3932	SIMULPF00001	98	102	109	91	11	7
3933	FW_pair3933	FakeAnc3933	FakeDesc3933	SIMULPF00001	41	45	49	37	8	4
3934	FW_pair3934	FakeAnc3934	FakeDesc3934	SIMULPF00001	503	532	568	467	65	36
3935	FW_pair3935	FakeAnc3935	FakeDesc3935	SIMULPF00001	613	624	671	566	58	47
3936	FW_pair3936	FakeAnc3936	FakeDesc3936	SIMULPF00001	844	861	923	782	79	62
3937	FW_pair3937	FakeAnc3937	FakeDesc3937	SIMULPF00001	251	224	262	213	11	38
3938	FW_pair3938	FakeAnc3938	FakeDesc3938	SIMULPF00001	545	570	609	506	64	39
3939	FW_pair3939	FakeAnc3939	FakeDesc3939	SIMULPF00001	47	46	52	41	5	6
3940	FW_pair3940	FakeAnc3940	FakeDesc3940	SIMULPF00001	47	46	49	44	2	3
3941	FW_pair3941	FakeAnc3941	FakeDesc3941	SIMULPF00001	424	420	469	375	45	49
3942	FW_pair3942	FakeAnc3942	FakeDesc3942	SIMULPF00001	67	69	74	62	7	5
3943	FW_pair3943	FakeAnc3943	FakeDesc3943	SIMULPF00001	365	351	387	329	22	36
3944	FW_pair3944	FakeAnc3944	FakeDesc3944	SIMULPF00001	23	23	24	22	1	1
3945	FW_pair3945	FakeAnc3945	FakeDesc3945	SIMULPF00001	290	272	315	247	25	43
3946	FW_pair3946	FakeAnc3946	FakeDesc3946	SIMULPF00001	429	428	473	384	44	45
3947	FW_pair3947	FakeAnc3947	FakeDesc3947	SIMULPF00001	341	353	383	311	42	30
3948	FW_pair3948	FakeAnc3948	FakeDesc3948	SIMULPF00001	227	235	256	206	29	21
3949	FW_pair3949	FakeAnc3949	FakeDesc3949	SIMULPF00001	362	356	389	329	27	33
3950	FW_pair3950	FakeAnc3950	FakeDesc3950	SIMULPF00001	22	23	23	22	1	0
3951	FW_pair3951	FakeAnc3951	FakeDesc3951	SIMULPF00001	824	832	911	745	87	79
3952	FW_pair3952	FakeAnc3952	FakeDesc3952	SIMULPF00001	63	59	65	57	2	6
3953	FW_pair3953	FakeAnc3953	FakeDesc3953	SIMULPF00001	417	421	459	379	42	38
3954	FW_pair3954	FakeAnc3954	FakeDesc3954	SIMULPF00001	772	752	823	701	51	71
3955	FW_pair3955	FakeAnc3955	FakeDesc3955	SIMULPF00001	132	141	154	119	22	13
3956	FW_pair3956	FakeAnc3956	FakeDesc3956	SIMULPF00001	410	401	447	364	37	46
3957	FW_pair3957	FakeAnc3957	FakeDesc3957	SIMULPF00001	347	360	385	322	38	25
3958	FW_pair3958	FakeAnc3958	FakeDesc3958	SIMULPF00001	23	23	25	21	2	2
3959	FW_pair3959	FakeAnc3959	FakeDesc3959	SIMULPF00001	277	277	308	246	31	31
3960	FW_pair3960	FakeAnc3960	FakeDesc3960	SIMULPF00001	290	282	317	255	27	35
3961	FW_pair3961	FakeAnc3961	FakeDesc3961	SIMULPF00001	196	206	222	180	26	16
3962	FW_pair3962	FakeAnc3962	FakeDesc3962	SIMULPF00001	77	78	83	72	6	5
3963	FW_pair3963	FakeAnc3963	FakeDesc3963	SIMULPF00001	21	18	21	18	0	3
3964	FW_pair3964	FakeAnc3964	FakeDesc3964	SIMULPF00001	7	8	9	6	2	1
3965	FW_pair3965	FakeAnc3965	FakeDesc3965	SIMULPF00001	227	223	242	208	15	19
3966	FW_pair3966	FakeAnc3966	FakeDesc3966	SIMULPF00001	452	472	504	420	52	32
3967	FW_pair3967	FakeAnc3967	FakeDesc3967	SIMULPF00001	113	105	122	96	9	17
3968	FW_pair3968	FakeAnc3968	FakeDesc3968	SIMULPF00001	228	223	248	203	20	25
3969	FW_pair3969	FakeAnc3969	FakeDesc3969	SIMULPF00001	144	151	157	138	13	6
3970	FW_pair3970	FakeAnc3970	FakeDesc3970	SIMULPF00001	133	138	144	127	11	6
3971	FW_pair3971	FakeAnc3971	FakeDesc3971	SIMULPF00001	17	17	18	16	1	1
3972	FW_pair3972	FakeAnc3972	FakeDesc3972	SIMULPF00001	150	143	158	135	8	15
3973	FW_pair3973	FakeAnc3973	FakeDesc3973	SIMULPF00001	141	134	147	128	6	13
3974	FW_pair3974	FakeAnc3974	FakeDesc3974	SIMULPF00001	101	98	107	92	6	9
3975	FW_pair3975	FakeAnc3975	FakeDesc3975	SIMULPF00001	109	110	116	103	7	6
3976	FW_pair3976	FakeAnc3976	FakeDesc3976	SIMULPF00001	881	879	969	791	88	90
3977	FW_pair3977	FakeAnc3977	FakeDesc3977	SIMULPF00001	134	132	142	124	8	10
3978	FW_pair3978	FakeAnc3978	FakeDesc3978	SIMULPF00001	137	138	152	123	15	14
3979	FW_pair3979	FakeAnc3979	FakeDesc3979	SIMULPF00001	178	176	193	161	15	17
3980	FW_pair3980	FakeAnc3980	FakeDesc3980	SIMULPF00001	118	113	125	106	7	12
3981	FW_pair3981	FakeAnc3981	FakeDesc3981	SIMULPF00001	16	17	18	15	2	1
3982	FW_pair3982	FakeAnc3982	FakeDesc3982	SIMULPF00001	524	539	581	482	57	42
3983	FW_pair3983	FakeAnc3983	FakeDesc3983	SIMULPF00001	57	56	62	51	5	6
3984	FW_pair3984	FakeAnc3984	FakeDesc3984	SIMULPF00001	92	95	101	86	9	6
3985	FW_pair3985	FakeAnc3985	FakeDesc3985	SIMULPF00001	44	37	45	36	1	8
3986	FW_pair3986	FakeAnc3986	FakeDesc3986	SIMULPF00001	549	549	602	496	53	53
3987	FW_pair3987	FakeAnc3987	FakeDesc3987	SIMULPF00001	142	158	167	133	25	9
3988	FW_pair3988	FakeAnc3988	FakeDesc3988	SIMULPF00001	241	220	248	213	7	28
3989	FW_pair3989	FakeAnc3989	FakeDesc3989	SIMULPF00001	392	384	419	357	27	35
3990	FW_pair3990	FakeAnc3990	FakeDesc3990	SIMULPF00001	604	602	655	551	51	53
3991	FW_pair3991	FakeAnc3991	FakeDesc3991	SIMULPF00001	549	559	603	505	54	44
3992	FW_pair3992	FakeAnc3992	FakeDesc3992	SIMULPF00001	307	316	344	279	37	28
3993	FW_pair3993	FakeAnc3993	FakeDesc3993	SIMULPF00001	124	130	138	116	14	8
3994	FW_pair3994	FakeAnc3994	FakeDesc3994	SIMULPF00001	220	230	243	207	23	13
3995	FW_pair3995	FakeAnc3995	FakeDesc3995	SIMULPF00001	280	266	298	248	18	32
3996	FW_pair3996	FakeAnc3996	FakeDesc3996	SIMULPF00001	17	18	20	15	3	2
3997	FW_pair3997	FakeAnc3997	FakeDesc3997	SIMULPF00001	44	41	48	37	4	7
3998	FW_pair3998	FakeAnc3998	FakeDesc3998	SIMULPF00001	171	174	185	160	14	11
3999	FW_pair3999	FakeAnc3999	FakeDesc3999	SIMULPF00001	181	174	191	164	10	17
4000	FW_pair4000	FakeAnc4000	FakeDesc4000	SIMULPF00001	110	108	116	102	6	8
4001	FW_pair4001	FakeAnc4001	FakeDesc4001	SIMULPF00001	31	30	34	27	3	4
4002	FW_pair4002	FakeAnc4002	FakeDesc4002	SIMULPF00001	44	37	45	36	1	8
4003	FW_pair4003	FakeAnc4003	FakeDesc4003	SIMULPF00001	79	83	86	76	7	3
4004	FW_pair4004	FakeAnc4004	FakeDesc4004	SIMULPF00001	88	92	101	79	13	9
4005	FW_pair4005	FakeAnc4005	FakeDesc4005	SIMULPF00001	118	113	126	105	8	13
4006	FW_pair4006	FakeAnc4006	FakeDesc4006	SIMULPF00001	27	27	31	23	4	4
4007	FW_pair4007	FakeAnc4007	FakeDesc4007	SIMULPF00001	644	655	720	579	76	65
4008	FW_pair4008	FakeAnc4008	FakeDesc4008	SIMULPF00001	182	192	206	168	24	14
4009	FW_pair4009	FakeAnc4009	FakeDesc4009	SIMULPF00001	42	45	49	38	7	4
4010	FW_pair4010	FakeAnc4010	FakeDesc4010	SIMULPF00001	56	52	61	47	5	9
4011	FW_pair4011	FakeAnc4011	FakeDesc4011	SIMULPF00001	379	378	409	348	30	31
4012	FW_pair4012	FakeAnc4012	FakeDesc4012	SIMULPF00001	339	352	381	310	42	29
4013	FW_pair4013	FakeAnc4013	FakeDesc4013	SIMULPF00001	250	245	271	224	21	26
4014	FW_pair4014	FakeAnc4014	FakeDesc4014	SIMULPF00001	171	176	184	163	13	8
4015	FW_pair4015	FakeAnc4015	FakeDesc4015	SIMULPF00001	83	72	90	65	7	18
4016	FW_pair4016	FakeAnc4016	FakeDesc4016	SIMULPF00001	397	362	419	340	22	57
4017	FW_pair4017	FakeAnc4017	FakeDesc4017	SIMULPF00001	151	157	171	137	20	14
4018	FW_pair4018	FakeAnc4018	FakeDesc4018	SIMULPF00001	16	13	16	13	0	3
4019	FW_pair4019	FakeAnc4019	FakeDesc4019	SIMULPF00001	18	18	19	17	1	1
4020	FW_pair4020	FakeAnc4020	FakeDesc4020	SIMULPF00001	5	5	5	5	0	0
4021	FW_pair4021	FakeAnc4021	FakeDesc4021	SIMULPF00001	171	169	181	159	10	12
4022	FW_pair4022	FakeAnc4022	FakeDesc4022	SIMULPF00001	299	289	322	266	23	33
4023	FW_pair4023	FakeAnc4023	FakeDesc4023	SIMULPF00001	312	310	349	273	37	39
4024	FW_pair4024	FakeAnc4024	FakeDesc4024	SIMULPF00001	17	13	17	13	0	4
4025	FW_pair4025	FakeAnc4025	FakeDesc4025	SIMULPF00001	566	573	632	507	66	59
4026	FW_pair4026	FakeAnc4026	FakeDesc4026	SIMULPF00001	109	116	118	107	9	2
4027	FW_pair4027	FakeAnc4027	FakeDesc4027	SIMULPF00001	87	86	90	83	3	4
4028	FW_pair4028	FakeAnc4028	FakeDesc4028	SIMULPF00001	142	141	152	131	10	11
4029	FW_pair4029	FakeAnc4029	FakeDesc4029	SIMULPF00001	600	597	648	549	48	51
4030	FW_pair4030	FakeAnc4030	FakeDesc4030	SIMULPF00001	92	98	103	87	11	5
4031	FW_pair4031	FakeAnc4031	FakeDesc4031	SIMULPF00001	164	184	191	157	27	7
4032	FW_pair4032	FakeAnc4032	FakeDesc4032	SIMULPF00001	404	390	433	361	29	43
4033	FW_pair4033	FakeAnc4033	FakeDesc4033	SIMULPF00001	214	219	239	194	25	20
4034	FW_pair4034	FakeAnc4034	FakeDesc4034	SIMULPF00001	102	106	118	90	16	12
4035	FW_pair4035	FakeAnc4035	FakeDesc4035	SIMULPF00001	524	523	576	471	52	53
4036	FW_pair4036	FakeAnc4036	FakeDesc4036	SIMULPF00001	141	137	152	126	11	15
4037	FW_pair4037	FakeAnc4037	FakeDesc4037	SIMULPF00001	117	108	129	96	12	21
4038	FW_pair4038	FakeAnc4038	FakeDesc4038	SIMULPF00001	146	160	167	139	21	7
4039	FW_pair4039	FakeAnc4039	FakeDesc4039	SIMULPF00001	6	5	6	5	0	1
4040	FW_pair4040	FakeAnc4040	FakeDesc4040	SIMULPF00001	389	391	423	357	34	32
4041	FW_pair4041	FakeAnc4041	FakeDesc4041	SIMULPF00001	633	659	718	574	85	59
4042	FW_pair4042	FakeAnc4042	FakeDesc4042	SIMULPF00001	383	391	428	346	45	37
4043	FW_pair4043	FakeAnc4043	FakeDesc4043	SIMULPF00001	151	144	165	130	14	21
4044	FW_pair4044	FakeAnc4044	FakeDesc4044	SIMULPF00001	55	53	60	48	5	7
4045	FW_pair4045	FakeAnc4045	FakeDesc4045	SIMULPF00001	65	62	71	56	6	9
4046	FW_pair4046	FakeAnc4046	FakeDesc4046	SIMULPF00001	273	258	298	233	25	40
4047	FW_pair4047	FakeAnc4047	FakeDesc4047	SIMULPF00001	512	508	560	460	48	52
4048	FW_pair4048	FakeAnc4048	FakeDesc4048	SIMULPF00001	438	449	493	394	55	44
4049	FW_pair4049	FakeAnc4049	FakeDesc4049	SIMULPF00001	73	70	79	64	6	9
4050	FW_pair4050	FakeAnc4050	FakeDesc4050	SIMULPF00001	115	109	131	93	16	22
4051	FW_pair4051	FakeAnc4051	FakeDesc4051	SIMULPF00001	331	331	366	296	35	35
4052	FW_pair4052	FakeAnc4052	FakeDesc4052	SIMULPF00001	61	58	64	55	3	6
4053	FW_pair4053	FakeAnc4053	FakeDesc4053	SIMULPF00001	110	112	123	99	13	11
4054	FW_pair4054	FakeAnc4054	FakeDesc4054	SIMULPF00001	86	91	99	78	13	8
4055	FW_pair4055	FakeAnc4055	FakeDesc4055	SIMULPF00001	590	606	646	550	56	40
4056	FW_pair4056	FakeAnc4056	FakeDesc4056	SIMULPF00001	143	148	161	130	18	13
4057	FW_pair4057	FakeAnc4057	FakeDesc4057	SIMULPF00001	409	415	444	380	35	29
4058	FW_pair4058	FakeAnc4058	FakeDesc4058	SIMULPF00001	198	205	219	184	21	14
4059	FW_pair4059	FakeAnc4059	FakeDesc4059	SIMULPF00001	382	395	427	350	45	32
4060	FW_pair4060	FakeAnc4060	FakeDesc4060	SIMULPF00001	361	373	400	334	39	27
4061	FW_pair4061	FakeAnc4061	FakeDesc4061	SIMULPF00001	102	111	114	99	12	3
4062	FW_pair4062	FakeAnc4062	FakeDesc4062	SIMULPF00001	244	238	268	214	24	30
4063	FW_pair4063	FakeAnc4063	FakeDesc4063	SIMULPF00001	17	16	21	12	4	5
4064	FW_pair4064	FakeAnc4064	FakeDesc4064	SIMULPF00001	382	386	417	351	35	31
4065	FW_pair4065	FakeAnc4065	FakeDesc4065	SIMULPF00001	268	277	302	243	34	25
4066	FW_pair4066	FakeAnc4066	FakeDesc4066	SIMULPF00001	622	640	689	573	67	49
4067	FW_pair4067	FakeAnc4067	FakeDesc4067	SIMULPF00001	62	59	66	55	4	7
4068	FW_pair4068	FakeAnc4068	FakeDesc4068	SIMULPF00001	197	188	206	179	9	18
4069	FW_pair4069	FakeAnc4069	FakeDesc4069	SIMULPF00001	52	58	61	49	9	3
4070	FW_pair4070	FakeAnc4070	FakeDesc4070	SIMULPF00001	365	356	393	328	28	37
4071	FW_pair4071	FakeAnc4071	FakeDesc4071	SIMULPF00001	330	335	367	298	37	32
4072	FW_pair4072	FakeAnc4072	FakeDesc4072	SIMULPF00001	265	264	288	241	23	24
4073	FW_pair4073	FakeAnc4073	FakeDesc4073	SIMULPF00001	373	365	404	334	31	39
4074	FW_pair4074	FakeAnc4074	FakeDesc4074	SIMULPF00001	86	88	94	80	8	6
4075	FW_pair4075	FakeAnc4075	FakeDesc4075	SIMULPF00001	111	117	125	103	14	8
4076	FW_pair4076	FakeAnc4076	FakeDesc4076	SIMULPF00001	4	5	5	4	1	0
4077	FW_pair4077	FakeAnc4077	FakeDesc4077	SIMULPF00001	477	474	525	426	48	51
4078	FW_pair4078	FakeAnc4078	FakeDesc4078	SIMULPF00001	63	63	69	57	6	6
4079	FW_pair4079	FakeAnc4079	FakeDesc4079	SIMULPF00001	345	340	370	315	25	30
4080	FW_pair4080	FakeAnc4080	FakeDesc4080	SIMULPF00001	172	172	188	156	16	16
4081	FW_pair4081	FakeAnc4081	FakeDesc4081	SIMULPF00001	8	8	8	8	0	0
4082	FW_pair4082	FakeAnc4082	FakeDesc4082	SIMULPF00001	242	246	265	223	23	19
4083	FW_pair4083	FakeAnc4083	FakeDesc4083	SIMULPF00001	506	498	547	457	41	49
4084	FW_pair4084	FakeAnc4084	FakeDesc4084	SIMULPF00001	240	252	265	227	25	13
4085	FW_pair4085	FakeAnc4085	FakeDesc4085	SIMULPF00001	208	212	224	196	16	12
4086	FW_pair4086	FakeAnc4086	FakeDesc4086	SIMULPF00001	241	239	261	219	20	22
4087	FW_pair4087	FakeAnc4087	FakeDesc4087	SIMULPF00001	580	552	616	516	36	64
4088	FW_pair4088	FakeAnc4088	FakeDesc4088	SIMULPF00001	118	118	129	107	11	11
4089	FW_pair4089	FakeAnc4089	FakeDesc4089	SIMULPF00001	107	100	109	98	2	9
4090	FW_pair4090	FakeAnc4090	FakeDesc4090	SIMULPF00001	277	284	298	263	21	14
4091	FW_pair4091	FakeAnc4091	FakeDesc4091	SIMULPF00001	156	156	169	143	13	13
4092	FW_pair4092	FakeAnc4092	FakeDesc4092	SIMULPF00001	561	577	610	528	49	33
4093	FW_pair4093	FakeAnc4093	FakeDesc4093	SIMULPF00001	131	145	153	123	22	8
4094	FW_pair4094	FakeAnc4094	FakeDesc4094	SIMULPF00001	43	40	45	38	2	5
4095	FW_pair4095	FakeAnc4095	FakeDesc4095	SIMULPF00001	525	505	558	472	33	53
4096	FW_pair4096	FakeAnc4096	FakeDesc4096	SIMULPF00001	198	197	214	181	16	17
4097	FW_pair4097	FakeAnc4097	FakeDesc4097	SIMULPF00001	340	355	379	316	39	24
4098	FW_pair4098	FakeAnc4098	FakeDesc4098	SIMULPF00001	181	192	210	163	29	18
4099	FW_pair4099	FakeAnc4099	FakeDesc4099	SIMULPF00001	562	557	611	508	49	54
4100	FW_pair4100	FakeAnc4100	FakeDesc4100	SIMULPF00001	199	200	216	183	17	16
4101	FW_pair4101	FakeAnc4101	FakeDesc4101	SIMULPF00001	20	19	20	19	0	1
4102	FW_pair4102	FakeAnc4102	FakeDesc4102	SIMULPF00001	144	148	161	131	17	13
4103	FW_pair4103	FakeAnc4103	FakeDesc4103	SIMULPF00001	576	587	641	522	65	54
4104	FW_pair4104	FakeAnc4104	FakeDesc4104	SIMULPF00001	401	399	437	363	36	38
4105	FW_pair4105	FakeAnc4105	FakeDesc4105	SIMULPF00001	307	308	334	281	27	26
4106	FW_pair4106	FakeAnc4106	FakeDesc4106	SIMULPF00001	255	249	285	219	30	36
4107	FW_pair4107	FakeAnc4107	FakeDesc4107	SIMULPF00001	71	68	75	64	4	7
4108	FW_pair4108	FakeAnc4108	FakeDesc4108	SIMULPF00001	101	111	120	92	19	9
4109	FW_pair4109	FakeAnc4109	FakeDesc4109	SIMULPF00001	313	325	340	298	27	15
4110	FW_pair4110	FakeAnc4110	FakeDesc4110	SIMULPF00001	265	260	290	235	25	30
4111	FW_pair4111	FakeAnc4111	FakeDesc4111	SIMULPF00001	29	30	33	26	4	3
4112	FW_pair4112	FakeAnc4112	FakeDesc4112	SIMULPF00001	110	114	123	101	13	9
4113	FW_pair4113	FakeAnc4113	FakeDesc4113	SIMULPF00001	433	430	471	392	38	41
4114	FW_pair4114	FakeAnc4114	FakeDesc4114	SIMULPF00001	15	13	15	13	0	2
4115	FW_pair4115	FakeAnc4115	FakeDesc4115	SIMULPF00001	148	142	166	124	18	24
4116	FW_pair4116	FakeAnc4116	FakeDesc4116	SIMULPF00001	574	585	637	522	63	52
4117	FW_pair4117	FakeAnc4117	FakeDesc4117	SIMULPF00001	387	375	404	358	17	29
4118	FW_pair4118	FakeAnc4118	FakeDesc4118	SIMULPF00001	406	428	453	381	47	25
4119	FW_pair4119	FakeAnc4119	FakeDesc4119	SIMULPF00001	610	602	661	551	51	59
4120	FW_pair4120	FakeAnc4120	FakeDesc4120	SIMULPF00001	12	11	12	11	0	1
4121	FW_pair4121	FakeAnc4121	FakeDesc4121	SIMULPF00001	71	70	79	62	8	9
4122	FW_pair4122	FakeAnc4122	FakeDesc4122	SIMULPF00001	46	44	50	40	4	6
4123	FW_pair4123	FakeAnc4123	FakeDesc4123	SIMULPF00001	343	336	377	302	34	41
4124	FW_pair4124	FakeAnc4124	FakeDesc4124	SIMULPF00001	320	331	352	299	32	21
4125	FW_pair4125	FakeAnc4125	FakeDesc4125	SIMULPF00001	38	40	45	33	7	5
4126	FW_pair4126	FakeAnc4126	FakeDesc4126	SIMULPF00001	35	34	36	33	1	2
4127	FW_pair4127	FakeAnc4127	FakeDesc4127	SIMULPF00001	58	55	61	52	3	6
4128	FW_pair4128	FakeAnc4128	FakeDesc4128	SIMULPF00001	172	178	192	158	20	14
4129	FW_pair4129	FakeAnc4129	FakeDesc4129	SIMULPF00001	208	201	222	187	14	21
4130	FW_pair4130	FakeAnc4130	FakeDesc4130	SIMULPF00001	61	64	68	57	7	4
4131	FW_pair4131	FakeAnc4131	FakeDesc4131	SIMULPF00001	207	225	240	192	33	15
4132	FW_pair4132	FakeAnc4132	FakeDesc4132	SIMULPF00001	27	30	32	25	5	2
4133	FW_pair4133	FakeAnc4133	FakeDesc4133	SIMULPF00001	35	36	41	30	6	5
4134	FW_pair4134	FakeAnc4134	FakeDesc4134	SIMULPF00001	359	361	405	315	46	44
4135	FW_pair4135	FakeAnc4135	FakeDesc4135	SIMULPF00001	192	189	207	174	15	18
4136	FW_pair4136	FakeAnc4136	FakeDesc4136	SIMULPF00001	19	17	19	17	0	2
4137	FW_pair4137	FakeAnc4137	FakeDesc4137	SIMULPF00001	72	69	79	62	7	10
4138	FW_pair4138	FakeAnc4138	FakeDesc4138	SIMULPF00001	352	351	381	322	29	30
4139	FW_pair4139	FakeAnc4139	FakeDesc4139	SIMULPF00001	363	339	394	308	31	55
4140	FW_pair4140	FakeAnc4140	FakeDesc4140	SIMULPF00001	185	180	193	172	8	13
4141	FW_pair4141	FakeAnc4141	FakeDesc4141	SIMULPF00001	74	74	77	71	3	3
4142	FW_pair4142	FakeAnc4142	FakeDesc4142	SIMULPF00001	253	263	283	233	30	20
4143	FW_pair4143	FakeAnc4143	FakeDesc4143	SIMULPF00001	250	253	271	232	21	18
4144	FW_pair4144	FakeAnc4144	FakeDesc4144	SIMULPF00001	212	230	242	200	30	12
4145	FW_pair4145	FakeAnc4145	FakeDesc4145	SIMULPF00001	225	218	247	196	22	29
4146	FW_pair4146	FakeAnc4146	FakeDesc4146	SIMULPF00001	408	426	465	369	57	39
4147	FW_pair4147	FakeAnc4147	FakeDesc4147	SIMULPF00001	383	359	404	338	21	45
4148	FW_pair4148	FakeAnc4148	FakeDesc4148	SIMULPF00001	128	124	139	113	11	15
4149	FW_pair4149	FakeAnc4149	FakeDesc4149	SIMULPF00001	118	117	124	111	6	7
4150	FW_pair4150	FakeAnc4150	FakeDesc4150	SIMULPF00001	100	102	110	92	10	8
4151	FW_pair4151	FakeAnc4151	FakeDesc4151	SIMULPF00001	124	120	131	113	7	11
4152	FW_pair4152	FakeAnc4152	FakeDesc4152	SIMULPF00001	116	115	127	104	11	12
4153	FW_pair4153	FakeAnc4153	FakeDesc4153	SIMULPF00001	262	267	291	238	29	24
4154	FW_pair4154	FakeAnc4154	FakeDesc4154	SIMULPF00001	58	57	62	53	4	5
4155	FW_pair4155	FakeAnc4155	FakeDesc4155	SIMULPF00001	442	437	485	394	43	48
4156	FW_pair4156	FakeAnc4156	FakeDesc4156	SIMULPF00001	260	255	278	237	18	23
4157	FW_pair4157	FakeAnc4157	FakeDesc4157	SIMULPF00001	201	196	219	178	18	23
4158	FW_pair4158	FakeAnc4158	FakeDesc4158	SIMULPF00001	494	486	545	435	51	59
4159	FW_pair4159	FakeAnc4159	FakeDesc4159	SIMULPF00001	691	710	766	635	75	56
4160	FW_pair4160	FakeAnc4160	FakeDesc4160	SIMULPF00001	177	176	188	165	11	12
4161	FW_pair4161	FakeAnc4161	FakeDesc4161	SIMULPF00001	217	222	252	187	35	30
4162	FW_pair4162	FakeAnc4162	FakeDesc4162	SIMULPF00001	149	152	159	142	10	7
4163	FW_pair4163	FakeAnc4163	FakeDesc4163	SIMULPF00001	86	87	95	78	9	8
4164	FW_pair4164	FakeAnc4164	FakeDesc4164	SIMULPF00001	316	326	361	281	45	35
4165	FW_pair4165	FakeAnc4165	FakeDesc4165	SIMULPF00001	680	689	743	626	63	54
4166	FW_pair4166	FakeAnc4166	FakeDesc4166	SIMULPF00001	197	198	215	180	18	17
4167	FW_pair4167	FakeAnc4167	FakeDesc4167	SIMULPF00001	7	7	8	6	1	1
4168	FW_pair4168	FakeAnc4168	FakeDesc4168	SIMULPF00001	13	14	14	13	1	0
4169	FW_pair4169	FakeAnc4169	FakeDesc4169	SIMULPF00001	65	62	68	59	3	6
4170	FW_pair4170	FakeAnc4170	FakeDesc4170	SIMULPF00001	29	29	32	26	3	3
4171	FW_pair4171	FakeAnc4171	FakeDesc4171	SIMULPF00001	560	565	616	509	56	51
4172	FW_pair4172	FakeAnc4172	FakeDesc4172	SIMULPF00001	1	1	1	1	0	0
4173	FW_pair4173	FakeAnc4173	FakeDesc4173	SIMULPF00001	154	157	174	137	20	17
4174	FW_pair4174	FakeAnc4174	FakeDesc4174	SIMULPF00001	2	2	2	2	0	0
4175	FW_pair4175	FakeAnc4175	FakeDesc4175	SIMULPF00001	475	463	514	424	39	51
4176	FW_pair4176	FakeAnc4176	FakeDesc4176	SIMULPF00001	162	157	172	147	10	15
4177	FW_pair4177	FakeAnc4177	FakeDesc4177	SIMULPF00001	115	108	121	102	6	13
4178	FW_pair4178	FakeAnc4178	FakeDesc4178	SIMULPF00001	97	102	108	91	11	6
4179	FW_pair4179	FakeAnc4179	FakeDesc4179	SIMULPF00001	22	25	25	22	3	0
4180	FW_pair4180	FakeAnc4180	FakeDesc4180	SIMULPF00001	89	86	96	79	7	10
4181	FW_pair4181	FakeAnc4181	FakeDesc4181	SIMULPF00001	107	107	114	100	7	7
4182	FW_pair4182	FakeAnc4182	FakeDesc4182	SIMULPF00001	369	378	409	338	40	31
4183	FW_pair4183	FakeAnc4183	FakeDesc4183	SIMULPF00001	245	239	263	221	18	24
4184	FW_pair4184	FakeAnc4184	FakeDesc4184	SIMULPF00001	485	493	537	441	52	44
4185	FW_pair4185	FakeAnc4185	FakeDesc4185	SIMULPF00001	484	503	538	449	54	35
4186	FW_pair4186	FakeAnc4186	FakeDesc4186	SIMULPF00001	35	39	39	35	4	0
4187	FW_pair4187	FakeAnc4187	FakeDesc4187	SIMULPF00001	14	15	15	14	1	0
4188	FW_pair4188	FakeAnc4188	FakeDesc4188	SIMULPF00001	76	82	86	72	10	4
4189	FW_pair4189	FakeAnc4189	FakeDesc4189	SIMULPF00001	2	3	3	2	1	0
4190	FW_pair4190	FakeAnc4190	FakeDesc4190	SIMULPF00001	431	442	481	392	50	39
4191	FW_pair4191	FakeAnc4191	FakeDesc4191	SIMULPF00001	292	295	323	264	31	28
4192	FW_pair4192	FakeAnc4192	FakeDesc4192	SIMULPF00001	467	464	505	426	38	41
4193	FW_pair4193	FakeAnc4193	FakeDesc4193	SIMULPF00001	360	357	390	327	30	33
4194	FW_pair4194	FakeAnc4194	FakeDesc4194	SIMULPF00001	274	278	304	248	30	26
4195	FW_pair4195	FakeAnc4195	FakeDesc4195	SIMULPF00001	21	27	27	21	6	0
4196	FW_pair4196	FakeAnc4196	FakeDesc4196	SIMULPF00001	866	870	939	797	73	69
4197	FW_pair4197	FakeAnc4197	FakeDesc4197	SIMULPF00001	351	348	387	312	36	39
4198	FW_pair4198	FakeAnc4198	FakeDesc4198	SIMULPF00001	518	499	552	465	34	53
4199	FW_pair4199	FakeAnc4199	FakeDesc4199	SIMULPF00001	103	95	109	89	6	14
4200	FW_pair4200	FakeAnc4200	FakeDesc4200	SIMULPF00001	72	79	81	70	9	2
4201	FW_pair4201	FakeAnc4201	FakeDesc4201	SIMULPF00001	2	3	3	2	1	0
4202	FW_pair4202	FakeAnc4202	FakeDesc4202	SIMULPF00001	73	69	78	64	5	9
4203	FW_pair4203	FakeAnc4203	FakeDesc4203	SIMULPF00001	240	240	255	225	15	15
4204	FW_pair4204	FakeAnc4204	FakeDesc4204	SIMULPF00001	112	118	122	108	10	4
4205	FW_pair4205	FakeAnc4205	FakeDesc4205	SIMULPF00001	31	29	31	29	0	2
4206	FW_pair4206	FakeAnc4206	FakeDesc4206	SIMULPF00001	34	40	43	31	9	3
4207	FW_pair4207	FakeAnc4207	FakeDesc4207	SIMULPF00001	54	51	57	48	3	6
4208	FW_pair4208	FakeAnc4208	FakeDesc4208	SIMULPF00001	6	7	7	6	1	0
4209	FW_pair4209	FakeAnc4209	FakeDesc4209	SIMULPF00001	893	891	972	812	79	81
4210	FW_pair4210	FakeAnc4210	FakeDesc4210	SIMULPF00001	47	45	52	40	5	7
4211	FW_pair4211	FakeAnc4211	FakeDesc4211	SIMULPF00001	258	257	283	232	25	26
4212	FW_pair4212	FakeAnc4212	FakeDesc4212	SIMULPF00001	177	170	192	155	15	22
4213	FW_pair4213	FakeAnc4213	FakeDesc4213	SIMULPF00001	382	364	412	334	30	48
4214	FW_pair4214	FakeAnc4214	FakeDesc4214	SIMULPF00001	114	126	135	105	21	9
4215	FW_pair4215	FakeAnc4215	FakeDesc4215	SIMULPF00001	742	747	805	684	63	58
4216	FW_pair4216	FakeAnc4216	FakeDesc4216	SIMULPF00001	413	416	449	380	36	33
4217	FW_pair4217	FakeAnc4217	FakeDesc4217	SIMULPF00001	90	92	98	84	8	6
4218	FW_pair4218	FakeAnc4218	FakeDesc4218	SIMULPF00001	214	207	226	195	12	19
4219	FW_pair4219	FakeAnc4219	FakeDesc4219	SIMULPF00001	54	57	59	52	5	2
4220	FW_pair4220	FakeAnc4220	FakeDesc4220	SIMULPF00001	63	63	71	55	8	8
4221	FW_pair4221	FakeAnc4221	FakeDesc4221	SIMULPF00001	264	259	290	233	26	31
4222	FW_pair4222	FakeAnc4222	FakeDesc4222	SIMULPF00001	76	75	83	68	7	8
4223	FW_pair4223	FakeAnc4223	FakeDesc4223	SIMULPF00001	347	346	375	318	28	29
4224	FW_pair4224	FakeAnc4224	FakeDesc4224	SIMULPF00001	483	490	544	429	61	54
4225	FW_pair4225	FakeAnc4225	FakeDesc4225	SIMULPF00001	198	198	221	175	23	23
4226	FW_pair4226	FakeAnc4226	FakeDesc4226	SIMULPF00001	116	112	127	101	11	15
4227	FW_pair4227	FakeAnc4227	FakeDesc4227	SIMULPF00001	134	140	150	124	16	10
4228	FW_pair4228	FakeAnc4228	FakeDesc4228	SIMULPF00001	55	58	64	49	9	6
4229	FW_pair4229	FakeAnc4229	FakeDesc4229	SIMULPF00001	12	10	12	10	0	2
4230	FW_pair4230	FakeAnc4230	FakeDesc4230	SIMULPF00001	151	145	156	140	5	11
4231	FW_pair4231	FakeAnc4231	FakeDesc4231	SIMULPF00001	41	45	45	41	4	0
4232	FW_pair4232	FakeAnc4232	FakeDesc4232	SIMULPF00001	433	442	477	398	44	35
4233	FW_pair4233	FakeAnc4233	FakeDesc4233	SIMULPF00001	198	211	218	191	20	7
4234	FW_pair4234	FakeAnc4234	FakeDesc4234	SIMULPF00001	121	128	131	118	10	3
4235	FW_pair4235	FakeAnc4235	FakeDesc4235	SIMULPF00001	107	118	125	100	18	7
4236	FW_pair4236	FakeAnc4236	FakeDesc4236	SIMULPF00001	49	55	57	47	8	2
4237	FW_pair4237	FakeAnc4237	FakeDesc4237	SIMULPF00001	534	539	581	492	47	42
4238	FW_pair4238	FakeAnc4238	FakeDesc4238	SIMULPF00001	813	790	871	732	58	81
4239	FW_pair4239	FakeAnc4239	FakeDesc4239	SIMULPF00001	232	241	259	214	27	18
4240	FW_pair4240	FakeAnc4240	FakeDesc4240	SIMULPF00001	202	196	220	178	18	24
4241	FW_pair4241	FakeAnc4241	FakeDesc4241	SIMULPF00001	94	97	108	83	14	11
4242	FW_pair4242	FakeAnc4242	FakeDesc4242	SIMULPF00001	55	58	61	52	6	3
4243	FW_pair4243	FakeAnc4243	FakeDesc4243	SIMULPF00001	38	39	42	35	4	3
4244	FW_pair4244	FakeAnc4244	FakeDesc4244	SIMULPF00001	210	208	231	187	21	23
4245	FW_pair4245	FakeAnc4245	FakeDesc4245	SIMULPF00001	85	82	92	75	7	10
4246	FW_pair4246	FakeAnc4246	FakeDesc4246	SIMULPF00001	44	42	48	38	4	6
4247	FW_pair4247	FakeAnc4247	FakeDesc4247	SIMULPF00001	3	3	3	3	0	0
4248	FW_pair4248	FakeAnc4248	FakeDesc4248	SIMULPF00001	68	66	72	62	4	6
4249	FW_pair4249	FakeAnc4249	FakeDesc4249	SIMULPF00001	45	45	47	43	2	2
4250	FW_pair4250	FakeAnc4250	FakeDesc4250	SIMULPF00001	239	245	254	230	15	9
4251	FW_pair4251	FakeAnc4251	FakeDesc4251	SIMULPF00001	37	34	38	33	1	4
4252	FW_pair4252	FakeAnc4252	FakeDesc4252	SIMULPF00001	594	585	645	534	51	60
4253	FW_pair4253	FakeAnc4253	FakeDesc4253	SIMULPF00001	12	14	14	12	2	0
4254	FW_pair4254	FakeAnc4254	FakeDesc4254	SIMULPF00001	66	66	71	61	5	5
4255	FW_pair4255	FakeAnc4255	FakeDesc4255	SIMULPF00001	158	159	181	136	23	22
4256	FW_pair4256	FakeAnc4256	FakeDesc4256	SIMULPF00001	41	44	48	37	7	4
4257	FW_pair4257	FakeAnc4257	FakeDesc4257	SIMULPF00001	257	250	285	222	28	35
4258	FW_pair4258	FakeAnc4258	FakeDesc4258	SIMULPF00001	35	34	37	32	2	3
4259	FW_pair4259	FakeAnc4259	FakeDesc4259	SIMULPF00001	496	513	558	451	62	45
4260	FW_pair4260	FakeAnc4260	FakeDesc4260	SIMULPF00001	52	51	55	48	3	4
4261	FW_pair4261	FakeAnc4261	FakeDesc4261	SIMULPF00001	7	4	7	4	0	3
4262	FW_pair4262	FakeAnc4262	FakeDesc4262	SIMULPF00001	11	12	13	10	2	1
4263	FW_pair4263	FakeAnc4263	FakeDesc4263	SIMULPF00001	70	66	74	62	4	8
4264	FW_pair4264	FakeAnc4264	FakeDesc4264	SIMULPF00001	90	84	98	76	8	14
4265	FW_pair4265	FakeAnc4265	FakeDesc4265	SIMULPF00001	183	188	202	169	19	14
4266	FW_pair4266	FakeAnc4266	FakeDesc4266	SIMULPF00001	388	362	414	336	26	52
4267	FW_pair4267	FakeAnc4267	FakeDesc4267	SIMULPF00001	194	195	215	174	21	20
4268	FW_pair4268	FakeAnc4268	FakeDesc4268	SIMULPF00001	420	416	448	388	28	32
4269	FW_pair4269	FakeAnc4269	FakeDesc4269	SIMULPF00001	95	103	111	87	16	8
4270	FW_pair4270	FakeAnc4270	FakeDesc4270	SIMULPF00001	200	211	227	184	27	16
4271	FW_pair4271	FakeAnc4271	FakeDesc4271	SIMULPF00001	204	210	233	181	29	23
4272	FW_pair4272	FakeAnc4272	FakeDesc4272	SIMULPF00001	717	717	791	643	74	74
4273	FW_pair4273	FakeAnc4273	FakeDesc4273	SIMULPF00001	25	21	26	20	1	5
4274	FW_pair4274	FakeAnc4274	FakeDesc4274	SIMULPF00001	209	206	227	188	18	21
4275	FW_pair4275	FakeAnc4275	FakeDesc4275	SIMULPF00001	822	834	898	758	76	64
4276	FW_pair4276	FakeAnc4276	FakeDesc4276	SIMULPF00001	245	247	274	218	29	27
4277	FW_pair4277	FakeAnc4277	FakeDesc4277	SIMULPF00001	479	473	521	431	42	48
4278	FW_pair4278	FakeAnc4278	FakeDesc4278	SIMULPF00001	73	78	82	69	9	4
4279	FW_pair4279	FakeAnc4279	FakeDesc4279	SIMULPF00001	121	117	127	111	6	10
4280	FW_pair4280	FakeAnc4280	FakeDesc4280	SIMULPF00001	314	312	344	282	30	32
4281	FW_pair4281	FakeAnc4281	FakeDesc4281	SIMULPF00001	25	24	25	24	0	1
4282	FW_pair4282	FakeAnc4282	FakeDesc4282	SIMULPF00001	200	197	216	181	16	19
4283	FW_pair4283	FakeAnc4283	FakeDesc4283	SIMULPF00001	30	32	34	28	4	2
4284	FW_pair4284	FakeAnc4284	FakeDesc4284	SIMULPF00001	546	522	583	485	37	61
4285	FW_pair4285	FakeAnc4285	FakeDesc4285	SIMULPF00001	121	116	133	104	12	17
4286	FW_pair4286	FakeAnc4286	FakeDesc4286	SIMULPF00001	32	31	34	29	2	3
4287	FW_pair4287	FakeAnc4287	FakeDesc4287	SIMULPF00001	91	92	101	82	10	9
4288	FW_pair4288	FakeAnc4288	FakeDesc4288	SIMULPF00001	301	305	330	276	29	25
4289	FW_pair4289	FakeAnc4289	FakeDesc4289	SIMULPF00001	324	311	344	291	20	33
4290	FW_pair4290	FakeAnc4290	FakeDesc4290	SIMULPF00001	111	110	119	102	8	9
4291	FW_pair4291	FakeAnc4291	FakeDesc4291	SIMULPF00001	604	611	674	541	70	63
4292	FW_pair4292	FakeAnc4292	FakeDesc4292	SIMULPF00001	280	266	298	248	18	32
4293	FW_pair4293	FakeAnc4293	FakeDesc4293	SIMULPF00001	178	184	199	163	21	15
4294	FW_pair4294	FakeAnc4294	FakeDesc4294	SIMULPF00001	18	22	22	18	4	0
4295	FW_pair4295	FakeAnc4295	FakeDesc4295	SIMULPF00001	104	103	111	96	7	8
4296	FW_pair4296	FakeAnc4296	FakeDesc4296	SIMULPF00001	14	14	15	13	1	1
4297	FW_pair4297	FakeAnc4297	FakeDesc4297	SIMULPF00001	130	129	147	112	17	18
4298	FW_pair4298	FakeAnc4298	FakeDesc4298	SIMULPF00001	21	16	22	15	1	6
4299	FW_pair4299	FakeAnc4299	FakeDesc4299	SIMULPF00001	135	133	145	123	10	12
4300	FW_pair4300	FakeAnc4300	FakeDesc4300	SIMULPF00001	411	422	454	379	43	32
4301	FW_pair4301	FakeAnc4301	FakeDesc4301	SIMULPF00001	574	560	626	508	52	66
4302	FW_pair4302	FakeAnc4302	FakeDesc4302	SIMULPF00001	181	200	205	176	24	5
4303	FW_pair4303	FakeAnc4303	FakeDesc4303	SIMULPF00001	654	646	708	592	54	62
4304	FW_pair4304	FakeAnc4304	FakeDesc4304	SIMULPF00001	55	48	59	44	4	11
4305	FW_pair4305	FakeAnc4305	FakeDesc4305	SIMULPF00001	6	6	6	6	0	0
4306	FW_pair4306	FakeAnc4306	FakeDesc4306	SIMULPF00001	233	229	249	213	16	20
4307	FW_pair4307	FakeAnc4307	FakeDesc4307	SIMULPF00001	12	13	13	12	1	0
4308	FW_pair4308	FakeAnc4308	FakeDesc4308	SIMULPF00001	244	242	263	223	19	21
4309	FW_pair4309	FakeAnc4309	FakeDesc4309	SIMULPF00001	86	86	95	77	9	9
4310	FW_pair4310	FakeAnc4310	FakeDesc4310	SIMULPF00001	376	377	413	340	37	36
4311	FW_pair4311	FakeAnc4311	FakeDesc4311	SIMULPF00001	572	577	631	518	59	54
4312	FW_pair4312	FakeAnc4312	FakeDesc4312	SIMULPF00001	92	93	103	82	11	10
4313	FW_pair4313	FakeAnc4313	FakeDesc4313	SIMULPF00001	3	3	3	3	0	0
4314	FW_pair4314	FakeAnc4314	FakeDesc4314	SIMULPF00001	4	4	4	4	0	0
4315	FW_pair4315	FakeAnc4315	FakeDesc4315	SIMULPF00001	430	428	473	385	43	45
4316	FW_pair4316	FakeAnc4316	FakeDesc4316	SIMULPF00001	659	659	725	593	66	66
4317	FW_pair4317	FakeAnc4317	FakeDesc4317	SIMULPF00001	116	119	130	105	14	11
4318	FW_pair4318	FakeAnc4318	FakeDesc4318	SIMULPF00001	654	658	716	596	62	58
4319	FW_pair4319	FakeAnc4319	FakeDesc4319	SIMULPF00001	109	104	114	99	5	10
4320	FW_pair4320	FakeAnc4320	FakeDesc4320	SIMULPF00001	43	46	48	41	5	2
4321	FW_pair4321	FakeAnc4321	FakeDesc4321	SIMULPF00001	77	71	82	66	5	11
4322	FW_pair4322	FakeAnc4322	FakeDesc4322	SIMULPF00001	119	113	128	104	9	15
4323	FW_pair4323	FakeAnc4323	FakeDesc4323	SIMULPF00001	18	18	19	17	1	1
4324	FW_pair4324	FakeAnc4324	FakeDesc4324	SIMULPF00001	1	1	1	1	0	0
4325	FW_pair4325	FakeAnc4325	FakeDesc4325	SIMULPF00001	127	127	141	113	14	14
4326	FW_pair4326	FakeAnc4326	FakeDesc4326	SIMULPF00001	21	20	23	18	2	3
4327	FW_pair4327	FakeAnc4327	FakeDesc4327	SIMULPF00001	263	273	292	244	29	19
4328	FW_pair4328	FakeAnc4328	FakeDesc4328	SIMULPF00001	574	574	634	514	60	60
4329	FW_pair4329	FakeAnc4329	FakeDesc4329	SIMULPF00001	197	187	214	170	17	27
4330	FW_pair4330	FakeAnc4330	FakeDesc4330	SIMULPF00001	318	316	344	290	26	28
4331	FW_pair4331	FakeAnc4331	FakeDesc4331	SIMULPF00001	18	15	18	15	0	3
4332	FW_pair4332	FakeAnc4332	FakeDesc4332	SIMULPF00001	565	548	621	492	56	73
4333	FW_pair4333	FakeAnc4333	FakeDesc4333	SIMULPF00001	524	543	588	479	64	45
4334	FW_pair4334	FakeAnc4334	FakeDesc4334	SIMULPF00001	23	26	26	23	3	0
4335	FW_pair4335	FakeAnc4335	FakeDesc4335	SIMULPF00001	44	52	53	43	9	1
4336	FW_pair4336	FakeAnc4336	FakeDesc4336	SIMULPF00001	182	180	192	170	10	12
4337	FW_pair4337	FakeAnc4337	FakeDesc4337	SIMULPF00001	32	35	37	30	5	2
4338	FW_pair4338	FakeAnc4338	FakeDesc4338	SIMULPF00001	100	81	101	80	1	20
4339	FW_pair4339	FakeAnc4339	FakeDesc4339	SIMULPF00001	637	628	698	567	61	70
4340	FW_pair4340	FakeAnc4340	FakeDesc4340	SIMULPF00001	357	367	397	327	40	30
4341	FW_pair4341	FakeAnc4341	FakeDesc4341	SIMULPF00001	417	418	458	377	41	40
4342	FW_pair4342	FakeAnc4342	FakeDesc4342	SIMULPF00001	52	46	56	42	4	10
4343	FW_pair4343	FakeAnc4343	FakeDesc4343	SIMULPF00001	193	187	206	174	13	19
4344	FW_pair4344	FakeAnc4344	FakeDesc4344	SIMULPF00001	74	85	88	71	14	3
4345	FW_pair4345	FakeAnc4345	FakeDesc4345	SIMULPF00001	336	343	374	305	38	31
4346	FW_pair4346	FakeAnc4346	FakeDesc4346	SIMULPF00001	114	114	121	107	7	7
4347	FW_pair4347	FakeAnc4347	FakeDesc4347	SIMULPF00001	866	864	946	784	80	82
4348	FW_pair4348	FakeAnc4348	FakeDesc4348	SIMULPF00001	196	198	210	184	14	12
4349	FW_pair4349	FakeAnc4349	FakeDesc4349	SIMULPF00001	228	229	246	211	18	17
4350	FW_pair4350	FakeAnc4350	FakeDesc4350	SIMULPF00001	72	70	75	67	3	5
4351	FW_pair4351	FakeAnc4351	FakeDesc4351	SIMULPF00001	375	359	399	335	24	40
4352	FW_pair4352	FakeAnc4352	FakeDesc4352	SIMULPF00001	561	554	600	515	39	46
4353	FW_pair4353	FakeAnc4353	FakeDesc4353	SIMULPF00001	232	240	257	215	25	17
4354	FW_pair4354	FakeAnc4354	FakeDesc4354	SIMULPF00001	391	375	427	339	36	52
4355	FW_pair4355	FakeAnc4355	FakeDesc4355	SIMULPF00001	334	334	363	305	29	29
4356	FW_pair4356	FakeAnc4356	FakeDesc4356	SIMULPF00001	55	53	61	47	6	8
4357	FW_pair4357	FakeAnc4357	FakeDesc4357	SIMULPF00001	99	98	102	95	3	4
4358	FW_pair4358	FakeAnc4358	FakeDesc4358	SIMULPF00001	306	301	331	276	25	30
4359	FW_pair4359	FakeAnc4359	FakeDesc4359	SIMULPF00001	14	10	14	10	0	4
4360	FW_pair4360	FakeAnc4360	FakeDesc4360	SIMULPF00001	46	42	49	39	3	7
4361	FW_pair4361	FakeAnc4361	FakeDesc4361	SIMULPF00001	175	185	201	159	26	16
4362	FW_pair4362	FakeAnc4362	FakeDesc4362	SIMULPF00001	72	72	80	64	8	8
4363	FW_pair4363	FakeAnc4363	FakeDesc4363	SIMULPF00001	166	158	174	150	8	16
4364	FW_pair4364	FakeAnc4364	FakeDesc4364	SIMULPF00001	851	833	932	752	81	99
4365	FW_pair4365	FakeAnc4365	FakeDesc4365	SIMULPF00001	81	84	95	70	14	11
4366	FW_pair4366	FakeAnc4366	FakeDesc4366	SIMULPF00001	127	117	133	111	6	16
4367	FW_pair4367	FakeAnc4367	FakeDesc4367	SIMULPF00001	283	277	310	250	27	33
4368	FW_pair4368	FakeAnc4368	FakeDesc4368	SIMULPF00001	696	700	775	621	79	75
4369	FW_pair4369	FakeAnc4369	FakeDesc4369	SIMULPF00001	310	299	329	280	19	30
4370	FW_pair4370	FakeAnc4370	FakeDesc4370	SIMULPF00001	25	25	28	22	3	3
4371	FW_pair4371	FakeAnc4371	FakeDesc4371	SIMULPF00001	372	362	412	322	40	50
4372	FW_pair4372	FakeAnc4372	FakeDesc4372	SIMULPF00001	87	88	99	76	12	11
4373	FW_pair4373	FakeAnc4373	FakeDesc4373	SIMULPF00001	87	91	96	82	9	5
4374	FW_pair4374	FakeAnc4374	FakeDesc4374	SIMULPF00001	9	7	9	7	0	2
4375	FW_pair4375	FakeAnc4375	FakeDesc4375	SIMULPF00001	94	93	105	82	11	12
4376	FW_pair4376	FakeAnc4376	FakeDesc4376	SIMULPF00001	83	88	94	77	11	6
4377	FW_pair4377	FakeAnc4377	FakeDesc4377	SIMULPF00001	442	435	477	400	35	42
4378	FW_pair4378	FakeAnc4378	FakeDesc4378	SIMULPF00001	223	233	243	213	20	10
4379	FW_pair4379	FakeAnc4379	FakeDesc4379	SIMULPF00001	13	16	16	13	3	0
4380	FW_pair4380	FakeAnc4380	FakeDesc4380	SIMULPF00001	255	260	285	230	30	25
4381	FW_pair4381	FakeAnc4381	FakeDesc4381	SIMULPF00001	9	9	9	9	0	0
4382	FW_pair4382	FakeAnc4382	FakeDesc4382	SIMULPF00001	98	99	107	90	9	8
4383	FW_pair4383	FakeAnc4383	FakeDesc4383	SIMULPF00001	205	205	228	182	23	23
4384	FW_pair4384	FakeAnc4384	FakeDesc4384	SIMULPF00001	149	140	160	129	11	20
4385	FW_pair4385	FakeAnc4385	FakeDesc4385	SIMULPF00001	137	149	161	125	24	12
4386	FW_pair4386	FakeAnc4386	FakeDesc4386	SIMULPF00001	197	198	216	179	19	18
4387	FW_pair4387	FakeAnc4387	FakeDesc4387	SIMULPF00001	215	211	228	198	13	17
4388	FW_pair4388	FakeAnc4388	FakeDesc4388	SIMULPF00001	10	11	12	9	2	1
4389	FW_pair4389	FakeAnc4389	FakeDesc4389	SIMULPF00001	435	440	487	388	52	47
4390	FW_pair4390	FakeAnc4390	FakeDesc4390	SIMULPF00001	173	179	199	153	26	20
4391	FW_pair4391	FakeAnc4391	FakeDesc4391	SIMULPF00001	105	108	119	94	14	11
4392	FW_pair4392	FakeAnc4392	FakeDesc4392	SIMULPF00001	463	441	489	415	26	48
4393	FW_pair4393	FakeAnc4393	FakeDesc4393	SIMULPF00001	371	384	412	343	41	28
4394	FW_pair4394	FakeAnc4394	FakeDesc4394	SIMULPF00001	369	368	402	335	33	34
4395	FW_pair4395	FakeAnc4395	FakeDesc4395	SIMULPF00001	228	247	261	214	33	14
4396	FW_pair4396	FakeAnc4396	FakeDesc4396	SIMULPF00001	108	99	113	94	5	14
4397	FW_pair4397	FakeAnc4397	FakeDesc4397	SIMULPF00001	75	77	78	74	3	1
4398	FW_pair4398	FakeAnc4398	FakeDesc4398	SIMULPF00001	260	253	277	236	17	24
4399	FW_pair4399	FakeAnc4399	FakeDesc4399	SIMULPF00001	251	238	274	215	23	36
4400	FW_pair4400	FakeAnc4400	FakeDesc4400	SIMULPF00001	299	313	334	278	35	21
4401	FW_pair4401	FakeAnc4401	FakeDesc4401	SIMULPF00001	133	141	150	124	17	9
4402	FW_pair4402	FakeAnc4402	FakeDesc4402	SIMULPF00001	75	78	83	70	8	5
4403	FW_pair4403	FakeAnc4403	FakeDesc4403	SIMULPF00001	337	349	381	305	44	32
4404	FW_pair4404	FakeAnc4404	FakeDesc4404	SIMULPF00001	219	225	240	204	21	15
4405	FW_pair4405	FakeAnc4405	FakeDesc4405	SIMULPF00001	112	117	128	101	16	11
4406	FW_pair4406	FakeAnc4406	FakeDesc4406	SIMULPF00001	219	220	239	200	20	19
4407	FW_pair4407	FakeAnc4407	FakeDesc4407	SIMULPF00001	343	328	367	304	24	39
4408	FW_pair4408	FakeAnc4408	FakeDesc4408	SIMULPF00001	370	392	418	344	48	26
4409	FW_pair4409	FakeAnc4409	FakeDesc4409	SIMULPF00001	58	49	62	45	4	13
4410	FW_pair4410	FakeAnc4410	FakeDesc4410	SIMULPF00001	224	232	249	207	25	17
4411	FW_pair4411	FakeAnc4411	FakeDesc4411	SIMULPF00001	281	277	314	244	33	37
4412	FW_pair4412	FakeAnc4412	FakeDesc4412	SIMULPF00001	58	59	65	52	7	6
4413	FW_pair4413	FakeAnc4413	FakeDesc4413	SIMULPF00001	264	271	292	243	28	21
4414	FW_pair4414	FakeAnc4414	FakeDesc4414	SIMULPF00001	53	56	59	50	6	3
4415	FW_pair4415	FakeAnc4415	FakeDesc4415	SIMULPF00001	86	88	96	78	10	8
4416	FW_pair4416	FakeAnc4416	FakeDesc4416	SIMULPF00001	352	324	376	300	24	52
4417	FW_pair4417	FakeAnc4417	FakeDesc4417	SIMULPF00001	45	43	48	40	3	5
4418	FW_pair4418	FakeAnc4418	FakeDesc4418	SIMULPF00001	441	443	480	404	39	37
4419	FW_pair4419	FakeAnc4419	FakeDesc4419	SIMULPF00001	771	773	837	707	66	64
4420	FW_pair4420	FakeAnc4420	FakeDesc4420	SIMULPF00001	404	424	459	369	55	35
4421	FW_pair4421	FakeAnc4421	FakeDesc4421	SIMULPF00001	566	573	635	504	69	62
4422	FW_pair4422	FakeAnc4422	FakeDesc4422	SIMULPF00001	66	70	76	60	10	6
4423	FW_pair4423	FakeAnc4423	FakeDesc4423	SIMULPF00001	292	295	319	268	27	24
4424	FW_pair4424	FakeAnc4424	FakeDesc4424	SIMULPF00001	31	28	31	28	0	3
4425	FW_pair4425	FakeAnc4425	FakeDesc4425	SIMULPF00001	52	47	53	46	1	6
4426	FW_pair4426	FakeAnc4426	FakeDesc4426	SIMULPF00001	193	190	206	177	13	16
4427	FW_pair4427	FakeAnc4427	FakeDesc4427	SIMULPF00001	107	111	118	100	11	7
4428	FW_pair4428	FakeAnc4428	FakeDesc4428	SIMULPF00001	162	159	177	144	15	18
4429	FW_pair4429	FakeAnc4429	FakeDesc4429	SIMULPF00001	115	117	125	107	10	8
4430	FW_pair4430	FakeAnc4430	FakeDesc4430	SIMULPF00001	111	98	115	94	4	17
4431	FW_pair4431	FakeAnc4431	FakeDesc4431	SIMULPF00001	18	18	19	17	1	1
4432	FW_pair4432	FakeAnc4432	FakeDesc4432	SIMULPF00001	397	405	432	370	35	27
4433	FW_pair4433	FakeAnc4433	FakeDesc4433	SIMULPF00001	66	69	73	62	7	4
4434	FW_pair4434	FakeAnc4434	FakeDesc4434	SIMULPF00001	89	90	97	82	8	7
4435	FW_pair4435	FakeAnc4435	FakeDesc4435	SIMULPF00001	344	352	374	322	30	22
4436	FW_pair4436	FakeAnc4436	FakeDesc4436	SIMULPF00001	22	26	26	22	4	0
4437	FW_pair4437	FakeAnc4437	FakeDesc4437	SIMULPF00001	359	362	405	316	46	43
4438	FW_pair4438	FakeAnc4438	FakeDesc4438	SIMULPF00001	177	178	191	164	14	13
4439	FW_pair4439	FakeAnc4439	FakeDesc4439	SIMULPF00001	428	404	460	372	32	56
4440	FW_pair4440	FakeAnc4440	FakeDesc4440	SIMULPF00001	42	46	47	41	5	1
4441	FW_pair4441	FakeAnc4441	FakeDesc4441	SIMULPF00001	215	222	245	192	30	23
4442	FW_pair4442	FakeAnc4442	FakeDesc4442	SIMULPF00001	298	266	312	252	14	46
4443	FW_pair4443	FakeAnc4443	FakeDesc4443	SIMULPF00001	218	214	236	196	18	22
4444	FW_pair4444	FakeAnc4444	FakeDesc4444	SIMULPF00001	142	135	149	128	7	14
4445	FW_pair4445	FakeAnc4445	FakeDesc4445	SIMULPF00001	25	27	29	23	4	2
4446	FW_pair4446	FakeAnc4446	FakeDesc4446	SIMULPF00001	343	350	384	309	41	34
4447	FW_pair4447	FakeAnc4447	FakeDesc4447	SIMULPF00001	114	119	127	106	13	8
4448	FW_pair4448	FakeAnc4448	FakeDesc4448	SIMULPF00001	72	72	78	66	6	6
4449	FW_pair4449	FakeAnc4449	FakeDesc4449	SIMULPF00001	286	275	302	259	16	27
4450	FW_pair4450	FakeAnc4450	FakeDesc4450	SIMULPF00001	69	75	80	64	11	5
4451	FW_pair4451	FakeAnc4451	FakeDesc4451	SIMULPF00001	7	8	10	5	3	2
4452	FW_pair4452	FakeAnc4452	FakeDesc4452	SIMULPF00001	313	315	339	289	26	24
4453	FW_pair4453	FakeAnc4453	FakeDesc4453	SIMULPF00001	329	312	353	288	24	41
4454	FW_pair4454	FakeAnc4454	FakeDesc4454	SIMULPF00001	331	346	378	299	47	32
4455	FW_pair4455	FakeAnc4455	FakeDesc4455	SIMULPF00001	510	523	568	465	58	45
4456	FW_pair4456	FakeAnc4456	FakeDesc4456	SIMULPF00001	84	86	94	76	10	8
4457	FW_pair4457	FakeAnc4457	FakeDesc4457	SIMULPF00001	62	61	68	55	6	7
4458	FW_pair4458	FakeAnc4458	FakeDesc4458	SIMULPF00001	335	347	378	304	43	31
4459	FW_pair4459	FakeAnc4459	FakeDesc4459	SIMULPF00001	195	203	220	178	25	17
4460	FW_pair4460	FakeAnc4460	FakeDesc4460	SIMULPF00001	444	466	498	412	54	32
4461	FW_pair4461	FakeAnc4461	FakeDesc4461	SIMULPF00001	390	395	428	357	38	33
4462	FW_pair4462	FakeAnc4462	FakeDesc4462	SIMULPF00001	246	253	271	228	25	18
4463	FW_pair4463	FakeAnc4463	FakeDesc4463	SIMULPF00001	130	127	135	122	5	8
4464	FW_pair4464	FakeAnc4464	FakeDesc4464	SIMULPF00001	172	160	185	147	13	25
4465	FW_pair4465	FakeAnc4465	FakeDesc4465	SIMULPF00001	161	158	176	143	15	18
4466	FW_pair4466	FakeAnc4466	FakeDesc4466	SIMULPF00001	164	171	177	158	13	6
4467	FW_pair4467	FakeAnc4467	FakeDesc4467	SIMULPF00001	44	42	47	39	3	5
4468	FW_pair4468	FakeAnc4468	FakeDesc4468	SIMULPF00001	23	23	28	18	5	5
4469	FW_pair4469	FakeAnc4469	FakeDesc4469	SIMULPF00001	2	2	2	2	0	0
4470	FW_pair4470	FakeAnc4470	FakeDesc4470	SIMULPF00001	165	165	177	153	12	12
4471	FW_pair4471	FakeAnc4471	FakeDesc4471	SIMULPF00001	681	681	751	611	70	70
4472	FW_pair4472	FakeAnc4472	FakeDesc4472	SIMULPF00001	51	52	57	46	6	5
4473	FW_pair4473	FakeAnc4473	FakeDesc4473	SIMULPF00001	283	294	314	263	31	20
4474	FW_pair4474	FakeAnc4474	FakeDesc4474	SIMULPF00001	108	105	113	100	5	8
4475	FW_pair4475	FakeAnc4475	FakeDesc4475	SIMULPF00001	116	126	134	108	18	8
4476	FW_pair4476	FakeAnc4476	FakeDesc4476	SIMULPF00001	30	30	30	30	0	0
4477	FW_pair4477	FakeAnc4477	FakeDesc4477	SIMULPF00001	107	99	111	95	4	12
4478	FW_pair4478	FakeAnc4478	FakeDesc4478	SIMULPF00001	85	78	91	72	6	13
4479	FW_pair4479	FakeAnc4479	FakeDesc4479	SIMULPF00001	353	352	385	320	32	33
4480	FW_pair4480	FakeAnc4480	FakeDesc4480	SIMULPF00001	586	588	646	528	60	58
4481	FW_pair4481	FakeAnc4481	FakeDesc4481	SIMULPF00001	122	112	125	109	3	13
4482	FW_pair4482	FakeAnc4482	FakeDesc4482	SIMULPF00001	257	267	288	236	31	21
4483	FW_pair4483	FakeAnc4483	FakeDesc4483	SIMULPF00001	45	53	53	45	8	0
4484	FW_pair4484	FakeAnc4484	FakeDesc4484	SIMULPF00001	425	406	454	377	29	48
4485	FW_pair4485	FakeAnc4485	FakeDesc4485	SIMULPF00001	133	135	148	120	15	13
4486	FW_pair4486	FakeAnc4486	FakeDesc4486	SIMULPF00001	265	249	277	237	12	28
4487	FW_pair4487	FakeAnc4487	FakeDesc4487	SIMULPF00001	91	89	101	79	10	12
4488	FW_pair4488	FakeAnc4488	FakeDesc4488	SIMULPF00001	321	334	361	294	40	27
4489	FW_pair4489	FakeAnc4489	FakeDesc4489	SIMULPF00001	308	297	333	272	25	36
4490	FW_pair4490	FakeAnc4490	FakeDesc4490	SIMULPF00001	64	69	71	62	7	2
4491	FW_pair4491	FakeAnc4491	FakeDesc4491	SIMULPF00001	297	306	337	266	40	31
4492	FW_pair4492	FakeAnc4492	FakeDesc4492	SIMULPF00001	3	3	3	3	0	0
4493	FW_pair4493	FakeAnc4493	FakeDesc4493	SIMULPF00001	273	274	303	244	30	29
4494	FW_pair4494	FakeAnc4494	FakeDesc4494	SIMULPF00001	106	105	113	98	7	8
4495	FW_pair4495	FakeAnc4495	FakeDesc4495	SIMULPF00001	165	163	181	147	16	18
4496	FW_pair4496	FakeAnc4496	FakeDesc4496	SIMULPF00001	13	10	15	8	2	5
4497	FW_pair4497	FakeAnc4497	FakeDesc4497	SIMULPF00001	3	3	3	3	0	0
4498	FW_pair4498	FakeAnc4498	FakeDesc4498	SIMULPF00001	811	836	908	739	97	72
4499	FW_pair4499	FakeAnc4499	FakeDesc4499	SIMULPF00001	217	225	244	198	27	19
4500	FW_pair4500	FakeAnc4500	FakeDesc4500	SIMULPF00001	45	45	50	40	5	5
4501	FW_pair4501	FakeAnc4501	FakeDesc4501	SIMULPF00001	214	215	233	196	19	18
4502	FW_pair4502	FakeAnc4502	FakeDesc4502	SIMULPF00001	138	129	147	120	9	18
4503	FW_pair4503	FakeAnc4503	FakeDesc4503	SIMULPF00001	62	62	70	54	8	8
4504	FW_pair4504	FakeAnc4504	FakeDesc4504	SIMULPF00001	136	140	144	132	8	4
4505	FW_pair4505	FakeAnc4505	FakeDesc4505	SIMULPF00001	12	13	14	11	2	1
4506	FW_pair4506	FakeAnc4506	FakeDesc4506	SIMULPF00001	248	222	260	210	12	38
4507	FW_pair4507	FakeAnc4507	FakeDesc4507	SIMULPF00001	91	90	98	83	7	8
4508	FW_pair4508	FakeAnc4508	FakeDesc4508	SIMULPF00001	56	54	59	51	3	5
4509	FW_pair4509	FakeAnc4509	FakeDesc4509	SIMULPF00001	98	98	104	92	6	6
4510	FW_pair4510	FakeAnc4510	FakeDesc4510	SIMULPF00001	160	155	173	142	13	18
4511	FW_pair4511	FakeAnc4511	FakeDesc4511	SIMULPF00001	173	170	191	152	18	21
4512	FW_pair4512	FakeAnc4512	FakeDesc4512	SIMULPF00001	49	47	58	38	9	11
4513	FW_pair4513	FakeAnc4513	FakeDesc4513	SIMULPF00001	128	121	137	112	9	16
4514	FW_pair4514	FakeAnc4514	FakeDesc4514	SIMULPF00001	262	246	283	225	21	37
4515	FW_pair4515	FakeAnc4515	FakeDesc4515	SIMULPF00001	344	335	380	299	36	45
4516	FW_pair4516	FakeAnc4516	FakeDesc4516	SIMULPF00001	115	108	124	99	9	16
4517	FW_pair4517	FakeAnc4517	FakeDesc4517	SIMULPF00001	305	318	343	280	38	25
4518	FW_pair4518	FakeAnc4518	FakeDesc4518	SIMULPF00001	9	9	9	9	0	0
4519	FW_pair4519	FakeAnc4519	FakeDesc4519	SIMULPF00001	10	14	15	9	5	1
4520	FW_pair4520	FakeAnc4520	FakeDesc4520	SIMULPF00001	157	144	163	138	6	19
4521	FW_pair4521	FakeAnc4521	FakeDesc4521	SIMULPF00001	21	17	22	16	1	5
4522	FW_pair4522	FakeAnc4522	FakeDesc4522	SIMULPF00001	471	449	509	411	38	60
4523	FW_pair4523	FakeAnc4523	FakeDesc4523	SIMULPF00001	358	343	388	313	30	45
4524	FW_pair4524	FakeAnc4524	FakeDesc4524	SIMULPF00001	235	231	258	208	23	27
4525	FW_pair4525	FakeAnc4525	FakeDesc4525	SIMULPF00001	614	608	675	547	61	67
4526	FW_pair4526	FakeAnc4526	FakeDesc4526	SIMULPF00001	1	1	1	1	0	0
4527	FW_pair4527	FakeAnc4527	FakeDesc4527	SIMULPF00001	160	160	179	141	19	19
4528	FW_pair4528	FakeAnc4528	FakeDesc4528	SIMULPF00001	113	112	124	101	11	12
4529	FW_pair4529	FakeAnc4529	FakeDesc4529	SIMULPF00001	90	96	99	87	9	3
4530	FW_pair4530	FakeAnc4530	FakeDesc4530	SIMULPF00001	637	644	700	581	63	56
4531	FW_pair4531	FakeAnc4531	FakeDesc4531	SIMULPF00001	273	264	299	238	26	35
4532	FW_pair4532	FakeAnc4532	FakeDesc4532	SIMULPF00001	3	2	3	2	0	1
4533	FW_pair4533	FakeAnc4533	FakeDesc4533	SIMULPF00001	258	246	274	230	16	28
4534	FW_pair4534	FakeAnc4534	FakeDesc4534	SIMULPF00001	250	250	269	231	19	19
4535	FW_pair4535	FakeAnc4535	FakeDesc4535	SIMULPF00001	270	278	295	253	25	17
4536	FW_pair4536	FakeAnc4536	FakeDesc4536	SIMULPF00001	510	523	562	471	52	39
4537	FW_pair4537	FakeAnc4537	FakeDesc4537	SIMULPF00001	331	340	376	295	45	36
4538	FW_pair4538	FakeAnc4538	FakeDesc4538	SIMULPF00001	594	611	665	540	71	54
4539	FW_pair4539	FakeAnc4539	FakeDesc4539	SIMULPF00001	138	135	146	127	8	11
4540	FW_pair4540	FakeAnc4540	FakeDesc4540	SIMULPF00001	367	359	397	329	30	38
4541	FW_pair4541	FakeAnc4541	FakeDesc4541	SIMULPF00001	318	334	355	297	37	21
4542	FW_pair4542	FakeAnc4542	FakeDesc4542	SIMULPF00001	11	10	11	10	0	1
4543	FW_pair4543	FakeAnc4543	FakeDesc4543	SIMULPF00001	187	196	207	176	20	11
4544	FW_pair4544	FakeAnc4544	FakeDesc4544	SIMULPF00001	166	155	180	141	14	25
4545	FW_pair4545	FakeAnc4545	FakeDesc4545	SIMULPF00001	648	647	708	587	60	61
4546	FW_pair4546	FakeAnc4546	FakeDesc4546	SIMULPF00001	21	19	21	19	0	2
4547	FW_pair4547	FakeAnc4547	FakeDesc4547	SIMULPF00001	411	407	449	369	38	42
4548	FW_pair4548	FakeAnc4548	FakeDesc4548	SIMULPF00001	97	90	102	85	5	12
4549	FW_pair4549	FakeAnc4549	FakeDesc4549	SIMULPF00001	205	196	221	180	16	25
4550	FW_pair4550	FakeAnc4550	FakeDesc4550	SIMULPF00001	258	258	277	239	19	19
4551	FW_pair4551	FakeAnc4551	FakeDesc4551	SIMULPF00001	233	222	248	207	15	26
4552	FW_pair4552	FakeAnc4552	FakeDesc4552	SIMULPF00001	503	483	547	439	44	64
4553	FW_pair4553	FakeAnc4553	FakeDesc4553	SIMULPF00001	21	24	25	20	4	1
4554	FW_pair4554	FakeAnc4554	FakeDesc4554	SIMULPF00001	91	88	97	82	6	9
4555	FW_pair4555	FakeAnc4555	FakeDesc4555	SIMULPF00001	11	9	11	9	0	2
4556	FW_pair4556	FakeAnc4556	FakeDesc4556	SIMULPF00001	603	605	673	535	70	68
4557	FW_pair4557	FakeAnc4557	FakeDesc4557	SIMULPF00001	77	74	84	67	7	10
4558	FW_pair4558	FakeAnc4558	FakeDesc4558	SIMULPF00001	196	189	208	177	12	19
4559	FW_pair4559	FakeAnc4559	FakeDesc4559	SIMULPF00001	118	127	132	113	14	5
4560	FW_pair4560	FakeAnc4560	FakeDesc4560	SIMULPF00001	8	8	9	7	1	1
4561	FW_pair4561	FakeAnc4561	FakeDesc4561	SIMULPF00001	376	372	406	342	30	34
4562	FW_pair4562	FakeAnc4562	FakeDesc4562	SIMULPF00001	289	300	327	262	38	27
4563	FW_pair4563	FakeAnc4563	FakeDesc4563	SIMULPF00001	2	2	2	2	0	0
4564	FW_pair4564	FakeAnc4564	FakeDesc4564	SIMULPF00001	65	62	69	58	4	7
4565	FW_pair4565	FakeAnc4565	FakeDesc4565	SIMULPF00001	68	61	70	59	2	9
4566	FW_pair4566	FakeAnc4566	FakeDesc4566	SIMULPF00001	137	133	142	128	5	9
4567	FW_pair4567	FakeAnc4567	FakeDesc4567	SIMULPF00001	218	227	242	203	24	15
4568	FW_pair4568	FakeAnc4568	FakeDesc4568	SIMULPF00001	302	328	351	279	49	23
4569	FW_pair4569	FakeAnc4569	FakeDesc4569	SIMULPF00001	157	149	172	134	15	23
4570	FW_pair4570	FakeAnc4570	FakeDesc4570	SIMULPF00001	470	502	544	428	74	42
4571	FW_pair4571	FakeAnc4571	FakeDesc4571	SIMULPF00001	307	299	330	276	23	31
4572	FW_pair4572	FakeAnc4572	FakeDesc4572	SIMULPF00001	96	91	98	89	2	7
4573	FW_pair4573	FakeAnc4573	FakeDesc4573	SIMULPF00001	427	416	457	386	30	41
4574	FW_pair4574	FakeAnc4574	FakeDesc4574	SIMULPF00001	177	176	193	160	16	17
4575	FW_pair4575	FakeAnc4575	FakeDesc4575	SIMULPF00001	153	161	169	145	16	8
4576	FW_pair4576	FakeAnc4576	FakeDesc4576	SIMULPF00001	690	690	756	624	66	66
4577	FW_pair4577	FakeAnc4577	FakeDesc4577	SIMULPF00001	175	180	199	156	24	19
4578	FW_pair4578	FakeAnc4578	FakeDesc4578	SIMULPF00001	135	137	148	124	13	11
4579	FW_pair4579	FakeAnc4579	FakeDesc4579	SIMULPF00001	139	149	164	124	25	15
4580	FW_pair4580	FakeAnc4580	FakeDesc4580	SIMULPF00001	223	212	236	199	13	24
4581	FW_pair4581	FakeAnc4581	FakeDesc4581	SIMULPF00001	187	183	209	161	22	26
4582	FW_pair4582	FakeAnc4582	FakeDesc4582	SIMULPF00001	352	351	388	315	36	37
4583	FW_pair4583	FakeAnc4583	FakeDesc4583	SIMULPF00001	340	339	377	302	37	38
4584	FW_pair4584	FakeAnc4584	FakeDesc4584	SIMULPF00001	134	131	144	121	10	13
4585	FW_pair4585	FakeAnc4585	FakeDesc4585	SIMULPF00001	8	6	8	6	0	2
4586	FW_pair4586	FakeAnc4586	FakeDesc4586	SIMULPF00001	420	427	466	381	46	39
4587	FW_pair4587	FakeAnc4587	FakeDesc4587	SIMULPF00001	197	194	208	183	11	14
4588	FW_pair4588	FakeAnc4588	FakeDesc4588	SIMULPF00001	285	284	305	264	20	21
4589	FW_pair4589	FakeAnc4589	FakeDesc4589	SIMULPF00001	692	726	782	636	90	56
4590	FW_pair4590	FakeAnc4590	FakeDesc4590	SIMULPF00001	235	237	260	212	25	23
4591	FW_pair4591	FakeAnc4591	FakeDesc4591	SIMULPF00001	22	26	27	21	5	1
4592	FW_pair4592	FakeAnc4592	FakeDesc4592	SIMULPF00001	24	24	27	21	3	3
4593	FW_pair4593	FakeAnc4593	FakeDesc4593	SIMULPF00001	64	66	74	56	10	8
4594	FW_pair4594	FakeAnc4594	FakeDesc4594	SIMULPF00001	94	93	100	87	6	7
4595	FW_pair4595	FakeAnc4595	FakeDesc4595	SIMULPF00001	175	178	199	154	24	21
4596	FW_pair4596	FakeAnc4596	FakeDesc4596	SIMULPF00001	50	48	53	45	3	5
4597	FW_pair4597	FakeAnc4597	FakeDesc4597	SIMULPF00001	259	275	295	239	36	20
4598	FW_pair4598	FakeAnc4598	FakeDesc4598	SIMULPF00001	42	42	46	38	4	4
4599	FW_pair4599	FakeAnc4599	FakeDesc4599	SIMULPF00001	102	94	106	90	4	12
4600	FW_pair4600	FakeAnc4600	FakeDesc4600	SIMULPF00001	152	155	169	138	17	14
4601	FW_pair4601	FakeAnc4601	FakeDesc4601	SIMULPF00001	101	92	112	81	11	20
4602	FW_pair4602	FakeAnc4602	FakeDesc4602	SIMULPF00001	523	519	566	476	43	47
4603	FW_pair4603	FakeAnc4603	FakeDesc4603	SIMULPF00001	290	291	326	255	36	35
4604	FW_pair4604	FakeAnc4604	FakeDesc4604	SIMULPF00001	40	38	43	35	3	5
4605	FW_pair4605	FakeAnc4605	FakeDesc4605	SIMULPF00001	677	688	744	621	67	56
4606	FW_pair4606	FakeAnc4606	FakeDesc4606	SIMULPF00001	307	298	333	272	26	35
4607	FW_pair4607	FakeAnc4607	FakeDesc4607	SIMULPF00001	89	87	92	84	3	5
4608	FW_pair4608	FakeAnc4608	FakeDesc4608	SIMULPF00001	218	212	231	199	13	19
4609	FW_pair4609	FakeAnc4609	FakeDesc4609	SIMULPF00001	479	475	522	432	43	47
4610	FW_pair4610	FakeAnc4610	FakeDesc4610	SIMULPF00001	18	18	18	18	0	0
4611	FW_pair4611	FakeAnc4611	FakeDesc4611	SIMULPF00001	59	61	68	52	9	7
4612	FW_pair4612	FakeAnc4612	FakeDesc4612	SIMULPF00001	19	21	21	19	2	0
4613	FW_pair4613	FakeAnc4613	FakeDesc4613	SIMULPF00001	153	143	163	133	10	20
4614	FW_pair4614	FakeAnc4614	FakeDesc4614	SIMULPF00001	142	138	155	125	13	17
4615	FW_pair4615	FakeAnc4615	FakeDesc4615	SIMULPF00001	30	35	37	28	7	2
4616	FW_pair4616	FakeAnc4616	FakeDesc4616	SIMULPF00001	73	69	77	65	4	8
4617	FW_pair4617	FakeAnc4617	FakeDesc4617	SIMULPF00001	417	405	446	376	29	41
4618	FW_pair4618	FakeAnc4618	FakeDesc4618	SIMULPF00001	291	291	322	260	31	31
4619	FW_pair4619	FakeAnc4619	FakeDesc4619	SIMULPF00001	276	272	296	252	20	24
4620	FW_pair4620	FakeAnc4620	FakeDesc4620	SIMULPF00001	103	108	115	96	12	7
4621	FW_pair4621	FakeAnc4621	FakeDesc4621	SIMULPF00001	118	117	127	108	9	10
4622	FW_pair4622	FakeAnc4622	FakeDesc4622	SIMULPF00001	26	27	31	22	5	4
4623	FW_pair4623	FakeAnc4623	FakeDesc4623	SIMULPF00001	141	134	149	126	8	15
4624	FW_pair4624	FakeAnc4624	FakeDesc4624	SIMULPF00001	361	370	395	336	34	25
4625	FW_pair4625	FakeAnc4625	FakeDesc4625	SIMULPF00001	81	95	100	76	19	5
4626	FW_pair4626	FakeAnc4626	FakeDesc4626	SIMULPF00001	55	54	58	51	3	4
4627	FW_pair4627	FakeAnc4627	FakeDesc4627	SIMULPF00001	175	175	193	157	18	18
4628	FW_pair4628	FakeAnc4628	FakeDesc4628	SIMULPF00001	105	104	112	97	7	8
4629	FW_pair4629	FakeAnc4629	FakeDesc4629	SIMULPF00001	80	75	83	72	3	8
4630	FW_pair4630	FakeAnc4630	FakeDesc4630	SIMULPF00001	260	260	284	236	24	24
4631	FW_pair4631	FakeAnc4631	FakeDesc4631	SIMULPF00001	132	130	142	120	10	12
4632	FW_pair4632	FakeAnc4632	FakeDesc4632	SIMULPF00001	377	382	422	337	45	40
4633	FW_pair4633	FakeAnc4633	FakeDesc4633	SIMULPF00001	370	380	418	332	48	38
4634	FW_pair4634	FakeAnc4634	FakeDesc4634	SIMULPF00001	198	192	215	175	17	23
4635	FW_pair4635	FakeAnc4635	FakeDesc4635	SIMULPF00001	738	724	806	656	68	82
4636	FW_pair4636	FakeAnc4636	FakeDesc4636	SIMULPF00001	213	209	225	197	12	16
4637	FW_pair4637	FakeAnc4637	FakeDesc4637	SIMULPF00001	30	34	35	29	5	1
4638	FW_pair4638	FakeAnc4638	FakeDesc4638	SIMULPF00001	538	524	573	489	35	49
4639	FW_pair4639	FakeAnc4639	FakeDesc4639	SIMULPF00001	342	347	377	312	35	30
4640	FW_pair4640	FakeAnc4640	FakeDesc4640	SIMULPF00001	228	217	251	194	23	34
4641	FW_pair4641	FakeAnc4641	FakeDesc4641	SIMULPF00001	144	141	151	134	7	10
4642	FW_pair4642	FakeAnc4642	FakeDesc4642	SIMULPF00001	31	29	33	27	2	4
4643	FW_pair4643	FakeAnc4643	FakeDesc4643	SIMULPF00001	118	112	126	104	8	14
4644	FW_pair4644	FakeAnc4644	FakeDesc4644	SIMULPF00001	74	78	86	66	12	8
4645	FW_pair4645	FakeAnc4645	FakeDesc4645	SIMULPF00001	361	351	395	317	34	44
4646	FW_pair4646	FakeAnc4646	FakeDesc4646	SIMULPF00001	184	183	198	169	14	15
4647	FW_pair4647	FakeAnc4647	FakeDesc4647	SIMULPF00001	398	406	441	363	43	35
4648	FW_pair4648	FakeAnc4648	FakeDesc4648	SIMULPF00001	229	230	248	211	19	18
4649	FW_pair4649	FakeAnc4649	FakeDesc4649	SIMULPF00001	4	7	7	4	3	0
4650	FW_pair4650	FakeAnc4650	FakeDesc4650	SIMULPF00001	323	318	349	292	26	31
4651	FW_pair4651	FakeAnc4651	FakeDesc4651	SIMULPF00001	72	71	78	65	6	7
4652	FW_pair4652	FakeAnc4652	FakeDesc4652	SIMULPF00001	408	407	442	373	34	35
4653	FW_pair4653	FakeAnc4653	FakeDesc4653	SIMULPF00001	466	472	513	425	47	41
4654	FW_pair4654	FakeAnc4654	FakeDesc4654	SIMULPF00001	461	460	504	417	43	44
4655	FW_pair4655	FakeAnc4655	FakeDesc4655	SIMULPF00001	167	162	178	151	11	16
4656	FW_pair4656	FakeAnc4656	FakeDesc4656	SIMULPF00001	9	9	9	9	0	0
4657	FW_pair4657	FakeAnc4657	FakeDesc4657	SIMULPF00001	27	28	31	24	4	3
4658	FW_pair4658	FakeAnc4658	FakeDesc4658	SIMULPF00001	251	230	266	215	15	36
4659	FW_pair4659	FakeAnc4659	FakeDesc4659	SIMULPF00001	5	4	5	4	0	1
4660	FW_pair4660	FakeAnc4660	FakeDesc4660	SIMULPF00001	43	40	45	38	2	5
4661	FW_pair4661	FakeAnc4661	FakeDesc4661	SIMULPF00001	73	73	77	69	4	4
4662	FW_pair4662	FakeAnc4662	FakeDesc4662	SIMULPF00001	183	176	201	158	18	25
4663	FW_pair4663	FakeAnc4663	FakeDesc4663	SIMULPF00001	94	89	101	82	7	12
4664	FW_pair4664	FakeAnc4664	FakeDesc4664	SIMULPF00001	160	160	173	147	13	13
4665	FW_pair4665	FakeAnc4665	FakeDesc4665	SIMULPF00001	26	25	26	25	0	1
4666	FW_pair4666	FakeAnc4666	FakeDesc4666	SIMULPF00001	95	94	100	89	5	6
4667	FW_pair4667	FakeAnc4667	FakeDesc4667	SIMULPF00001	16	14	17	13	1	3
4668	FW_pair4668	FakeAnc4668	FakeDesc4668	SIMULPF00001	3	3	3	3	0	0
4669	FW_pair4669	FakeAnc4669	FakeDesc4669	SIMULPF00001	24	31	31	24	7	0
4670	FW_pair4670	FakeAnc4670	FakeDesc4670	SIMULPF00001	448	460	491	417	43	31
4671	FW_pair4671	FakeAnc4671	FakeDesc4671	SIMULPF00001	214	207	230	191	16	23
4672	FW_pair4672	FakeAnc4672	FakeDesc4672	SIMULPF00001	145	147	157	135	12	10
4673	FW_pair4673	FakeAnc4673	FakeDesc4673	SIMULPF00001	273	275	300	248	27	25
4674	FW_pair4674	FakeAnc4674	FakeDesc4674	SIMULPF00001	28	32	32	28	4	0
4675	FW_pair4675	FakeAnc4675	FakeDesc4675	SIMULPF00001	98	102	110	90	12	8
4676	FW_pair4676	FakeAnc4676	FakeDesc4676	SIMULPF00001	26	25	27	24	1	2
4677	FW_pair4677	FakeAnc4677	FakeDesc4677	SIMULPF00001	60	63	68	55	8	5
4678	FW_pair4678	FakeAnc4678	FakeDesc4678	SIMULPF00001	129	136	143	122	14	7
4679	FW_pair4679	FakeAnc4679	FakeDesc4679	SIMULPF00001	184	179	200	163	16	21
4680	FW_pair4680	FakeAnc4680	FakeDesc4680	SIMULPF00001	219	219	233	205	14	14
4681	FW_pair4681	FakeAnc4681	FakeDesc4681	SIMULPF00001	175	159	186	148	11	27
4682	FW_pair4682	FakeAnc4682	FakeDesc4682	SIMULPF00001	272	272	299	245	27	27
4683	FW_pair4683	FakeAnc4683	FakeDesc4683	SIMULPF00001	268	276	300	244	32	24
4684	FW_pair4684	FakeAnc4684	FakeDesc4684	SIMULPF00001	537	550	603	484	66	53
4685	FW_pair4685	FakeAnc4685	FakeDesc4685	SIMULPF00001	113	119	126	106	13	7
4686	FW_pair4686	FakeAnc4686	FakeDesc4686	SIMULPF00001	431	447	482	396	51	35
4687	FW_pair4687	FakeAnc4687	FakeDesc4687	SIMULPF00001	230	222	244	208	14	22
4688	FW_pair4688	FakeAnc4688	FakeDesc4688	SIMULPF00001	147	152	163	136	16	11
4689	FW_pair4689	FakeAnc4689	FakeDesc4689	SIMULPF00001	92	88	98	82	6	10
4690	FW_pair4690	FakeAnc4690	FakeDesc4690	SIMULPF00001	155	159	167	147	12	8
4691	FW_pair4691	FakeAnc4691	FakeDesc4691	SIMULPF00001	287	277	303	261	16	26
4692	FW_pair4692	FakeAnc4692	FakeDesc4692	SIMULPF00001	447	439	492	394	45	53
4693	FW_pair4693	FakeAnc4693	FakeDesc4693	SIMULPF00001	185	169	195	159	10	26
4694	FW_pair4694	FakeAnc4694	FakeDesc4694	SIMULPF00001	172	170	193	149	21	23
4695	FW_pair4695	FakeAnc4695	FakeDesc4695	SIMULPF00001	581	608	656	533	75	48
4696	FW_pair4696	FakeAnc4696	FakeDesc4696	SIMULPF00001	37	35	39	33	2	4
4697	FW_pair4697	FakeAnc4697	FakeDesc4697	SIMULPF00001	31	29	31	29	0	2
4698	FW_pair4698	FakeAnc4698	FakeDesc4698	SIMULPF00001	221	215	239	197	18	24
4699	FW_pair4699	FakeAnc4699	FakeDesc4699	SIMULPF00001	117	120	128	109	11	8
4700	FW_pair4700	FakeAnc4700	FakeDesc4700	SIMULPF00001	331	322	358	295	27	36
4701	FW_pair4701	FakeAnc4701	FakeDesc4701	SIMULPF00001	88	78	93	73	5	15
4702	FW_pair4702	FakeAnc4702	FakeDesc4702	SIMULPF00001	99	94	104	89	5	10
4703	FW_pair4703	FakeAnc4703	FakeDesc4703	SIMULPF00001	98	96	110	84	12	14
4704	FW_pair4704	FakeAnc4704	FakeDesc4704	SIMULPF00001	797	802	868	731	71	66
4705	FW_pair4705	FakeAnc4705	FakeDesc4705	SIMULPF00001	238	234	251	221	13	17
4706	FW_pair4706	FakeAnc4706	FakeDesc4706	SIMULPF00001	481	485	521	445	40	36
4707	FW_pair4707	FakeAnc4707	FakeDesc4707	SIMULPF00001	164	152	174	142	10	22
4708	FW_pair4708	FakeAnc4708	FakeDesc4708	SIMULPF00001	28	27	31	24	3	4
4709	FW_pair4709	FakeAnc4709	FakeDesc4709	SIMULPF00001	425	433	464	394	39	31
4710	FW_pair4710	FakeAnc4710	FakeDesc4710	SIMULPF00001	417	436	471	382	54	35
4711	FW_pair4711	FakeAnc4711	FakeDesc4711	SIMULPF00001	112	117	128	101	16	11
4712	FW_pair4712	FakeAnc4712	FakeDesc4712	SIMULPF00001	31	30	32	29	1	2
4713	FW_pair4713	FakeAnc4713	FakeDesc4713	SIMULPF00001	35	33	37	31	2	4
4714	FW_pair4714	FakeAnc4714	FakeDesc4714	SIMULPF00001	41	47	50	38	9	3
4715	FW_pair4715	FakeAnc4715	FakeDesc4715	SIMULPF00001	49	56	58	47	9	2
4716	FW_pair4716	FakeAnc4716	FakeDesc4716	SIMULPF00001	7	6	7	6	0	1
4717	FW_pair4717	FakeAnc4717	FakeDesc4717	SIMULPF00001	53	49	57	45	4	8
4718	FW_pair4718	FakeAnc4718	FakeDesc4718	SIMULPF00001	471	486	523	434	52	37
4719	FW_pair4719	FakeAnc4719	FakeDesc4719	SIMULPF00001	521	529	575	475	54	46
4720	FW_pair4720	FakeAnc4720	FakeDesc4720	SIMULPF00001	19	23	24	18	5	1
4721	FW_pair4721	FakeAnc4721	FakeDesc4721	SIMULPF00001	57	63	66	54	9	3
4722	FW_pair4722	FakeAnc4722	FakeDesc4722	SIMULPF00001	74	73	81	66	7	8
4723	FW_pair4723	FakeAnc4723	FakeDesc4723	SIMULPF00001	183	180	202	161	19	22
4724	FW_pair4724	FakeAnc4724	FakeDesc4724	SIMULPF00001	197	217	229	185	32	12
4725	FW_pair4725	FakeAnc4725	FakeDesc4725	SIMULPF00001	21	21	26	16	5	5
4726	FW_pair4726	FakeAnc4726	FakeDesc4726	SIMULPF00001	42	39	45	36	3	6
4727	FW_pair4727	FakeAnc4727	FakeDesc4727	SIMULPF00001	64	66	71	59	7	5
4728	FW_pair4728	FakeAnc4728	FakeDesc4728	SIMULPF00001	5	9	10	4	5	1
4729	FW_pair4729	FakeAnc4729	FakeDesc4729	SIMULPF00001	392	392	421	363	29	29
4730	FW_pair4730	FakeAnc4730	FakeDesc4730	SIMULPF00001	105	114	121	98	16	7
4731	FW_pair4731	FakeAnc4731	FakeDesc4731	SIMULPF00001	151	146	163	134	12	17
4732	FW_pair4732	FakeAnc4732	FakeDesc4732	SIMULPF00001	79	78	90	67	11	12
4733	FW_pair4733	FakeAnc4733	FakeDesc4733	SIMULPF00001	359	350	395	314	36	45
4734	FW_pair4734	FakeAnc4734	FakeDesc4734	SIMULPF00001	330	340	367	303	37	27
4735	FW_pair4735	FakeAnc4735	FakeDesc4735	SIMULPF00001	556	562	614	504	58	52
4736	FW_pair4736	FakeAnc4736	FakeDesc4736	SIMULPF00001	66	65	73	58	7	8
4737	FW_pair4737	FakeAnc4737	FakeDesc4737	SIMULPF00001	14	14	16	12	2	2
4738	FW_pair4738	FakeAnc4738	FakeDesc4738	SIMULPF00001	99	104	108	95	9	4
4739	FW_pair4739	FakeAnc4739	FakeDesc4739	SIMULPF00001	207	215	232	190	25	17
4740	FW_pair4740	FakeAnc4740	FakeDesc4740	SIMULPF00001	145	144	159	130	14	15
4741	FW_pair4741	FakeAnc4741	FakeDesc4741	SIMULPF00001	9	11	11	9	2	0
4742	FW_pair4742	FakeAnc4742	FakeDesc4742	SIMULPF00001	115	114	121	108	6	7
4743	FW_pair4743	FakeAnc4743	FakeDesc4743	SIMULPF00001	96	106	111	91	15	5
4744	FW_pair4744	FakeAnc4744	FakeDesc4744	SIMULPF00001	519	520	570	469	51	50
4745	FW_pair4745	FakeAnc4745	FakeDesc4745	SIMULPF00001	126	127	140	113	14	13
4746	FW_pair4746	FakeAnc4746	FakeDesc4746	SIMULPF00001	88	86	96	78	8	10
4747	FW_pair4747	FakeAnc4747	FakeDesc4747	SIMULPF00001	189	190	209	170	20	19
4748	FW_pair4748	FakeAnc4748	FakeDesc4748	SIMULPF00001	373	369	405	337	32	36
4749	FW_pair4749	FakeAnc4749	FakeDesc4749	SIMULPF00001	185	180	197	168	12	17
4750	FW_pair4750	FakeAnc4750	FakeDesc4750	SIMULPF00001	21	19	21	19	0	2
4751	FW_pair4751	FakeAnc4751	FakeDesc4751	SIMULPF00001	8	11	11	8	3	0
4752	FW_pair4752	FakeAnc4752	FakeDesc4752	SIMULPF00001	276	275	299	252	23	24
4753	FW_pair4753	FakeAnc4753	FakeDesc4753	SIMULPF00001	430	431	468	393	38	37
4754	FW_pair4754	FakeAnc4754	FakeDesc4754	SIMULPF00001	326	328	358	296	32	30
4755	FW_pair4755	FakeAnc4755	FakeDesc4755	SIMULPF00001	460	468	507	421	47	39
4756	FW_pair4756	FakeAnc4756	FakeDesc4756	SIMULPF00001	251	226	262	215	11	36
4757	FW_pair4757	FakeAnc4757	FakeDesc4757	SIMULPF00001	53	53	58	48	5	5
4758	FW_pair4758	FakeAnc4758	FakeDesc4758	SIMULPF00001	209	190	224	175	15	34
4759	FW_pair4759	FakeAnc4759	FakeDesc4759	SIMULPF00001	46	46	50	42	4	4
4760	FW_pair4760	FakeAnc4760	FakeDesc4760	SIMULPF00001	123	125	130	118	7	5
4761	FW_pair4761	FakeAnc4761	FakeDesc4761	SIMULPF00001	11	12	12	11	1	0
4762	FW_pair4762	FakeAnc4762	FakeDesc4762	SIMULPF00001	46	51	52	45	6	1
4763	FW_pair4763	FakeAnc4763	FakeDesc4763	SIMULPF00001	110	107	117	100	7	10
4764	FW_pair4764	FakeAnc4764	FakeDesc4764	SIMULPF00001	730	740	803	667	73	63
4765	FW_pair4765	FakeAnc4765	FakeDesc4765	SIMULPF00001	359	366	394	331	35	28
4766	FW_pair4766	FakeAnc4766	FakeDesc4766	SIMULPF00001	10	10	10	10	0	0
4767	FW_pair4767	FakeAnc4767	FakeDesc4767	SIMULPF00001	44	44	45	43	1	1
4768	FW_pair4768	FakeAnc4768	FakeDesc4768	SIMULPF00001	389	390	435	344	46	45
4769	FW_pair4769	FakeAnc4769	FakeDesc4769	SIMULPF00001	213	221	245	189	32	24
4770	FW_pair4770	FakeAnc4770	FakeDesc4770	SIMULPF00001	439	456	488	407	49	32
4771	FW_pair4771	FakeAnc4771	FakeDesc4771	SIMULPF00001	236	236	254	218	18	18
4772	FW_pair4772	FakeAnc4772	FakeDesc4772	SIMULPF00001	24	23	25	22	1	2
4773	FW_pair4773	FakeAnc4773	FakeDesc4773	SIMULPF00001	471	463	503	431	32	40
4774	FW_pair4774	FakeAnc4774	FakeDesc4774	SIMULPF00001	460	442	491	411	31	49
4775	FW_pair4775	FakeAnc4775	FakeDesc4775	SIMULPF00001	60	63	67	56	7	4
4776	FW_pair4776	FakeAnc4776	FakeDesc4776	SIMULPF00001	313	302	337	278	24	35
4777	FW_pair4777	FakeAnc4777	FakeDesc4777	SIMULPF00001	101	102	110	93	9	8
4778	FW_pair4778	FakeAnc4778	FakeDesc4778	SIMULPF00001	296	303	320	279	24	17
4779	FW_pair4779	FakeAnc4779	FakeDesc4779	SIMULPF00001	10	10	11	9	1	1
4780	FW_pair4780	FakeAnc4780	FakeDesc4780	SIMULPF00001	426	437	480	383	54	43
4781	FW_pair4781	FakeAnc4781	FakeDesc4781	SIMULPF00001	498	498	542	454	44	44
4782	FW_pair4782	FakeAnc4782	FakeDesc4782	SIMULPF00001	144	134	156	122	12	22
4783	FW_pair4783	FakeAnc4783	FakeDesc4783	SIMULPF00001	100	104	111	93	11	7
4784	FW_pair4784	FakeAnc4784	FakeDesc4784	SIMULPF00001	519	528	571	476	52	43
4785	FW_pair4785	FakeAnc4785	FakeDesc4785	SIMULPF00001	192	203	217	178	25	14
4786	FW_pair4786	FakeAnc4786	FakeDesc4786	SIMULPF00001	24	24	27	21	3	3
4787	FW_pair4787	FakeAnc4787	FakeDesc4787	SIMULPF00001	369	384	413	340	44	29
4788	FW_pair4788	FakeAnc4788	FakeDesc4788	SIMULPF00001	69	76	83	62	14	7
4789	FW_pair4789	FakeAnc4789	FakeDesc4789	SIMULPF00001	97	105	114	88	17	9
4790	FW_pair4790	FakeAnc4790	FakeDesc4790	SIMULPF00001	205	206	232	179	27	26
4791	FW_pair4791	FakeAnc4791	FakeDesc4791	SIMULPF00001	20	20	20	20	0	0
4792	FW_pair4792	FakeAnc4792	FakeDesc4792	SIMULPF00001	75	68	80	63	5	12
4793	FW_pair4793	FakeAnc4793	FakeDesc4793	SIMULPF00001	189	198	218	169	29	20
4794	FW_pair4794	FakeAnc4794	FakeDesc4794	SIMULPF00001	21	21	22	20	1	1
4795	FW_pair4795	FakeAnc4795	FakeDesc4795	SIMULPF00001	165	169	177	157	12	8
4796	FW_pair4796	FakeAnc4796	FakeDesc4796	SIMULPF00001	214	211	237	188	23	26
4797	FW_pair4797	FakeAnc4797	FakeDesc4797	SIMULPF00001	62	61	70	53	8	9
4798	FW_pair4798	FakeAnc4798	FakeDesc4798	SIMULPF00001	243	237	268	212	25	31
4799	FW_pair4799	FakeAnc4799	FakeDesc4799	SIMULPF00001	468	458	506	420	38	48
4800	FW_pair4800	FakeAnc4800	FakeDesc4800	SIMULPF00001	228	239	257	210	29	18
4801	FW_pair4801	FakeAnc4801	FakeDesc4801	SIMULPF00001	144	137	156	125	12	19
4802	FW_pair4802	FakeAnc4802	FakeDesc4802	SIMULPF00001	288	299	318	269	30	19
4803	FW_pair4803	FakeAnc4803	FakeDesc4803	SIMULPF00001	242	239	261	220	19	22
4804	FW_pair4804	FakeAnc4804	FakeDesc4804	SIMULPF00001	372	352	402	322	30	50
4805	FW_pair4805	FakeAnc4805	FakeDesc4805	SIMULPF00001	241	246	265	222	24	19
4806	FW_pair4806	FakeAnc4806	FakeDesc4806	SIMULPF00001	159	149	176	132	17	27
4807	FW_pair4807	FakeAnc4807	FakeDesc4807	SIMULPF00001	89	93	98	84	9	5
4808	FW_pair4808	FakeAnc4808	FakeDesc4808	SIMULPF00001	216	214	238	192	22	24
4809	FW_pair4809	FakeAnc4809	FakeDesc4809	SIMULPF00001	556	566	620	502	64	54
4810	FW_pair4810	FakeAnc4810	FakeDesc4810	SIMULPF00001	203	203	221	185	18	18
4811	FW_pair4811	FakeAnc4811	FakeDesc4811	SIMULPF00001	185	195	214	166	29	19
4812	FW_pair4812	FakeAnc4812	FakeDesc4812	SIMULPF00001	41	38	42	37	1	4
4813	FW_pair4813	FakeAnc4813	FakeDesc4813	SIMULPF00001	191	186	212	165	21	26
4814	FW_pair4814	FakeAnc4814	FakeDesc4814	SIMULPF00001	525	522	571	476	46	49
4815	FW_pair4815	FakeAnc4815	FakeDesc4815	SIMULPF00001	243	256	274	225	31	18
4816	FW_pair4816	FakeAnc4816	FakeDesc4816	SIMULPF00001	82	82	89	75	7	7
4817	FW_pair4817	FakeAnc4817	FakeDesc4817	SIMULPF00001	844	844	912	776	68	68
4818	FW_pair4818	FakeAnc4818	FakeDesc4818	SIMULPF00001	172	168	187	153	15	19
4819	FW_pair4819	FakeAnc4819	FakeDesc4819	SIMULPF00001	7	7	8	6	1	1
4820	FW_pair4820	FakeAnc4820	FakeDesc4820	SIMULPF00001	100	107	117	90	17	10
4821	FW_pair4821	FakeAnc4821	FakeDesc4821	SIMULPF00001	45	49	51	43	6	2
4822	FW_pair4822	FakeAnc4822	FakeDesc4822	SIMULPF00001	44	45	47	42	3	2
4823	FW_pair4823	FakeAnc4823	FakeDesc4823	SIMULPF00001	369	378	414	333	45	36
4824	FW_pair4824	FakeAnc4824	FakeDesc4824	SIMULPF00001	358	359	391	326	33	32
4825	FW_pair4825	FakeAnc4825	FakeDesc4825	SIMULPF00001	195	205	221	179	26	16
4826	FW_pair4826	FakeAnc4826	FakeDesc4826	SIMULPF00001	241	239	270	210	29	31
4827	FW_pair4827	FakeAnc4827	FakeDesc4827	SIMULPF00001	321	324	352	293	31	28
4828	FW_pair4828	FakeAnc4828	FakeDesc4828	SIMULPF00001	569	563	612	520	43	49
4829	FW_pair4829	FakeAnc4829	FakeDesc4829	SIMULPF00001	46	47	52	41	6	5
4830	FW_pair4830	FakeAnc4830	FakeDesc4830	SIMULPF00001	136	139	146	129	10	7
4831	FW_pair4831	FakeAnc4831	FakeDesc4831	SIMULPF00001	105	102	113	94	8	11
4832	FW_pair4832	FakeAnc4832	FakeDesc4832	SIMULPF00001	166	166	187	145	21	21
4833	FW_pair4833	FakeAnc4833	FakeDesc4833	SIMULPF00001	61	61	70	52	9	9
4834	FW_pair4834	FakeAnc4834	FakeDesc4834	SIMULPF00001	357	343	387	313	30	44
4835	FW_pair4835	FakeAnc4835	FakeDesc4835	SIMULPF00001	303	309	327	285	24	18
4836	FW_pair4836	FakeAnc4836	FakeDesc4836	SIMULPF00001	140	139	149	130	9	10
4837	FW_pair4837	FakeAnc4837	FakeDesc4837	SIMULPF00001	52	53	55	50	3	2
4838	FW_pair4838	FakeAnc4838	FakeDesc4838	SIMULPF00001	694	696	763	627	69	67
4839	FW_pair4839	FakeAnc4839	FakeDesc4839	SIMULPF00001	313	312	342	283	29	30
4840	FW_pair4840	FakeAnc4840	FakeDesc4840	SIMULPF00001	108	115	123	100	15	8
4841	FW_pair4841	FakeAnc4841	FakeDesc4841	SIMULPF00001	13	13	13	13	0	0
4842	FW_pair4842	FakeAnc4842	FakeDesc4842	SIMULPF00001	160	150	166	144	6	16
4843	FW_pair4843	FakeAnc4843	FakeDesc4843	SIMULPF00001	33	33	35	31	2	2
4844	FW_pair4844	FakeAnc4844	FakeDesc4844	SIMULPF00001	346	346	379	313	33	33
4845	FW_pair4845	FakeAnc4845	FakeDesc4845	SIMULPF00001	236	245	263	218	27	18
4846	FW_pair4846	FakeAnc4846	FakeDesc4846	SIMULPF00001	318	310	343	285	25	33
4847	FW_pair4847	FakeAnc4847	FakeDesc4847	SIMULPF00001	32	35	35	32	3	0
4848	FW_pair4848	FakeAnc4848	FakeDesc4848	SIMULPF00001	22	24	25	21	3	1
4849	FW_pair4849	FakeAnc4849	FakeDesc4849	SIMULPF00001	187	185	201	171	14	16
4850	FW_pair4850	FakeAnc4850	FakeDesc4850	SIMULPF00001	45	49	51	43	6	2
4851	FW_pair4851	FakeAnc4851	FakeDesc4851	SIMULPF00001	107	101	116	92	9	15
4852	FW_pair4852	FakeAnc4852	FakeDesc4852	SIMULPF00001	367	359	394	332	27	35
4853	FW_pair4853	FakeAnc4853	FakeDesc4853	SIMULPF00001	677	706	763	620	86	57
4854	FW_pair4854	FakeAnc4854	FakeDesc4854	SIMULPF00001	209	195	220	184	11	25
4855	FW_pair4855	FakeAnc4855	FakeDesc4855	SIMULPF00001	197	215	226	186	29	11
4856	FW_pair4856	FakeAnc4856	FakeDesc4856	SIMULPF00001	22	21	23	20	1	2
4857	FW_pair4857	FakeAnc4857	FakeDesc4857	SIMULPF00001	44	44	46	42	2	2
4858	FW_pair4858	FakeAnc4858	FakeDesc4858	SIMULPF00001	27	29	29	27	2	0
4859	FW_pair4859	FakeAnc4859	FakeDesc4859	SIMULPF00001	395	383	424	354	29	41
4860	FW_pair4860	FakeAnc4860	FakeDesc4860	SIMULPF00001	463	466	506	423	43	40
4861	FW_pair4861	FakeAnc4861	FakeDesc4861	SIMULPF00001	90	74	93	71	3	19
4862	FW_pair4862	FakeAnc4862	FakeDesc4862	SIMULPF00001	45	44	48	41	3	4
4863	FW_pair4863	FakeAnc4863	FakeDesc4863	SIMULPF00001	288	280	312	256	24	32
4864	FW_pair4864	FakeAnc4864	FakeDesc4864	SIMULPF00001	323	337	369	291	46	32
4865	FW_pair4865	FakeAnc4865	FakeDesc4865	SIMULPF00001	21	21	22	20	1	1
4866	FW_pair4866	FakeAnc4866	FakeDesc4866	SIMULPF00001	151	156	162	145	11	6
4867	FW_pair4867	FakeAnc4867	FakeDesc4867	SIMULPF00001	78	85	90	73	12	5
4868	FW_pair4868	FakeAnc4868	FakeDesc4868	SIMULPF00001	242	236	261	217	19	25
4869	FW_pair4869	FakeAnc4869	FakeDesc4869	SIMULPF00001	115	113	131	97	16	18
4870	FW_pair4870	FakeAnc4870	FakeDesc4870	SIMULPF00001	386	385	425	346	39	40
4871	FW_pair4871	FakeAnc4871	FakeDesc4871	SIMULPF00001	272	260	292	240	20	32
4872	FW_pair4872	FakeAnc4872	FakeDesc4872	SIMULPF00001	382	399	417	364	35	18
4873	FW_pair4873	FakeAnc4873	FakeDesc4873	SIMULPF00001	521	524	582	463	61	58
4874	FW_pair4874	FakeAnc4874	FakeDesc4874	SIMULPF00001	196	206	220	182	24	14
4875	FW_pair4875	FakeAnc4875	FakeDesc4875	SIMULPF00001	420	418	454	384	34	36
4876	FW_pair4876	FakeAnc4876	FakeDesc4876	SIMULPF00001	197	193	210	180	13	17
4877	FW_pair4877	FakeAnc4877	FakeDesc4877	SIMULPF00001	581	576	617	540	36	41
4878	FW_pair4878	FakeAnc4878	FakeDesc4878	SIMULPF00001	81	80	90	71	9	10
4879	FW_pair4879	FakeAnc4879	FakeDesc4879	SIMULPF00001	458	440	501	397	43	61
4880	FW_pair4880	FakeAnc4880	FakeDesc4880	SIMULPF00001	77	80	84	73	7	4
4881	FW_pair4881	FakeAnc4881	FakeDesc4881	SIMULPF00001	78	76	86	68	8	10
4882	FW_pair4882	FakeAnc4882	FakeDesc4882	SIMULPF00001	598	592	655	535	57	63
4883	FW_pair4883	FakeAnc4883	FakeDesc4883	SIMULPF00001	437	434	472	399	35	38
4884	FW_pair4884	FakeAnc4884	FakeDesc4884	SIMULPF00001	274	278	294	258	20	16
4885	FW_pair4885	FakeAnc4885	FakeDesc4885	SIMULPF00001	162	157	182	137	20	25
4886	FW_pair4886	FakeAnc4886	FakeDesc4886	SIMULPF00001	488	498	532	454	44	34
4887	FW_pair4887	FakeAnc4887	FakeDesc4887	SIMULPF00001	31	32	32	31	1	0
4888	FW_pair4888	FakeAnc4888	FakeDesc4888	SIMULPF00001	249	258	283	224	34	25
4889	FW_pair4889	FakeAnc4889	FakeDesc4889	SIMULPF00001	19	15	20	14	1	5
4890	FW_pair4890	FakeAnc4890	FakeDesc4890	SIMULPF00001	362	349	386	325	24	37
4891	FW_pair4891	FakeAnc4891	FakeDesc4891	SIMULPF00001	51	50	58	43	7	8
4892	FW_pair4892	FakeAnc4892	FakeDesc4892	SIMULPF00001	80	82	91	71	11	9
4893	FW_pair4893	FakeAnc4893	FakeDesc4893	SIMULPF00001	577	579	642	514	65	63
4894	FW_pair4894	FakeAnc4894	FakeDesc4894	SIMULPF00001	124	124	133	115	9	9
4895	FW_pair4895	FakeAnc4895	FakeDesc4895	SIMULPF00001	14	15	15	14	1	0
4896	FW_pair4896	FakeAnc4896	FakeDesc4896	SIMULPF00001	393	382	422	353	29	40
4897	FW_pair4897	FakeAnc4897	FakeDesc4897	SIMULPF00001	15	14	15	14	0	1
4898	FW_pair4898	FakeAnc4898	FakeDesc4898	SIMULPF00001	149	151	164	136	15	13
4899	FW_pair4899	FakeAnc4899	FakeDesc4899	SIMULPF00001	377	382	418	341	41	36
4900	FW_pair4900	FakeAnc4900	FakeDesc4900	SIMULPF00001	255	259	279	235	24	20
4901	FW_pair4901	FakeAnc4901	FakeDesc4901	SIMULPF00001	174	182	201	155	27	19
4902	FW_pair4902	FakeAnc4902	FakeDesc4902	SIMULPF00001	256	253	278	231	22	25
4903	FW_pair4903	FakeAnc4903	FakeDesc4903	SIMULPF00001	431	432	469	394	38	37
4904	FW_pair4904	FakeAnc4904	FakeDesc4904	SIMULPF00001	3	1	3	1	0	2
4905	FW_pair4905	FakeAnc4905	FakeDesc4905	SIMULPF00001	8	7	8	7	0	1
4906	FW_pair4906	FakeAnc4906	FakeDesc4906	SIMULPF00001	534	535	593	476	59	58
4907	FW_pair4907	FakeAnc4907	FakeDesc4907	SIMULPF00001	200	197	222	175	22	25
4908	FW_pair4908	FakeAnc4908	FakeDesc4908	SIMULPF00001	66	71	74	63	8	3
4909	FW_pair4909	FakeAnc4909	FakeDesc4909	SIMULPF00001	178	171	192	157	14	21
4910	FW_pair4910	FakeAnc4910	FakeDesc4910	SIMULPF00001	409	403	452	360	43	49
4911	FW_pair4911	FakeAnc4911	FakeDesc4911	SIMULPF00001	399	402	437	364	38	35
4912	FW_pair4912	FakeAnc4912	FakeDesc4912	SIMULPF00001	119	117	125	111	6	8
4913	FW_pair4913	FakeAnc4913	FakeDesc4913	SIMULPF00001	228	238	255	211	27	17
4914	FW_pair4914	FakeAnc4914	FakeDesc4914	SIMULPF00001	621	630	694	557	73	64
4915	FW_pair4915	FakeAnc4915	FakeDesc4915	SIMULPF00001	348	336	376	308	28	40
4916	FW_pair4916	FakeAnc4916	FakeDesc4916	SIMULPF00001	91	87	94	84	3	7
4917	FW_pair4917	FakeAnc4917	FakeDesc4917	SIMULPF00001	72	72	78	66	6	6
4918	FW_pair4918	FakeAnc4918	FakeDesc4918	SIMULPF00001	67	76	79	64	12	3
4919	FW_pair4919	FakeAnc4919	FakeDesc4919	SIMULPF00001	377	385	425	337	48	40
4920	FW_pair4920	FakeAnc4920	FakeDesc4920	SIMULPF00001	262	274	292	244	30	18
4921	FW_pair4921	FakeAnc4921	FakeDesc4921	SIMULPF00001	125	125	138	112	13	13
4922	FW_pair4922	FakeAnc4922	FakeDesc4922	SIMULPF00001	482	480	522	440	40	42
4923	FW_pair4923	FakeAnc4923	FakeDesc4923	SIMULPF00001	24	23	24	23	0	1
4924	FW_pair4924	FakeAnc4924	FakeDesc4924	SIMULPF00001	55	58	61	52	6	3
4925	FW_pair4925	FakeAnc4925	FakeDesc4925	SIMULPF00001	397	379	432	344	35	53
4926	FW_pair4926	FakeAnc4926	FakeDesc4926	SIMULPF00001	16	16	19	13	3	3
4927	FW_pair4927	FakeAnc4927	FakeDesc4927	SIMULPF00001	575	577	632	520	57	55
4928	FW_pair4928	FakeAnc4928	FakeDesc4928	SIMULPF00001	168	162	179	151	11	17
4929	FW_pair4929	FakeAnc4929	FakeDesc4929	SIMULPF00001	196	187	211	172	15	24
4930	FW_pair4930	FakeAnc4930	FakeDesc4930	SIMULPF00001	281	277	308	250	27	31
4931	FW_pair4931	FakeAnc4931	FakeDesc4931	SIMULPF00001	492	487	533	446	41	46
4932	FW_pair4932	FakeAnc4932	FakeDesc4932	SIMULPF00001	50	54	58	46	8	4
4933	FW_pair4933	FakeAnc4933	FakeDesc4933	SIMULPF00001	771	758	835	694	64	77
4934	FW_pair4934	FakeAnc4934	FakeDesc4934	SIMULPF00001	90	82	93	79	3	11
4935	FW_pair4935	FakeAnc4935	FakeDesc4935	SIMULPF00001	8	11	11	8	3	0
4936	FW_pair4936	FakeAnc4936	FakeDesc4936	SIMULPF00001	774	783	848	709	74	65
4937	FW_pair4937	FakeAnc4937	FakeDesc4937	SIMULPF00001	165	168	185	148	20	17
4938	FW_pair4938	FakeAnc4938	FakeDesc4938	SIMULPF00001	229	232	255	206	26	23
4939	FW_pair4939	FakeAnc4939	FakeDesc4939	SIMULPF00001	63	61	69	55	6	8
4940	FW_pair4940	FakeAnc4940	FakeDesc4940	SIMULPF00001	260	270	287	243	27	17
4941	FW_pair4941	FakeAnc4941	FakeDesc4941	SIMULPF00001	135	135	148	122	13	13
4942	FW_pair4942	FakeAnc4942	FakeDesc4942	SIMULPF00001	290	266	301	255	11	35
4943	FW_pair4943	FakeAnc4943	FakeDesc4943	SIMULPF00001	65	66	70	61	5	4
4944	FW_pair4944	FakeAnc4944	FakeDesc4944	SIMULPF00001	610	608	666	552	56	58
4945	FW_pair4945	FakeAnc4945	FakeDesc4945	SIMULPF00001	263	263	292	234	29	29
4946	FW_pair4946	FakeAnc4946	FakeDesc4946	SIMULPF00001	193	191	212	172	19	21
4947	FW_pair4947	FakeAnc4947	FakeDesc4947	SIMULPF00001	71	74	75	70	4	1
4948	FW_pair4948	FakeAnc4948	FakeDesc4948	SIMULPF00001	416	409	451	374	35	42
4949	FW_pair4949	FakeAnc4949	FakeDesc4949	SIMULPF00001	166	167	175	158	9	8
4950	FW_pair4950	FakeAnc4950	FakeDesc4950	SIMULPF00001	219	217	232	204	13	15
4951	FW_pair4951	FakeAnc4951	FakeDesc4951	SIMULPF00001	698	682	759	621	61	77
4952	FW_pair4952	FakeAnc4952	FakeDesc4952	SIMULPF00001	95	99	105	89	10	6
4953	FW_pair4953	FakeAnc4953	FakeDesc4953	SIMULPF00001	62	61	66	57	4	5
4954	FW_pair4954	FakeAnc4954	FakeDesc4954	SIMULPF00001	24	26	27	23	3	1
4955	FW_pair4955	FakeAnc4955	FakeDesc4955	SIMULPF00001	109	113	126	96	17	13
4956	FW_pair4956	FakeAnc4956	FakeDesc4956	SIMULPF00001	164	164	177	151	13	13
4957	FW_pair4957	FakeAnc4957	FakeDesc4957	SIMULPF00001	47	47	52	42	5	5
4958	FW_pair4958	FakeAnc4958	FakeDesc4958	SIMULPF00001	211	205	220	196	9	15
4959	FW_pair4959	FakeAnc4959	FakeDesc4959	SIMULPF00001	162	132	166	128	4	34
4960	FW_pair4960	FakeAnc4960	FakeDesc4960	SIMULPF00001	309	308	350	267	41	42
4961	FW_pair4961	FakeAnc4961	FakeDesc4961	SIMULPF00001	263	269	288	244	25	19
4962	FW_pair4962	FakeAnc4962	FakeDesc4962	SIMULPF00001	211	210	232	189	21	22
4963	FW_pair4963	FakeAnc4963	FakeDesc4963	SIMULPF00001	34	38	39	33	5	1
4964	FW_pair4964	FakeAnc4964	FakeDesc4964	SIMULPF00001	164	166	181	149	17	15
4965	FW_pair4965	FakeAnc4965	FakeDesc4965	SIMULPF00001	17	13	17	13	0	4
4966	FW_pair4966	FakeAnc4966	FakeDesc4966	SIMULPF00001	583	585	640	528	57	55
4967	FW_pair4967	FakeAnc4967	FakeDesc4967	SIMULPF00001	94	96	108	82	14	12
4968	FW_pair4968	FakeAnc4968	FakeDesc4968	SIMULPF00001	206	204	224	186	18	20
4969	FW_pair4969	FakeAnc4969	FakeDesc4969	SIMULPF00001	4	6	6	4	2	0
4970	FW_pair4970	FakeAnc4970	FakeDesc4970	SIMULPF00001	188	198	213	173	25	15
4971	FW_pair4971	FakeAnc4971	FakeDesc4971	SIMULPF00001	596	616	662	550	66	46
4972	FW_pair4972	FakeAnc4972	FakeDesc4972	SIMULPF00001	707	703	769	641	62	66
4973	FW_pair4973	FakeAnc4973	FakeDesc4973	SIMULPF00001	55	49	61	43	6	12
4974	FW_pair4974	FakeAnc4974	FakeDesc4974	SIMULPF00001	90	89	96	83	6	7
4975	FW_pair4975	FakeAnc4975	FakeDesc4975	SIMULPF00001	7	6	7	6	0	1
4976	FW_pair4976	FakeAnc4976	FakeDesc4976	SIMULPF00001	44	45	46	43	2	1
4977	FW_pair4977	FakeAnc4977	FakeDesc4977	SIMULPF00001	148	146	162	132	14	16
4978	FW_pair4978	FakeAnc4978	FakeDesc4978	SIMULPF00001	806	839	906	739	100	67
4979	FW_pair4979	FakeAnc4979	FakeDesc4979	SIMULPF00001	285	295	316	264	31	21
4980	FW_pair4980	FakeAnc4980	FakeDesc4980	SIMULPF00001	7	7	7	7	0	0
4981	FW_pair4981	FakeAnc4981	FakeDesc4981	SIMULPF00001	739	703	793	649	54	90
4982	FW_pair4982	FakeAnc4982	FakeDesc4982	SIMULPF00001	136	147	147	136	11	0
4983	FW_pair4983	FakeAnc4983	FakeDesc4983	SIMULPF00001	164	152	170	146	6	18
4984	FW_pair4984	FakeAnc4984	FakeDesc4984	SIMULPF00001	251	257	274	234	23	17
4985	FW_pair4985	FakeAnc4985	FakeDesc4985	SIMULPF00001	364	368	393	339	29	25
4986	FW_pair4986	FakeAnc4986	FakeDesc4986	SIMULPF00001	57	52	60	49	3	8
4987	FW_pair4987	FakeAnc4987	FakeDesc4987	SIMULPF00001	50	55	56	49	6	1
4988	FW_pair4988	FakeAnc4988	FakeDesc4988	SIMULPF00001	234	250	265	219	31	15
4989	FW_pair4989	FakeAnc4989	FakeDesc4989	SIMULPF00001	153	152	165	140	12	13
4990	FW_pair4990	FakeAnc4990	FakeDesc4990	SIMULPF00001	80	83	90	73	10	7
4991	FW_pair4991	FakeAnc4991	FakeDesc4991	SIMULPF00001	320	340	366	294	46	26
4992	FW_pair4992	FakeAnc4992	FakeDesc4992	SIMULPF00001	161	172	185	148	24	13
4993	FW_pair4993	FakeAnc4993	FakeDesc4993	SIMULPF00001	165	167	191	141	26	24
4994	FW_pair4994	FakeAnc4994	FakeDesc4994	SIMULPF00001	403	397	438	362	35	41
4995	FW_pair4995	FakeAnc4995	FakeDesc4995	SIMULPF00001	391	375	420	346	29	45
4996	FW_pair4996	FakeAnc4996	FakeDesc4996	SIMULPF00001	55	57	60	52	5	3
4997	FW_pair4997	FakeAnc4997	FakeDesc4997	SIMULPF00001	787	794	859	722	72	65
4998	FW_pair4998	FakeAnc4998	FakeDesc4998	SIMULPF00001	75	72	80	67	5	8
4999	FW_pair4999	FakeAnc4999	FakeDesc4999	SIMULPF00001	246	254	268	232	22	14
5000	RV_pair0	FakeDesc0	FakeAnc0	SIMULPF00001	449	452	499	402	50	47
5001	RV_pair1	FakeDesc1	FakeAnc1	SIMULPF00001	21	17	23	15	2	6
5002	RV_pair2	FakeDesc2	FakeAnc2	SIMULPF00001	56	56	63	49	7	7
5003	RV_pair3	FakeDesc3	FakeAnc3	SIMULPF00001	862	878	970	770	108	92
5004	RV_pair4	FakeDesc4	FakeAnc4	SIMULPF00001	502	512	552	462	50	40
5005	RV_pair5	FakeDesc5	FakeAnc5	SIMULPF00001	770	753	825	698	55	72
5006	RV_pair6	FakeDesc6	FakeAnc6	SIMULPF00001	107	104	118	93	11	14
5007	RV_pair7	FakeDesc7	FakeAnc7	SIMULPF00001	25	26	27	24	2	1
5008	RV_pair8	FakeDesc8	FakeAnc8	SIMULPF00001	514	502	549	467	35	47
5009	RV_pair9	FakeDesc9	FakeAnc9	SIMULPF00001	172	174	187	159	15	13
5010	RV_pair10	FakeDesc10	FakeAnc10	SIMULPF00001	666	668	737	597	71	69
5011	RV_pair11	FakeDesc11	FakeAnc11	SIMULPF00001	479	499	540	438	61	41
5012	RV_pair12	FakeDesc12	FakeAnc12	SIMULPF00001	77	76	83	70	6	7
5013	RV_pair13	FakeDesc13	FakeAnc13	SIMULPF00001	108	110	117	101	9	7
5014	RV_pair14	FakeDesc14	FakeAnc14	SIMULPF00001	224	232	249	207	25	17
5015	RV_pair15	FakeDesc15	FakeAnc15	SIMULPF00001	24	25	25	24	1	0
5016	RV_pair16	FakeDesc16	FakeAnc16	SIMULPF00001	289	284	315	258	26	31
5017	RV_pair17	FakeDesc17	FakeAnc17	SIMULPF00001	61	55	65	51	4	10
5018	RV_pair18	FakeDesc18	FakeAnc18	SIMULPF00001	144	135	155	124	11	20
5019	RV_pair19	FakeDesc19	FakeAnc19	SIMULPF00001	155	159	171	143	16	12
5020	RV_pair20	FakeDesc20	FakeAnc20	SIMULPF00001	113	116	123	106	10	7
5021	RV_pair21	FakeDesc21	FakeAnc21	SIMULPF00001	282	282	318	246	36	36
5022	RV_pair22	FakeDesc22	FakeAnc22	SIMULPF00001	322	323	351	294	29	28
5023	RV_pair23	FakeDesc23	FakeAnc23	SIMULPF00001	36	33	39	30	3	6
5024	RV_pair24	FakeDesc24	FakeAnc24	SIMULPF00001	65	75	79	61	14	4
5025	RV_pair25	FakeDesc25	FakeAnc25	SIMULPF00001	102	104	109	97	7	5
5026	RV_pair26	FakeDesc26	FakeAnc26	SIMULPF00001	156	164	173	147	17	9
5027	RV_pair27	FakeDesc27	FakeAnc27	SIMULPF00001	100	102	112	90	12	10
5028	RV_pair28	FakeDesc28	FakeAnc28	SIMULPF00001	643	650	701	592	58	51
5029	RV_pair29	FakeDesc29	FakeAnc29	SIMULPF00001	621	637	697	561	76	60
5030	RV_pair30	FakeDesc30	FakeAnc30	SIMULPF00001	98	95	104	89	6	9
5031	RV_pair31	FakeDesc31	FakeAnc31	SIMULPF00001	253	258	280	231	27	22
5032	RV_pair32	FakeDesc32	FakeAnc32	SIMULPF00001	54	55	58	51	4	3
5033	RV_pair33	FakeDesc33	FakeAnc33	SIMULPF00001	249	245	266	228	17	21
5034	RV_pair34	FakeDesc34	FakeAnc34	SIMULPF00001	64	62	70	56	6	8
5035	RV_pair35	FakeDesc35	FakeAnc35	SIMULPF00001	274	284	313	245	39	29
5036	RV_pair36	FakeDesc36	FakeAnc36	SIMULPF00001	186	186	203	169	17	17
5037	RV_pair37	FakeDesc37	FakeAnc37	SIMULPF00001	34	27	35	26	1	8
5038	RV_pair38	FakeDesc38	FakeAnc38	SIMULPF00001	185	185	197	173	12	12
5039	RV_pair39	FakeDesc39	FakeAnc39	SIMULPF00001	372	370	410	332	38	40
5040	RV_pair40	FakeDesc40	FakeAnc40	SIMULPF00001	6	5	6	5	0	1
5041	RV_pair41	FakeDesc41	FakeAnc41	SIMULPF00001	499	500	545	454	46	45
5042	RV_pair42	FakeDesc42	FakeAnc42	SIMULPF00001	25	26	30	21	5	4
5043	RV_pair43	FakeDesc43	FakeAnc43	SIMULPF00001	821	853	908	766	87	55
5044	RV_pair44	FakeDesc44	FakeAnc44	SIMULPF00001	132	144	155	121	23	11
5045	RV_pair45	FakeDesc45	FakeAnc45	SIMULPF00001	273	280	306	247	33	26
5046	RV_pair46	FakeDesc46	FakeAnc46	SIMULPF00001	131	131	151	111	20	20
5047	RV_pair47	FakeDesc47	FakeAnc47	SIMULPF00001	54	59	63	50	9	4
5048	RV_pair48	FakeDesc48	FakeAnc48	SIMULPF00001	443	447	480	410	37	33
5049	RV_pair49	FakeDesc49	FakeAnc49	SIMULPF00001	68	79	79	68	11	0
5050	RV_pair50	FakeDesc50	FakeAnc50	SIMULPF00001	285	279	309	255	24	30
5051	RV_pair51	FakeDesc51	FakeAnc51	SIMULPF00001	272	280	291	261	19	11
5052	RV_pair52	FakeDesc52	FakeAnc52	SIMULPF00001	12	11	12	11	0	1
5053	RV_pair53	FakeDesc53	FakeAnc53	SIMULPF00001	28	27	29	26	1	2
5054	RV_pair54	FakeDesc54	FakeAnc54	SIMULPF00001	204	198	221	181	17	23
5055	RV_pair55	FakeDesc55	FakeAnc55	SIMULPF00001	73	66	75	64	2	9
5056	RV_pair56	FakeDesc56	FakeAnc56	SIMULPF00001	14	14	14	14	0	0
5057	RV_pair57	FakeDesc57	FakeAnc57	SIMULPF00001	120	114	128	106	8	14
5058	RV_pair58	FakeDesc58	FakeAnc58	SIMULPF00001	97	104	108	93	11	4
5059	RV_pair59	FakeDesc59	FakeAnc59	SIMULPF00001	317	308	346	279	29	38
5060	RV_pair60	FakeDesc60	FakeAnc60	SIMULPF00001	250	232	262	220	12	30
5061	RV_pair61	FakeDesc61	FakeAnc61	SIMULPF00001	188	182	206	164	18	24
5062	RV_pair62	FakeDesc62	FakeAnc62	SIMULPF00001	96	106	109	93	13	3
5063	RV_pair63	FakeDesc63	FakeAnc63	SIMULPF00001	33	36	37	32	4	1
5064	RV_pair64	FakeDesc64	FakeAnc64	SIMULPF00001	48	49	54	43	6	5
5065	RV_pair65	FakeDesc65	FakeAnc65	SIMULPF00001	810	812	891	731	81	79
5066	RV_pair66	FakeDesc66	FakeAnc66	SIMULPF00001	110	102	120	92	10	18
5067	RV_pair67	FakeDesc67	FakeAnc67	SIMULPF00001	68	65	72	61	4	7
5068	RV_pair68	FakeDesc68	FakeAnc68	SIMULPF00001	12	9	12	9	0	3
5069	RV_pair69	FakeDesc69	FakeAnc69	SIMULPF00001	289	286	315	260	26	29
5070	RV_pair70	FakeDesc70	FakeAnc70	SIMULPF00001	244	238	262	220	18	24
5071	RV_pair71	FakeDesc71	FakeAnc71	SIMULPF00001	423	428	469	382	46	41
5072	RV_pair72	FakeDesc72	FakeAnc72	SIMULPF00001	82	77	85	74	3	8
5073	RV_pair73	FakeDesc73	FakeAnc73	SIMULPF00001	597	570	631	536	34	61
5074	RV_pair74	FakeDesc74	FakeAnc74	SIMULPF00001	141	137	151	127	10	14
5075	RV_pair75	FakeDesc75	FakeAnc75	SIMULPF00001	71	70	78	63	7	8
5076	RV_pair76	FakeDesc76	FakeAnc76	SIMULPF00001	162	160	178	144	16	18
5077	RV_pair77	FakeDesc77	FakeAnc77	SIMULPF00001	101	100	109	92	8	9
5078	RV_pair78	FakeDesc78	FakeAnc78	SIMULPF00001	649	653	698	604	49	45
5079	RV_pair79	FakeDesc79	FakeAnc79	SIMULPF00001	85	83	89	79	4	6
5080	RV_pair80	FakeDesc80	FakeAnc80	SIMULPF00001	380	381	414	347	34	33
5081	RV_pair81	FakeDesc81	FakeAnc81	SIMULPF00001	134	139	150	123	16	11
5082	RV_pair82	FakeDesc82	FakeAnc82	SIMULPF00001	549	519	578	490	29	59
5083	RV_pair83	FakeDesc83	FakeAnc83	SIMULPF00001	264	275	296	243	32	21
5084	RV_pair84	FakeDesc84	FakeAnc84	SIMULPF00001	232	231	254	209	22	23
5085	RV_pair85	FakeDesc85	FakeAnc85	SIMULPF00001	511	504	559	456	48	55
5086	RV_pair86	FakeDesc86	FakeAnc86	SIMULPF00001	297	293	323	267	26	30
5087	RV_pair87	FakeDesc87	FakeAnc87	SIMULPF00001	381	367	404	344	23	37
5088	RV_pair88	FakeDesc88	FakeAnc88	SIMULPF00001	163	149	172	140	9	23
5089	RV_pair89	FakeDesc89	FakeAnc89	SIMULPF00001	160	150	172	138	12	22
5090	RV_pair90	FakeDesc90	FakeAnc90	SIMULPF00001	349	348	383	314	34	35
5091	RV_pair91	FakeDesc91	FakeAnc91	SIMULPF00001	268	276	291	253	23	15
5092	RV_pair92	FakeDesc92	FakeAnc92	SIMULPF00001	264	269	298	235	34	29
5093	RV_pair93	FakeDesc93	FakeAnc93	SIMULPF00001	127	125	138	114	11	13
5094	RV_pair94	FakeDesc94	FakeAnc94	SIMULPF00001	12	12	12	12	0	0
5095	RV_pair95	FakeDesc95	FakeAnc95	SIMULPF00001	68	68	72	64	4	4
5096	RV_pair96	FakeDesc96	FakeAnc96	SIMULPF00001	342	330	372	300	30	42
5097	RV_pair97	FakeDesc97	FakeAnc97	SIMULPF00001	126	124	137	113	11	13
5098	RV_pair98	FakeDesc98	FakeAnc98	SIMULPF00001	375	370	413	332	38	43
5099	RV_pair99	FakeDesc99	FakeAnc99	SIMULPF00001	415	412	446	381	31	34
5100	RV_pair100	FakeDesc100	FakeAnc100	SIMULPF00001	303	299	330	272	27	31
5101	RV_pair101	FakeDesc101	FakeAnc101	SIMULPF00001	159	152	172	139	13	20
5102	RV_pair102	FakeDesc102	FakeAnc102	SIMULPF00001	28	27	30	25	2	3
5103	RV_pair103	FakeDesc103	FakeAnc103	SIMULPF00001	255	254	274	235	19	20
5104	RV_pair104	FakeDesc104	FakeAnc104	SIMULPF00001	366	378	407	337	41	29
5105	RV_pair105	FakeDesc105	FakeAnc105	SIMULPF00001	55	52	60	47	5	8
5106	RV_pair106	FakeDesc106	FakeAnc106	SIMULPF00001	105	108	116	97	11	8
5107	RV_pair107	FakeDesc107	FakeAnc107	SIMULPF00001	101	104	111	94	10	7
5108	RV_pair108	FakeDesc108	FakeAnc108	SIMULPF00001	145	151	166	130	21	15
5109	RV_pair109	FakeDesc109	FakeAnc109	SIMULPF00001	205	214	230	189	25	16
5110	RV_pair110	FakeDesc110	FakeAnc110	SIMULPF00001	555	563	605	513	50	42
5111	RV_pair111	FakeDesc111	FakeAnc111	SIMULPF00001	356	375	399	332	43	24
5112	RV_pair112	FakeDesc112	FakeAnc112	SIMULPF00001	246	235	258	223	12	23
5113	RV_pair113	FakeDesc113	FakeAnc113	SIMULPF00001	164	157	182	139	18	25
5114	RV_pair114	FakeDesc114	FakeAnc114	SIMULPF00001	95	106	111	90	16	5
5115	RV_pair115	FakeDesc115	FakeAnc115	SIMULPF00001	224	227	252	199	28	25
5116	RV_pair116	FakeDesc116	FakeAnc116	SIMULPF00001	224	235	252	207	28	17
5117	RV_pair117	FakeDesc117	FakeAnc117	SIMULPF00001	159	140	169	130	10	29
5118	RV_pair118	FakeDesc118	FakeAnc118	SIMULPF00001	910	922	991	841	81	69
5119	RV_pair119	FakeDesc119	FakeAnc119	SIMULPF00001	128	123	134	117	6	11
5120	RV_pair120	FakeDesc120	FakeAnc120	SIMULPF00001	401	401	439	363	38	38
5121	RV_pair121	FakeDesc121	FakeAnc121	SIMULPF00001	246	256	274	228	28	18
5122	RV_pair122	FakeDesc122	FakeAnc122	SIMULPF00001	117	120	128	109	11	8
5123	RV_pair123	FakeDesc123	FakeAnc123	SIMULPF00001	381	399	428	352	47	29
5124	RV_pair124	FakeDesc124	FakeAnc124	SIMULPF00001	65	62	68	59	3	6
5125	RV_pair125	FakeDesc125	FakeAnc125	SIMULPF00001	759	773	842	690	83	69
5126	RV_pair126	FakeDesc126	FakeAnc126	SIMULPF00001	367	361	396	332	29	35
5127	RV_pair127	FakeDesc127	FakeAnc127	SIMULPF00001	78	82	90	70	12	8
5128	RV_pair128	FakeDesc128	FakeAnc128	SIMULPF00001	217	221	242	196	25	21
5129	RV_pair129	FakeDesc129	FakeAnc129	SIMULPF00001	379	379	412	346	33	33
5130	RV_pair130	FakeDesc130	FakeAnc130	SIMULPF00001	357	352	385	324	28	33
5131	RV_pair131	FakeDesc131	FakeAnc131	SIMULPF00001	96	88	104	80	8	16
5132	RV_pair132	FakeDesc132	FakeAnc132	SIMULPF00001	320	323	349	294	29	26
5133	RV_pair133	FakeDesc133	FakeAnc133	SIMULPF00001	173	168	189	152	16	21
5134	RV_pair134	FakeDesc134	FakeAnc134	SIMULPF00001	72	68	74	66	2	6
5135	RV_pair135	FakeDesc135	FakeAnc135	SIMULPF00001	85	85	97	73	12	12
5136	RV_pair136	FakeDesc136	FakeAnc136	SIMULPF00001	267	271	291	247	24	20
5137	RV_pair137	FakeDesc137	FakeAnc137	SIMULPF00001	143	135	148	130	5	13
5138	RV_pair138	FakeDesc138	FakeAnc138	SIMULPF00001	49	56	59	46	10	3
5139	RV_pair139	FakeDesc139	FakeAnc139	SIMULPF00001	480	482	532	430	52	50
5140	RV_pair140	FakeDesc140	FakeAnc140	SIMULPF00001	243	240	260	223	17	20
5141	RV_pair141	FakeDesc141	FakeAnc141	SIMULPF00001	447	453	490	410	43	37
5142	RV_pair142	FakeDesc142	FakeAnc142	SIMULPF00001	1	1	1	1	0	0
5143	RV_pair143	FakeDesc143	FakeAnc143	SIMULPF00001	217	220	239	198	22	19
5144	RV_pair144	FakeDesc144	FakeAnc144	SIMULPF00001	208	207	225	190	17	18
5145	RV_pair145	FakeDesc145	FakeAnc145	SIMULPF00001	266	265	289	242	23	24
5146	RV_pair146	FakeDesc146	FakeAnc146	SIMULPF00001	194	186	208	172	14	22
5147	RV_pair147	FakeDesc147	FakeAnc147	SIMULPF00001	288	287	320	255	32	33
5148	RV_pair148	FakeDesc148	FakeAnc148	SIMULPF00001	363	359	394	328	31	35
5149	RV_pair149	FakeDesc149	FakeAnc149	SIMULPF00001	70	73	79	64	9	6
5150	RV_pair150	FakeDesc150	FakeAnc150	SIMULPF00001	272	281	299	254	27	18
5151	RV_pair151	FakeDesc151	FakeAnc151	SIMULPF00001	11	10	12	9	1	2
5152	RV_pair152	FakeDesc152	FakeAnc152	SIMULPF00001	45	42	48	39	3	6
5153	RV_pair153	FakeDesc153	FakeAnc153	SIMULPF00001	144	146	157	133	13	11
5154	RV_pair154	FakeDesc154	FakeAnc154	SIMULPF00001	133	135	150	118	17	15
5155	RV_pair155	FakeDesc155	FakeAnc155	SIMULPF00001	225	215	242	198	17	27
5156	RV_pair156	FakeDesc156	FakeAnc156	SIMULPF00001	108	105	117	96	9	12
5157	RV_pair157	FakeDesc157	FakeAnc157	SIMULPF00001	16	14	16	14	0	2
5158	RV_pair158	FakeDesc158	FakeAnc158	SIMULPF00001	232	223	246	209	14	23
5159	RV_pair159	FakeDesc159	FakeAnc159	SIMULPF00001	116	115	128	103	12	13
5160	RV_pair160	FakeDesc160	FakeAnc160	SIMULPF00001	139	159	167	131	28	8
5161	RV_pair161	FakeDesc161	FakeAnc161	SIMULPF00001	212	210	228	194	16	18
5162	RV_pair162	FakeDesc162	FakeAnc162	SIMULPF00001	168	171	183	156	15	12
5163	RV_pair163	FakeDesc163	FakeAnc163	SIMULPF00001	6	7	7	6	1	0
5164	RV_pair164	FakeDesc164	FakeAnc164	SIMULPF00001	6	5	6	5	0	1
5165	RV_pair165	FakeDesc165	FakeAnc165	SIMULPF00001	472	462	497	437	25	35
5166	RV_pair166	FakeDesc166	FakeAnc166	SIMULPF00001	277	276	310	243	33	34
5167	RV_pair167	FakeDesc167	FakeAnc167	SIMULPF00001	449	450	484	415	35	34
5168	RV_pair168	FakeDesc168	FakeAnc168	SIMULPF00001	124	129	138	115	14	9
5169	RV_pair169	FakeDesc169	FakeAnc169	SIMULPF00001	322	313	348	287	26	35
5170	RV_pair170	FakeDesc170	FakeAnc170	SIMULPF00001	75	76	82	69	7	6
5171	RV_pair171	FakeDesc171	FakeAnc171	SIMULPF00001	46	48	49	45	3	1
5172	RV_pair172	FakeDesc172	FakeAnc172	SIMULPF00001	6	7	8	5	2	1
5173	RV_pair173	FakeDesc173	FakeAnc173	SIMULPF00001	723	751	800	674	77	49
5174	RV_pair174	FakeDesc174	FakeAnc174	SIMULPF00001	223	214	234	203	11	20
5175	RV_pair175	FakeDesc175	FakeAnc175	SIMULPF00001	74	80	82	72	8	2
5176	RV_pair176	FakeDesc176	FakeAnc176	SIMULPF00001	445	440	481	404	36	41
5177	RV_pair177	FakeDesc177	FakeAnc177	SIMULPF00001	177	172	189	160	12	17
5178	RV_pair178	FakeDesc178	FakeAnc178	SIMULPF00001	60	66	70	56	10	4
5179	RV_pair179	FakeDesc179	FakeAnc179	SIMULPF00001	577	584	625	536	48	41
5180	RV_pair180	FakeDesc180	FakeAnc180	SIMULPF00001	520	503	573	450	53	70
5181	RV_pair181	FakeDesc181	FakeAnc181	SIMULPF00001	399	412	443	368	44	31
5182	RV_pair182	FakeDesc182	FakeAnc182	SIMULPF00001	85	83	90	78	5	7
5183	RV_pair183	FakeDesc183	FakeAnc183	SIMULPF00001	142	131	149	124	7	18
5184	RV_pair184	FakeDesc184	FakeAnc184	SIMULPF00001	144	154	166	132	22	12
5185	RV_pair185	FakeDesc185	FakeAnc185	SIMULPF00001	150	132	159	123	9	27
5186	RV_pair186	FakeDesc186	FakeAnc186	SIMULPF00001	826	852	933	745	107	81
5187	RV_pair187	FakeDesc187	FakeAnc187	SIMULPF00001	133	140	146	127	13	6
5188	RV_pair188	FakeDesc188	FakeAnc188	SIMULPF00001	266	278	296	248	30	18
5189	RV_pair189	FakeDesc189	FakeAnc189	SIMULPF00001	10	10	10	10	0	0
5190	RV_pair190	FakeDesc190	FakeAnc190	SIMULPF00001	175	171	186	160	11	15
5191	RV_pair191	FakeDesc191	FakeAnc191	SIMULPF00001	375	366	396	345	21	30
5192	RV_pair192	FakeDesc192	FakeAnc192	SIMULPF00001	2	1	2	1	0	1
5193	RV_pair193	FakeDesc193	FakeAnc193	SIMULPF00001	40	41	43	38	3	2
5194	RV_pair194	FakeDesc194	FakeAnc194	SIMULPF00001	186	184	211	159	25	27
5195	RV_pair195	FakeDesc195	FakeAnc195	SIMULPF00001	295	285	312	268	17	27
5196	RV_pair196	FakeDesc196	FakeAnc196	SIMULPF00001	135	129	146	118	11	17
5197	RV_pair197	FakeDesc197	FakeAnc197	SIMULPF00001	240	242	263	219	23	21
5198	RV_pair198	FakeDesc198	FakeAnc198	SIMULPF00001	157	141	164	134	7	23
5199	RV_pair199	FakeDesc199	FakeAnc199	SIMULPF00001	501	513	546	468	45	33
5200	RV_pair200	FakeDesc200	FakeAnc200	SIMULPF00001	192	181	206	167	14	25
5201	RV_pair201	FakeDesc201	FakeAnc201	SIMULPF00001	16	16	17	15	1	1
5202	RV_pair202	FakeDesc202	FakeAnc202	SIMULPF00001	73	76	84	65	11	8
5203	RV_pair203	FakeDesc203	FakeAnc203	SIMULPF00001	45	53	57	41	12	4
5204	RV_pair204	FakeDesc204	FakeAnc204	SIMULPF00001	97	97	106	88	9	9
5205	RV_pair205	FakeDesc205	FakeAnc205	SIMULPF00001	138	134	147	125	9	13
5206	RV_pair206	FakeDesc206	FakeAnc206	SIMULPF00001	15	16	16	15	1	0
5207	RV_pair207	FakeDesc207	FakeAnc207	SIMULPF00001	334	324	360	298	26	36
5208	RV_pair208	FakeDesc208	FakeAnc208	SIMULPF00001	286	283	303	266	17	20
5209	RV_pair209	FakeDesc209	FakeAnc209	SIMULPF00001	34	35	37	32	3	2
5210	RV_pair210	FakeDesc210	FakeAnc210	SIMULPF00001	7	5	7	5	0	2
5211	RV_pair211	FakeDesc211	FakeAnc211	SIMULPF00001	140	140	150	130	10	10
5212	RV_pair212	FakeDesc212	FakeAnc212	SIMULPF00001	50	58	59	49	9	1
5213	RV_pair213	FakeDesc213	FakeAnc213	SIMULPF00001	174	161	183	152	9	22
5214	RV_pair214	FakeDesc214	FakeAnc214	SIMULPF00001	66	72	76	62	10	4
5215	RV_pair215	FakeDesc215	FakeAnc215	SIMULPF00001	66	60	71	55	5	11
5216	RV_pair216	FakeDesc216	FakeAnc216	SIMULPF00001	298	315	337	276	39	22
5217	RV_pair217	FakeDesc217	FakeAnc217	SIMULPF00001	147	150	166	131	19	16
5218	RV_pair218	FakeDesc218	FakeAnc218	SIMULPF00001	85	79	92	72	7	13
5219	RV_pair219	FakeDesc219	FakeAnc219	SIMULPF00001	214	215	234	195	20	19
5220	RV_pair220	FakeDesc220	FakeAnc220	SIMULPF00001	8	8	9	7	1	1
5221	RV_pair221	FakeDesc221	FakeAnc221	SIMULPF00001	863	840	928	775	65	88
5222	RV_pair222	FakeDesc222	FakeAnc222	SIMULPF00001	107	105	118	94	11	13
5223	RV_pair223	FakeDesc223	FakeAnc223	SIMULPF00001	403	402	451	354	48	49
5224	RV_pair224	FakeDesc224	FakeAnc224	SIMULPF00001	350	354	385	319	35	31
5225	RV_pair225	FakeDesc225	FakeAnc225	SIMULPF00001	75	75	78	72	3	3
5226	RV_pair226	FakeDesc226	FakeAnc226	SIMULPF00001	156	164	173	147	17	9
5227	RV_pair227	FakeDesc227	FakeAnc227	SIMULPF00001	238	239	258	219	20	19
5228	RV_pair228	FakeDesc228	FakeAnc228	SIMULPF00001	62	62	69	55	7	7
5229	RV_pair229	FakeDesc229	FakeAnc229	SIMULPF00001	116	110	125	101	9	15
5230	RV_pair230	FakeDesc230	FakeAnc230	SIMULPF00001	269	281	299	251	30	18
5231	RV_pair231	FakeDesc231	FakeAnc231	SIMULPF00001	109	102	115	96	6	13
5232	RV_pair232	FakeDesc232	FakeAnc232	SIMULPF00001	545	532	591	486	46	59
5233	RV_pair233	FakeDesc233	FakeAnc233	SIMULPF00001	107	108	125	90	18	17
5234	RV_pair234	FakeDesc234	FakeAnc234	SIMULPF00001	294	285	327	252	33	42
5235	RV_pair235	FakeDesc235	FakeAnc235	SIMULPF00001	332	359	383	308	51	24
5236	RV_pair236	FakeDesc236	FakeAnc236	SIMULPF00001	140	149	158	131	18	9
5237	RV_pair237	FakeDesc237	FakeAnc237	SIMULPF00001	620	632	677	575	57	45
5238	RV_pair238	FakeDesc238	FakeAnc238	SIMULPF00001	101	86	108	79	7	22
5239	RV_pair239	FakeDesc239	FakeAnc239	SIMULPF00001	762	774	838	698	76	64
5240	RV_pair240	FakeDesc240	FakeAnc240	SIMULPF00001	127	132	140	119	13	8
5241	RV_pair241	FakeDesc241	FakeAnc241	SIMULPF00001	101	113	120	94	19	7
5242	RV_pair242	FakeDesc242	FakeAnc242	SIMULPF00001	315	309	345	279	30	36
5243	RV_pair243	FakeDesc243	FakeAnc243	SIMULPF00001	31	29	34	26	3	5
5244	RV_pair244	FakeDesc244	FakeAnc244	SIMULPF00001	88	88	101	75	13	13
5245	RV_pair245	FakeDesc245	FakeAnc245	SIMULPF00001	144	138	152	130	8	14
5246	RV_pair246	FakeDesc246	FakeAnc246	SIMULPF00001	43	38	45	36	2	7
5247	RV_pair247	FakeDesc247	FakeAnc247	SIMULPF00001	194	205	228	171	34	23
5248	RV_pair248	FakeDesc248	FakeAnc248	SIMULPF00001	42	39	45	36	3	6
5249	RV_pair249	FakeDesc249	FakeAnc249	SIMULPF00001	342	339	373	308	31	34
5250	RV_pair250	FakeDesc250	FakeAnc250	SIMULPF00001	472	468	509	431	37	41
5251	RV_pair251	FakeDesc251	FakeAnc251	SIMULPF00001	127	129	139	117	12	10
5252	RV_pair252	FakeDesc252	FakeAnc252	SIMULPF00001	377	389	417	349	40	28
5253	RV_pair253	FakeDesc253	FakeAnc253	SIMULPF00001	260	268	290	238	30	22
5254	RV_pair254	FakeDesc254	FakeAnc254	SIMULPF00001	89	89	99	79	10	10
5255	RV_pair255	FakeDesc255	FakeAnc255	SIMULPF00001	181	173	190	164	9	17
5256	RV_pair256	FakeDesc256	FakeAnc256	SIMULPF00001	705	696	763	638	58	67
5257	RV_pair257	FakeDesc257	FakeAnc257	SIMULPF00001	34	33	35	32	1	2
5258	RV_pair258	FakeDesc258	FakeAnc258	SIMULPF00001	54	56	56	54	2	0
5259	RV_pair259	FakeDesc259	FakeAnc259	SIMULPF00001	271	281	312	240	41	31
5260	RV_pair260	FakeDesc260	FakeAnc260	SIMULPF00001	78	76	84	70	6	8
5261	RV_pair261	FakeDesc261	FakeAnc261	SIMULPF00001	179	181	199	161	20	18
5262	RV_pair262	FakeDesc262	FakeAnc262	SIMULPF00001	60	60	67	53	7	7
5263	RV_pair263	FakeDesc263	FakeAnc263	SIMULPF00001	107	107	116	98	9	9
5264	RV_pair264	FakeDesc264	FakeAnc264	SIMULPF00001	113	109	119	103	6	10
5265	RV_pair265	FakeDesc265	FakeAnc265	SIMULPF00001	12	11	12	11	0	1
5266	RV_pair266	FakeDesc266	FakeAnc266	SIMULPF00001	41	43	46	38	5	3
5267	RV_pair267	FakeDesc267	FakeAnc267	SIMULPF00001	180	176	195	161	15	19
5268	RV_pair268	FakeDesc268	FakeAnc268	SIMULPF00001	340	329	362	307	22	33
5269	RV_pair269	FakeDesc269	FakeAnc269	SIMULPF00001	136	142	156	122	20	14
5270	RV_pair270	FakeDesc270	FakeAnc270	SIMULPF00001	248	248	275	221	27	27
5271	RV_pair271	FakeDesc271	FakeAnc271	SIMULPF00001	118	120	129	109	11	9
5272	RV_pair272	FakeDesc272	FakeAnc272	SIMULPF00001	213	212	228	197	15	16
5273	RV_pair273	FakeDesc273	FakeAnc273	SIMULPF00001	359	368	390	337	31	22
5274	RV_pair274	FakeDesc274	FakeAnc274	SIMULPF00001	214	226	244	196	30	18
5275	RV_pair275	FakeDesc275	FakeAnc275	SIMULPF00001	21	17	23	15	2	6
5276	RV_pair276	FakeDesc276	FakeAnc276	SIMULPF00001	295	297	321	271	26	24
5277	RV_pair277	FakeDesc277	FakeAnc277	SIMULPF00001	245	247	274	218	29	27
5278	RV_pair278	FakeDesc278	FakeAnc278	SIMULPF00001	373	357	392	338	19	35
5279	RV_pair279	FakeDesc279	FakeAnc279	SIMULPF00001	6	8	8	6	2	0
5280	RV_pair280	FakeDesc280	FakeAnc280	SIMULPF00001	68	66	74	60	6	8
5281	RV_pair281	FakeDesc281	FakeAnc281	SIMULPF00001	156	172	179	149	23	7
5282	RV_pair282	FakeDesc282	FakeAnc282	SIMULPF00001	185	187	203	169	18	16
5283	RV_pair283	FakeDesc283	FakeAnc283	SIMULPF00001	516	518	561	473	45	43
5284	RV_pair284	FakeDesc284	FakeAnc284	SIMULPF00001	192	190	215	167	23	25
5285	RV_pair285	FakeDesc285	FakeAnc285	SIMULPF00001	118	114	126	106	8	12
5286	RV_pair286	FakeDesc286	FakeAnc286	SIMULPF00001	33	36	38	31	5	2
5287	RV_pair287	FakeDesc287	FakeAnc287	SIMULPF00001	51	49	56	44	5	7
5288	RV_pair288	FakeDesc288	FakeAnc288	SIMULPF00001	857	859	924	792	67	65
5289	RV_pair289	FakeDesc289	FakeAnc289	SIMULPF00001	207	208	228	187	21	20
5290	RV_pair290	FakeDesc290	FakeAnc290	SIMULPF00001	516	525	560	481	44	35
5291	RV_pair291	FakeDesc291	FakeAnc291	SIMULPF00001	59	52	60	51	1	8
5292	RV_pair292	FakeDesc292	FakeAnc292	SIMULPF00001	87	77	88	76	1	11
5293	RV_pair293	FakeDesc293	FakeAnc293	SIMULPF00001	116	120	127	109	11	7
5294	RV_pair294	FakeDesc294	FakeAnc294	SIMULPF00001	33	37	38	32	5	1
5295	RV_pair295	FakeDesc295	FakeAnc295	SIMULPF00001	22	20	24	18	2	4
5296	RV_pair296	FakeDesc296	FakeAnc296	SIMULPF00001	159	160	172	147	13	12
5297	RV_pair297	FakeDesc297	FakeAnc297	SIMULPF00001	97	93	101	89	4	8
5298	RV_pair298	FakeDesc298	FakeAnc298	SIMULPF00001	215	212	236	191	21	24
5299	RV_pair299	FakeDesc299	FakeAnc299	SIMULPF00001	47	56	59	44	12	3
5300	RV_pair300	FakeDesc300	FakeAnc300	SIMULPF00001	146	155	167	134	21	12
5301	RV_pair301	FakeDesc301	FakeAnc301	SIMULPF00001	86	86	91	81	5	5
5302	RV_pair302	FakeDesc302	FakeAnc302	SIMULPF00001	254	248	275	227	21	27
5303	RV_pair303	FakeDesc303	FakeAnc303	SIMULPF00001	86	80	92	74	6	12
5304	RV_pair304	FakeDesc304	FakeAnc304	SIMULPF00001	246	236	265	217	19	29
5305	RV_pair305	FakeDesc305	FakeAnc305	SIMULPF00001	392	405	440	357	48	35
5306	RV_pair306	FakeDesc306	FakeAnc306	SIMULPF00001	172	161	185	148	13	24
5307	RV_pair307	FakeDesc307	FakeAnc307	SIMULPF00001	114	111	121	104	7	10
5308	RV_pair308	FakeDesc308	FakeAnc308	SIMULPF00001	15	13	15	13	0	2
5309	RV_pair309	FakeDesc309	FakeAnc309	SIMULPF00001	91	95	100	86	9	5
5310	RV_pair310	FakeDesc310	FakeAnc310	SIMULPF00001	29	26	31	24	2	5
5311	RV_pair311	FakeDesc311	FakeAnc311	SIMULPF00001	646	642	708	580	62	66
5312	RV_pair312	FakeDesc312	FakeAnc312	SIMULPF00001	15	15	17	13	2	2
5313	RV_pair313	FakeDesc313	FakeAnc313	SIMULPF00001	491	494	545	440	54	51
5314	RV_pair314	FakeDesc314	FakeAnc314	SIMULPF00001	233	236	255	214	22	19
5315	RV_pair315	FakeDesc315	FakeAnc315	SIMULPF00001	391	377	423	345	32	46
5316	RV_pair316	FakeDesc316	FakeAnc316	SIMULPF00001	233	219	245	207	12	26
5317	RV_pair317	FakeDesc317	FakeAnc317	SIMULPF00001	276	257	297	236	21	40
5318	RV_pair318	FakeDesc318	FakeAnc318	SIMULPF00001	26	29	30	25	4	1
5319	RV_pair319	FakeDesc319	FakeAnc319	SIMULPF00001	24	24	25	23	1	1
5320	RV_pair320	FakeDesc320	FakeAnc320	SIMULPF00001	7	7	7	7	0	0
5321	RV_pair321	FakeDesc321	FakeAnc321	SIMULPF00001	88	84	96	76	8	12
5322	RV_pair322	FakeDesc322	FakeAnc322	SIMULPF00001	59	56	64	51	5	8
5323	RV_pair323	FakeDesc323	FakeAnc323	SIMULPF00001	193	203	223	173	30	20
5324	RV_pair324	FakeDesc324	FakeAnc324	SIMULPF00001	867	874	956	785	89	82
5325	RV_pair325	FakeDesc325	FakeAnc325	SIMULPF00001	294	284	316	262	22	32
5326	RV_pair326	FakeDesc326	FakeAnc326	SIMULPF00001	71	66	76	61	5	10
5327	RV_pair327	FakeDesc327	FakeAnc327	SIMULPF00001	20	24	24	20	4	0
5328	RV_pair328	FakeDesc328	FakeAnc328	SIMULPF00001	118	118	123	113	5	5
5329	RV_pair329	FakeDesc329	FakeAnc329	SIMULPF00001	248	245	270	223	22	25
5330	RV_pair330	FakeDesc330	FakeAnc330	SIMULPF00001	93	90	99	84	6	9
5331	RV_pair331	FakeDesc331	FakeAnc331	SIMULPF00001	270	270	297	243	27	27
5332	RV_pair332	FakeDesc332	FakeAnc332	SIMULPF00001	333	327	361	299	28	34
5333	RV_pair333	FakeDesc333	FakeAnc333	SIMULPF00001	162	170	184	148	22	14
5334	RV_pair334	FakeDesc334	FakeAnc334	SIMULPF00001	328	321	359	290	31	38
5335	RV_pair335	FakeDesc335	FakeAnc335	SIMULPF00001	473	489	530	432	57	41
5336	RV_pair336	FakeDesc336	FakeAnc336	SIMULPF00001	76	79	84	71	8	5
5337	RV_pair337	FakeDesc337	FakeAnc337	SIMULPF00001	344	342	373	313	29	31
5338	RV_pair338	FakeDesc338	FakeAnc338	SIMULPF00001	737	709	791	655	54	82
5339	RV_pair339	FakeDesc339	FakeAnc339	SIMULPF00001	124	140	150	114	26	10
5340	RV_pair340	FakeDesc340	FakeAnc340	SIMULPF00001	202	204	219	187	17	15
5341	RV_pair341	FakeDesc341	FakeAnc341	SIMULPF00001	169	168	181	156	12	13
5342	RV_pair342	FakeDesc342	FakeAnc342	SIMULPF00001	146	144	154	136	8	10
5343	RV_pair343	FakeDesc343	FakeAnc343	SIMULPF00001	37	38	43	32	6	5
5344	RV_pair344	FakeDesc344	FakeAnc344	SIMULPF00001	41	37	43	35	2	6
5345	RV_pair345	FakeDesc345	FakeAnc345	SIMULPF00001	113	118	133	98	20	15
5346	RV_pair346	FakeDesc346	FakeAnc346	SIMULPF00001	149	134	152	131	3	18
5347	RV_pair347	FakeDesc347	FakeAnc347	SIMULPF00001	217	221	236	202	19	15
5348	RV_pair348	FakeDesc348	FakeAnc348	SIMULPF00001	293	269	309	253	16	40
5349	RV_pair349	FakeDesc349	FakeAnc349	SIMULPF00001	223	215	236	202	13	21
5350	RV_pair350	FakeDesc350	FakeAnc350	SIMULPF00001	2	2	2	2	0	0
5351	RV_pair351	FakeDesc351	FakeAnc351	SIMULPF00001	61	67	70	58	9	3
5352	RV_pair352	FakeDesc352	FakeAnc352	SIMULPF00001	359	359	400	318	41	41
5353	RV_pair353	FakeDesc353	FakeAnc353	SIMULPF00001	68	71	74	65	6	3
5354	RV_pair354	FakeDesc354	FakeAnc354	SIMULPF00001	51	44	56	39	5	12
5355	RV_pair355	FakeDesc355	FakeAnc355	SIMULPF00001	168	172	186	154	18	14
5356	RV_pair356	FakeDesc356	FakeAnc356	SIMULPF00001	127	124	137	114	10	13
5357	RV_pair357	FakeDesc357	FakeAnc357	SIMULPF00001	201	203	224	180	23	21
5358	RV_pair358	FakeDesc358	FakeAnc358	SIMULPF00001	122	120	134	108	12	14
5359	RV_pair359	FakeDesc359	FakeAnc359	SIMULPF00001	23	25	29	19	6	4
5360	RV_pair360	FakeDesc360	FakeAnc360	SIMULPF00001	117	111	127	101	10	16
5361	RV_pair361	FakeDesc361	FakeAnc361	SIMULPF00001	10	10	11	9	1	1
5362	RV_pair362	FakeDesc362	FakeAnc362	SIMULPF00001	423	423	459	387	36	36
5363	RV_pair363	FakeDesc363	FakeAnc363	SIMULPF00001	154	146	169	131	15	23
5364	RV_pair364	FakeDesc364	FakeAnc364	SIMULPF00001	760	747	832	675	72	85
5365	RV_pair365	FakeDesc365	FakeAnc365	SIMULPF00001	213	212	228	197	15	16
5366	RV_pair366	FakeDesc366	FakeAnc366	SIMULPF00001	373	367	408	332	35	41
5367	RV_pair367	FakeDesc367	FakeAnc367	SIMULPF00001	635	623	696	562	61	73
5368	RV_pair368	FakeDesc368	FakeAnc368	SIMULPF00001	177	190	205	162	28	15
5369	RV_pair369	FakeDesc369	FakeAnc369	SIMULPF00001	744	757	827	674	83	70
5370	RV_pair370	FakeDesc370	FakeAnc370	SIMULPF00001	29	32	33	28	4	1
5371	RV_pair371	FakeDesc371	FakeAnc371	SIMULPF00001	447	457	508	396	61	51
5372	RV_pair372	FakeDesc372	FakeAnc372	SIMULPF00001	312	314	342	284	30	28
5373	RV_pair373	FakeDesc373	FakeAnc373	SIMULPF00001	54	55	60	49	6	5
5374	RV_pair374	FakeDesc374	FakeAnc374	SIMULPF00001	145	136	154	127	9	18
5375	RV_pair375	FakeDesc375	FakeAnc375	SIMULPF00001	391	404	437	358	46	33
5376	RV_pair376	FakeDesc376	FakeAnc376	SIMULPF00001	171	179	193	157	22	14
5377	RV_pair377	FakeDesc377	FakeAnc377	SIMULPF00001	336	343	368	311	32	25
5378	RV_pair378	FakeDesc378	FakeAnc378	SIMULPF00001	367	390	410	347	43	20
5379	RV_pair379	FakeDesc379	FakeAnc379	SIMULPF00001	414	413	454	373	40	41
5380	RV_pair380	FakeDesc380	FakeAnc380	SIMULPF00001	108	112	123	97	15	11
5381	RV_pair381	FakeDesc381	FakeAnc381	SIMULPF00001	154	158	167	145	13	9
5382	RV_pair382	FakeDesc382	FakeAnc382	SIMULPF00001	248	239	266	221	18	27
5383	RV_pair383	FakeDesc383	FakeAnc383	SIMULPF00001	29	31	32	28	3	1
5384	RV_pair384	FakeDesc384	FakeAnc384	SIMULPF00001	760	751	824	687	64	73
5385	RV_pair385	FakeDesc385	FakeAnc385	SIMULPF00001	59	54	63	50	4	9
5386	RV_pair386	FakeDesc386	FakeAnc386	SIMULPF00001	18	16	20	14	2	4
5387	RV_pair387	FakeDesc387	FakeAnc387	SIMULPF00001	272	274	293	253	21	19
5388	RV_pair388	FakeDesc388	FakeAnc388	SIMULPF00001	652	654	712	594	60	58
5389	RV_pair389	FakeDesc389	FakeAnc389	SIMULPF00001	560	571	623	508	63	52
5390	RV_pair390	FakeDesc390	FakeAnc390	SIMULPF00001	385	391	422	354	37	31
5391	RV_pair391	FakeDesc391	FakeAnc391	SIMULPF00001	164	167	185	146	21	18
5392	RV_pair392	FakeDesc392	FakeAnc392	SIMULPF00001	280	278	302	256	22	24
5393	RV_pair393	FakeDesc393	FakeAnc393	SIMULPF00001	162	165	180	147	18	15
5394	RV_pair394	FakeDesc394	FakeAnc394	SIMULPF00001	478	479	533	424	55	54
5395	RV_pair395	FakeDesc395	FakeAnc395	SIMULPF00001	39	35	42	32	3	7
5396	RV_pair396	FakeDesc396	FakeAnc396	SIMULPF00001	246	248	272	222	26	24
5397	RV_pair397	FakeDesc397	FakeAnc397	SIMULPF00001	106	109	118	97	12	9
5398	RV_pair398	FakeDesc398	FakeAnc398	SIMULPF00001	106	109	117	98	11	8
5399	RV_pair399	FakeDesc399	FakeAnc399	SIMULPF00001	711	698	759	650	48	61
5400	RV_pair400	FakeDesc400	FakeAnc400	SIMULPF00001	114	104	122	96	8	18
5401	RV_pair401	FakeDesc401	FakeAnc401	SIMULPF00001	90	91	95	86	5	4
5402	RV_pair402	FakeDesc402	FakeAnc402	SIMULPF00001	143	155	161	137	18	6
5403	RV_pair403	FakeDesc403	FakeAnc403	SIMULPF00001	337	330	361	306	24	31
5404	RV_pair404	FakeDesc404	FakeAnc404	SIMULPF00001	29	34	37	26	8	3
5405	RV_pair405	FakeDesc405	FakeAnc405	SIMULPF00001	86	90	99	77	13	9
5406	RV_pair406	FakeDesc406	FakeAnc406	SIMULPF00001	45	43	47	41	2	4
5407	RV_pair407	FakeDesc407	FakeAnc407	SIMULPF00001	20	18	20	18	0	2
5408	RV_pair408	FakeDesc408	FakeAnc408	SIMULPF00001	428	425	468	385	40	43
5409	RV_pair409	FakeDesc409	FakeAnc409	SIMULPF00001	653	655	717	591	64	62
5410	RV_pair410	FakeDesc410	FakeAnc410	SIMULPF00001	62	65	69	58	7	4
5411	RV_pair411	FakeDesc411	FakeAnc411	SIMULPF00001	29	28	30	27	1	2
5412	RV_pair412	FakeDesc412	FakeAnc412	SIMULPF00001	205	203	222	186	17	19
5413	RV_pair413	FakeDesc413	FakeAnc413	SIMULPF00001	335	346	373	308	38	27
5414	RV_pair414	FakeDesc414	FakeAnc414	SIMULPF00001	3	3	3	3	0	0
5415	RV_pair415	FakeDesc415	FakeAnc415	SIMULPF00001	26	28	28	26	2	0
5416	RV_pair416	FakeDesc416	FakeAnc416	SIMULPF00001	203	200	216	187	13	16
5417	RV_pair417	FakeDesc417	FakeAnc417	SIMULPF00001	462	456	502	416	40	46
5418	RV_pair418	FakeDesc418	FakeAnc418	SIMULPF00001	237	218	250	205	13	32
5419	RV_pair419	FakeDesc419	FakeAnc419	SIMULPF00001	73	68	77	64	4	9
5420	RV_pair420	FakeDesc420	FakeAnc420	SIMULPF00001	192	181	203	170	11	22
5421	RV_pair421	FakeDesc421	FakeAnc421	SIMULPF00001	3	3	3	3	0	0
5422	RV_pair422	FakeDesc422	FakeAnc422	SIMULPF00001	273	272	288	257	15	16
5423	RV_pair423	FakeDesc423	FakeAnc423	SIMULPF00001	128	130	138	120	10	8
5424	RV_pair424	FakeDesc424	FakeAnc424	SIMULPF00001	121	123	129	115	8	6
5425	RV_pair425	FakeDesc425	FakeAnc425	SIMULPF00001	236	238	256	218	20	18
5426	RV_pair426	FakeDesc426	FakeAnc426	SIMULPF00001	218	225	247	196	29	22
5427	RV_pair427	FakeDesc427	FakeAnc427	SIMULPF00001	550	537	607	480	57	70
5428	RV_pair428	FakeDesc428	FakeAnc428	SIMULPF00001	132	137	144	125	12	7
5429	RV_pair429	FakeDesc429	FakeAnc429	SIMULPF00001	38	38	40	36	2	2
5430	RV_pair430	FakeDesc430	FakeAnc430	SIMULPF00001	612	602	659	555	47	57
5431	RV_pair431	FakeDesc431	FakeAnc431	SIMULPF00001	148	166	172	142	24	6
5432	RV_pair432	FakeDesc432	FakeAnc432	SIMULPF00001	218	221	242	197	24	21
5433	RV_pair433	FakeDesc433	FakeAnc433	SIMULPF00001	99	85	105	79	6	20
5434	RV_pair434	FakeDesc434	FakeAnc434	SIMULPF00001	242	241	259	224	17	18
5435	RV_pair435	FakeDesc435	FakeAnc435	SIMULPF00001	30	32	34	28	4	2
5436	RV_pair436	FakeDesc436	FakeAnc436	SIMULPF00001	25	22	25	22	0	3
5437	RV_pair437	FakeDesc437	FakeAnc437	SIMULPF00001	441	437	476	402	35	39
5438	RV_pair438	FakeDesc438	FakeAnc438	SIMULPF00001	47	49	51	45	4	2
5439	RV_pair439	FakeDesc439	FakeAnc439	SIMULPF00001	414	408	448	374	34	40
5440	RV_pair440	FakeDesc440	FakeAnc440	SIMULPF00001	87	85	96	76	9	11
5441	RV_pair441	FakeDesc441	FakeAnc441	SIMULPF00001	187	194	213	168	26	19
5442	RV_pair442	FakeDesc442	FakeAnc442	SIMULPF00001	50	52	53	49	3	1
5443	RV_pair443	FakeDesc443	FakeAnc443	SIMULPF00001	49	50	54	45	5	4
5444	RV_pair444	FakeDesc444	FakeAnc444	SIMULPF00001	175	174	193	156	18	19
5445	RV_pair445	FakeDesc445	FakeAnc445	SIMULPF00001	243	225	260	208	17	35
5446	RV_pair446	FakeDesc446	FakeAnc446	SIMULPF00001	630	634	695	569	65	61
5447	RV_pair447	FakeDesc447	FakeAnc447	SIMULPF00001	158	156	169	145	11	13
5448	RV_pair448	FakeDesc448	FakeAnc448	SIMULPF00001	106	114	121	99	15	7
5449	RV_pair449	FakeDesc449	FakeAnc449	SIMULPF00001	205	200	223	182	18	23
5450	RV_pair450	FakeDesc450	FakeAnc450	SIMULPF00001	125	125	135	115	10	10
5451	RV_pair451	FakeDesc451	FakeAnc451	SIMULPF00001	64	72	75	61	11	3
5452	RV_pair452	FakeDesc452	FakeAnc452	SIMULPF00001	347	338	373	312	26	35
5453	RV_pair453	FakeDesc453	FakeAnc453	SIMULPF00001	308	319	345	282	37	26
5454	RV_pair454	FakeDesc454	FakeAnc454	SIMULPF00001	496	510	545	461	49	35
5455	RV_pair455	FakeDesc455	FakeAnc455	SIMULPF00001	111	124	130	105	19	6
5456	RV_pair456	FakeDesc456	FakeAnc456	SIMULPF00001	322	327	361	288	39	34
5457	RV_pair457	FakeDesc457	FakeAnc457	SIMULPF00001	207	216	238	185	31	22
5458	RV_pair458	FakeDesc458	FakeAnc458	SIMULPF00001	52	54	56	50	4	2
5459	RV_pair459	FakeDesc459	FakeAnc459	SIMULPF00001	4	5	5	4	1	0
5460	RV_pair460	FakeDesc460	FakeAnc460	SIMULPF00001	61	57	67	51	6	10
5461	RV_pair461	FakeDesc461	FakeAnc461	SIMULPF00001	37	36	39	34	2	3
5462	RV_pair462	FakeDesc462	FakeAnc462	SIMULPF00001	116	125	133	108	17	8
5463	RV_pair463	FakeDesc463	FakeAnc463	SIMULPF00001	266	262	286	242	20	24
5464	RV_pair464	FakeDesc464	FakeAnc464	SIMULPF00001	48	49	52	45	4	3
5465	RV_pair465	FakeDesc465	FakeAnc465	SIMULPF00001	26	24	26	24	0	2
5466	RV_pair466	FakeDesc466	FakeAnc466	SIMULPF00001	99	102	108	93	9	6
5467	RV_pair467	FakeDesc467	FakeAnc467	SIMULPF00001	195	199	211	183	16	12
5468	RV_pair468	FakeDesc468	FakeAnc468	SIMULPF00001	51	48	54	45	3	6
5469	RV_pair469	FakeDesc469	FakeAnc469	SIMULPF00001	286	285	318	253	32	33
5470	RV_pair470	FakeDesc470	FakeAnc470	SIMULPF00001	56	57	59	54	3	2
5471	RV_pair471	FakeDesc471	FakeAnc471	SIMULPF00001	778	760	850	688	72	90
5472	RV_pair472	FakeDesc472	FakeAnc472	SIMULPF00001	759	767	836	690	77	69
5473	RV_pair473	FakeDesc473	FakeAnc473	SIMULPF00001	98	101	110	89	12	9
5474	RV_pair474	FakeDesc474	FakeAnc474	SIMULPF00001	15	11	16	10	1	5
5475	RV_pair475	FakeDesc475	FakeAnc475	SIMULPF00001	103	97	110	90	7	13
5476	RV_pair476	FakeDesc476	FakeAnc476	SIMULPF00001	539	522	584	477	45	62
5477	RV_pair477	FakeDesc477	FakeAnc477	SIMULPF00001	134	124	145	113	11	21
5478	RV_pair478	FakeDesc478	FakeAnc478	SIMULPF00001	833	810	902	741	69	92
5479	RV_pair479	FakeDesc479	FakeAnc479	SIMULPF00001	919	917	996	840	77	79
5480	RV_pair480	FakeDesc480	FakeAnc480	SIMULPF00001	232	241	258	215	26	17
5481	RV_pair481	FakeDesc481	FakeAnc481	SIMULPF00001	580	610	652	538	72	42
5482	RV_pair482	FakeDesc482	FakeAnc482	SIMULPF00001	85	84	91	78	6	7
5483	RV_pair483	FakeDesc483	FakeAnc483	SIMULPF00001	300	308	328	280	28	20
5484	RV_pair484	FakeDesc484	FakeAnc484	SIMULPF00001	287	289	309	267	22	20
5485	RV_pair485	FakeDesc485	FakeAnc485	SIMULPF00001	539	553	599	493	60	46
5486	RV_pair486	FakeDesc486	FakeAnc486	SIMULPF00001	34	34	35	33	1	1
5487	RV_pair487	FakeDesc487	FakeAnc487	SIMULPF00001	184	183	200	167	16	17
5488	RV_pair488	FakeDesc488	FakeAnc488	SIMULPF00001	174	173	189	158	15	16
5489	RV_pair489	FakeDesc489	FakeAnc489	SIMULPF00001	54	54	56	52	2	2
5490	RV_pair490	FakeDesc490	FakeAnc490	SIMULPF00001	13	14	16	11	3	2
5491	RV_pair491	FakeDesc491	FakeAnc491	SIMULPF00001	8	8	8	8	0	0
5492	RV_pair492	FakeDesc492	FakeAnc492	SIMULPF00001	102	94	108	88	6	14
5493	RV_pair493	FakeDesc493	FakeAnc493	SIMULPF00001	427	423	468	382	41	45
5494	RV_pair494	FakeDesc494	FakeAnc494	SIMULPF00001	811	826	894	743	83	68
5495	RV_pair495	FakeDesc495	FakeAnc495	SIMULPF00001	128	117	132	113	4	15
5496	RV_pair496	FakeDesc496	FakeAnc496	SIMULPF00001	282	280	312	250	30	32
5497	RV_pair497	FakeDesc497	FakeAnc497	SIMULPF00001	183	195	209	169	26	14
5498	RV_pair498	FakeDesc498	FakeAnc498	SIMULPF00001	8	7	8	7	0	1
5499	RV_pair499	FakeDesc499	FakeAnc499	SIMULPF00001	63	71	74	60	11	3
5500	RV_pair500	FakeDesc500	FakeAnc500	SIMULPF00001	97	93	100	90	3	7
5501	RV_pair501	FakeDesc501	FakeAnc501	SIMULPF00001	93	94	101	86	8	7
5502	RV_pair502	FakeDesc502	FakeAnc502	SIMULPF00001	589	603	650	542	61	47
5503	RV_pair503	FakeDesc503	FakeAnc503	SIMULPF00001	672	670	738	604	66	68
5504	RV_pair504	FakeDesc504	FakeAnc504	SIMULPF00001	153	147	159	141	6	12
5505	RV_pair505	FakeDesc505	FakeAnc505	SIMULPF00001	237	233	256	214	19	23
5506	RV_pair506	FakeDesc506	FakeAnc506	SIMULPF00001	147	143	158	132	11	15
5507	RV_pair507	FakeDesc507	FakeAnc507	SIMULPF00001	219	224	244	199	25	20
5508	RV_pair508	FakeDesc508	FakeAnc508	SIMULPF00001	244	237	262	219	18	25
5509	RV_pair509	FakeDesc509	FakeAnc509	SIMULPF00001	509	516	562	463	53	46
5510	RV_pair510	FakeDesc510	FakeAnc510	SIMULPF00001	285	284	310	259	25	26
5511	RV_pair511	FakeDesc511	FakeAnc511	SIMULPF00001	496	498	540	454	44	42
5512	RV_pair512	FakeDesc512	FakeAnc512	SIMULPF00001	272	276	301	247	29	25
5513	RV_pair513	FakeDesc513	FakeAnc513	SIMULPF00001	172	176	194	154	22	18
5514	RV_pair514	FakeDesc514	FakeAnc514	SIMULPF00001	799	778	866	711	67	88
5515	RV_pair515	FakeDesc515	FakeAnc515	SIMULPF00001	195	197	218	174	23	21
5516	RV_pair516	FakeDesc516	FakeAnc516	SIMULPF00001	228	232	243	217	15	11
5517	RV_pair517	FakeDesc517	FakeAnc517	SIMULPF00001	556	524	597	483	41	73
5518	RV_pair518	FakeDesc518	FakeAnc518	SIMULPF00001	363	372	409	326	46	37
5519	RV_pair519	FakeDesc519	FakeAnc519	SIMULPF00001	258	274	288	244	30	14
5520	RV_pair520	FakeDesc520	FakeAnc520	SIMULPF00001	52	55	56	51	4	1
5521	RV_pair521	FakeDesc521	FakeAnc521	SIMULPF00001	141	138	151	128	10	13
5522	RV_pair522	FakeDesc522	FakeAnc522	SIMULPF00001	179	196	206	169	27	10
5523	RV_pair523	FakeDesc523	FakeAnc523	SIMULPF00001	544	543	589	498	45	46
5524	RV_pair524	FakeDesc524	FakeAnc524	SIMULPF00001	60	57	64	53	4	7
5525	RV_pair525	FakeDesc525	FakeAnc525	SIMULPF00001	176	167	185	158	9	18
5526	RV_pair526	FakeDesc526	FakeAnc526	SIMULPF00001	90	93	101	82	11	8
5527	RV_pair527	FakeDesc527	FakeAnc527	SIMULPF00001	330	329	360	299	30	31
5528	RV_pair528	FakeDesc528	FakeAnc528	SIMULPF00001	412	410	453	369	41	43
5529	RV_pair529	FakeDesc529	FakeAnc529	SIMULPF00001	435	449	486	398	51	37
5530	RV_pair530	FakeDesc530	FakeAnc530	SIMULPF00001	201	211	230	182	29	19
5531	RV_pair531	FakeDesc531	FakeAnc531	SIMULPF00001	89	91	99	81	10	8
5532	RV_pair532	FakeDesc532	FakeAnc532	SIMULPF00001	122	129	139	112	17	10
5533	RV_pair533	FakeDesc533	FakeAnc533	SIMULPF00001	29	25	29	25	0	4
5534	RV_pair534	FakeDesc534	FakeAnc534	SIMULPF00001	172	164	188	148	16	24
5535	RV_pair535	FakeDesc535	FakeAnc535	SIMULPF00001	13	14	14	13	1	0
5536	RV_pair536	FakeDesc536	FakeAnc536	SIMULPF00001	376	360	396	340	20	36
5537	RV_pair537	FakeDesc537	FakeAnc537	SIMULPF00001	891	874	971	794	80	97
5538	RV_pair538	FakeDesc538	FakeAnc538	SIMULPF00001	743	745	805	683	62	60
5539	RV_pair539	FakeDesc539	FakeAnc539	SIMULPF00001	82	72	85	69	3	13
5540	RV_pair540	FakeDesc540	FakeAnc540	SIMULPF00001	326	337	362	301	36	25
5541	RV_pair541	FakeDesc541	FakeAnc541	SIMULPF00001	185	186	200	171	15	14
5542	RV_pair542	FakeDesc542	FakeAnc542	SIMULPF00001	96	96	104	88	8	8
5543	RV_pair543	FakeDesc543	FakeAnc543	SIMULPF00001	174	187	202	159	28	15
5544	RV_pair544	FakeDesc544	FakeAnc544	SIMULPF00001	84	82	91	75	7	9
5545	RV_pair545	FakeDesc545	FakeAnc545	SIMULPF00001	96	93	108	81	12	15
5546	RV_pair546	FakeDesc546	FakeAnc546	SIMULPF00001	370	364	396	338	26	32
5547	RV_pair547	FakeDesc547	FakeAnc547	SIMULPF00001	2	2	2	2	0	0
5548	RV_pair548	FakeDesc548	FakeAnc548	SIMULPF00001	105	97	109	93	4	12
5549	RV_pair549	FakeDesc549	FakeAnc549	SIMULPF00001	118	109	125	102	7	16
5550	RV_pair550	FakeDesc550	FakeAnc550	SIMULPF00001	171	183	196	158	25	13
5551	RV_pair551	FakeDesc551	FakeAnc551	SIMULPF00001	103	101	115	89	12	14
5552	RV_pair552	FakeDesc552	FakeAnc552	SIMULPF00001	210	198	225	183	15	27
5553	RV_pair553	FakeDesc553	FakeAnc553	SIMULPF00001	458	455	502	411	44	47
5554	RV_pair554	FakeDesc554	FakeAnc554	SIMULPF00001	208	211	235	184	27	24
5555	RV_pair555	FakeDesc555	FakeAnc555	SIMULPF00001	1	6	6	1	5	0
5556	RV_pair556	FakeDesc556	FakeAnc556	SIMULPF00001	407	428	460	375	53	32
5557	RV_pair557	FakeDesc557	FakeAnc557	SIMULPF00001	217	218	238	197	21	20
5558	RV_pair558	FakeDesc558	FakeAnc558	SIMULPF00001	251	248	277	222	26	29
5559	RV_pair559	FakeDesc559	FakeAnc559	SIMULPF00001	507	509	560	456	53	51
5560	RV_pair560	FakeDesc560	FakeAnc560	SIMULPF00001	71	69	76	64	5	7
5561	RV_pair561	FakeDesc561	FakeAnc561	SIMULPF00001	227	224	240	211	13	16
5562	RV_pair562	FakeDesc562	FakeAnc562	SIMULPF00001	3	4	4	3	1	0
5563	RV_pair563	FakeDesc563	FakeAnc563	SIMULPF00001	364	359	390	333	26	31
5564	RV_pair564	FakeDesc564	FakeAnc564	SIMULPF00001	40	43	46	37	6	3
5565	RV_pair565	FakeDesc565	FakeAnc565	SIMULPF00001	93	94	103	84	10	9
5566	RV_pair566	FakeDesc566	FakeAnc566	SIMULPF00001	884	863	966	781	82	103
5567	RV_pair567	FakeDesc567	FakeAnc567	SIMULPF00001	768	770	836	702	68	66
5568	RV_pair568	FakeDesc568	FakeAnc568	SIMULPF00001	30	31	35	26	5	4
5569	RV_pair569	FakeDesc569	FakeAnc569	SIMULPF00001	239	236	260	215	21	24
5570	RV_pair570	FakeDesc570	FakeAnc570	SIMULPF00001	520	500	557	463	37	57
5571	RV_pair571	FakeDesc571	FakeAnc571	SIMULPF00001	619	601	673	547	54	72
5572	RV_pair572	FakeDesc572	FakeAnc572	SIMULPF00001	84	80	95	69	11	15
5573	RV_pair573	FakeDesc573	FakeAnc573	SIMULPF00001	184	184	198	170	14	14
5574	RV_pair574	FakeDesc574	FakeAnc574	SIMULPF00001	513	521	567	467	54	46
5575	RV_pair575	FakeDesc575	FakeAnc575	SIMULPF00001	168	169	180	157	12	11
5576	RV_pair576	FakeDesc576	FakeAnc576	SIMULPF00001	66	65	72	59	6	7
5577	RV_pair577	FakeDesc577	FakeAnc577	SIMULPF00001	680	659	724	615	44	65
5578	RV_pair578	FakeDesc578	FakeAnc578	SIMULPF00001	41	38	45	34	4	7
5579	RV_pair579	FakeDesc579	FakeAnc579	SIMULPF00001	15	14	15	14	0	1
5580	RV_pair580	FakeDesc580	FakeAnc580	SIMULPF00001	73	79	85	67	12	6
5581	RV_pair581	FakeDesc581	FakeAnc581	SIMULPF00001	416	419	451	384	35	32
5582	RV_pair582	FakeDesc582	FakeAnc582	SIMULPF00001	25	27	27	25	2	0
5583	RV_pair583	FakeDesc583	FakeAnc583	SIMULPF00001	82	72	86	68	4	14
5584	RV_pair584	FakeDesc584	FakeAnc584	SIMULPF00001	124	120	133	111	9	13
5585	RV_pair585	FakeDesc585	FakeAnc585	SIMULPF00001	160	153	172	141	12	19
5586	RV_pair586	FakeDesc586	FakeAnc586	SIMULPF00001	167	167	177	157	10	10
5587	RV_pair587	FakeDesc587	FakeAnc587	SIMULPF00001	106	105	110	101	4	5
5588	RV_pair588	FakeDesc588	FakeAnc588	SIMULPF00001	64	66	69	61	5	3
5589	RV_pair589	FakeDesc589	FakeAnc589	SIMULPF00001	247	251	270	228	23	19
5590	RV_pair590	FakeDesc590	FakeAnc590	SIMULPF00001	471	462	505	428	34	43
5591	RV_pair591	FakeDesc591	FakeAnc591	SIMULPF00001	44	41	48	37	4	7
5592	RV_pair592	FakeDesc592	FakeAnc592	SIMULPF00001	68	71	75	64	7	4
5593	RV_pair593	FakeDesc593	FakeAnc593	SIMULPF00001	353	353	377	329	24	24
5594	RV_pair594	FakeDesc594	FakeAnc594	SIMULPF00001	107	101	111	97	4	10
5595	RV_pair595	FakeDesc595	FakeAnc595	SIMULPF00001	414	413	448	379	34	35
5596	RV_pair596	FakeDesc596	FakeAnc596	SIMULPF00001	32	34	35	31	3	1
5597	RV_pair597	FakeDesc597	FakeAnc597	SIMULPF00001	77	74	85	66	8	11
5598	RV_pair598	FakeDesc598	FakeAnc598	SIMULPF00001	102	94	110	86	8	16
5599	RV_pair599	FakeDesc599	FakeAnc599	SIMULPF00001	238	233	261	210	23	28
5600	RV_pair600	FakeDesc600	FakeAnc600	SIMULPF00001	256	262	283	235	27	21
5601	RV_pair601	FakeDesc601	FakeAnc601	SIMULPF00001	290	281	315	256	25	34
5602	RV_pair602	FakeDesc602	FakeAnc602	SIMULPF00001	635	625	695	565	60	70
5603	RV_pair603	FakeDesc603	FakeAnc603	SIMULPF00001	13	10	13	10	0	3
5604	RV_pair604	FakeDesc604	FakeAnc604	SIMULPF00001	69	66	73	62	4	7
5605	RV_pair605	FakeDesc605	FakeAnc605	SIMULPF00001	516	522	570	468	54	48
5606	RV_pair606	FakeDesc606	FakeAnc606	SIMULPF00001	10	11	13	8	3	2
5607	RV_pair607	FakeDesc607	FakeAnc607	SIMULPF00001	2	2	2	2	0	0
5608	RV_pair608	FakeDesc608	FakeAnc608	SIMULPF00001	643	631	686	588	43	55
5609	RV_pair609	FakeDesc609	FakeAnc609	SIMULPF00001	266	261	283	244	17	22
5610	RV_pair610	FakeDesc610	FakeAnc610	SIMULPF00001	408	393	438	363	30	45
5611	RV_pair611	FakeDesc611	FakeAnc611	SIMULPF00001	360	361	392	329	32	31
5612	RV_pair612	FakeDesc612	FakeAnc612	SIMULPF00001	102	101	110	93	8	9
5613	RV_pair613	FakeDesc613	FakeAnc613	SIMULPF00001	280	297	311	266	31	14
5614	RV_pair614	FakeDesc614	FakeAnc614	SIMULPF00001	29	31	33	27	4	2
5615	RV_pair615	FakeDesc615	FakeAnc615	SIMULPF00001	158	160	174	144	16	14
5616	RV_pair616	FakeDesc616	FakeAnc616	SIMULPF00001	173	163	188	148	15	25
5617	RV_pair617	FakeDesc617	FakeAnc617	SIMULPF00001	383	398	431	350	48	33
5618	RV_pair618	FakeDesc618	FakeAnc618	SIMULPF00001	448	466	492	422	44	26
5619	RV_pair619	FakeDesc619	FakeAnc619	SIMULPF00001	274	275	297	252	23	22
5620	RV_pair620	FakeDesc620	FakeAnc620	SIMULPF00001	587	588	643	532	56	55
5621	RV_pair621	FakeDesc621	FakeAnc621	SIMULPF00001	814	807	892	729	78	85
5622	RV_pair622	FakeDesc622	FakeAnc622	SIMULPF00001	26	27	30	23	4	3
5623	RV_pair623	FakeDesc623	FakeAnc623	SIMULPF00001	9	9	9	9	0	0
5624	RV_pair624	FakeDesc624	FakeAnc624	SIMULPF00001	436	452	487	401	51	35
5625	RV_pair625	FakeDesc625	FakeAnc625	SIMULPF00001	53	53	55	51	2	2
5626	RV_pair626	FakeDesc626	FakeAnc626	SIMULPF00001	504	512	549	467	45	37
5627	RV_pair627	FakeDesc627	FakeAnc627	SIMULPF00001	86	85	96	75	10	11
5628	RV_pair628	FakeDesc628	FakeAnc628	SIMULPF00001	45	47	52	40	7	5
5629	RV_pair629	FakeDesc629	FakeAnc629	SIMULPF00001	37	37	44	30	7	7
5630	RV_pair630	FakeDesc630	FakeAnc630	SIMULPF00001	418	428	467	379	49	39
5631	RV_pair631	FakeDesc631	FakeAnc631	SIMULPF00001	121	125	135	111	14	10
5632	RV_pair632	FakeDesc632	FakeAnc632	SIMULPF00001	146	155	161	140	15	6
5633	RV_pair633	FakeDesc633	FakeAnc633	SIMULPF00001	405	406	439	372	34	33
5634	RV_pair634	FakeDesc634	FakeAnc634	SIMULPF00001	415	435	476	374	61	41
5635	RV_pair635	FakeDesc635	FakeAnc635	SIMULPF00001	714	719	787	646	73	68
5636	RV_pair636	FakeDesc636	FakeAnc636	SIMULPF00001	119	131	140	110	21	9
5637	RV_pair637	FakeDesc637	FakeAnc637	SIMULPF00001	92	89	97	84	5	8
5638	RV_pair638	FakeDesc638	FakeAnc638	SIMULPF00001	2	2	2	2	0	0
5639	RV_pair639	FakeDesc639	FakeAnc639	SIMULPF00001	122	132	140	114	18	8
5640	RV_pair640	FakeDesc640	FakeAnc640	SIMULPF00001	392	387	420	359	28	33
5641	RV_pair641	FakeDesc641	FakeAnc641	SIMULPF00001	242	243	263	222	21	20
5642	RV_pair642	FakeDesc642	FakeAnc642	SIMULPF00001	3	3	3	3	0	0
5643	RV_pair643	FakeDesc643	FakeAnc643	SIMULPF00001	100	102	108	94	8	6
5644	RV_pair644	FakeDesc644	FakeAnc644	SIMULPF00001	74	74	82	66	8	8
5645	RV_pair645	FakeDesc645	FakeAnc645	SIMULPF00001	14	12	16	10	2	4
5646	RV_pair646	FakeDesc646	FakeAnc646	SIMULPF00001	106	111	117	100	11	6
5647	RV_pair647	FakeDesc647	FakeAnc647	SIMULPF00001	80	76	86	70	6	10
5648	RV_pair648	FakeDesc648	FakeAnc648	SIMULPF00001	83	83	92	74	9	9
5649	RV_pair649	FakeDesc649	FakeAnc649	SIMULPF00001	166	173	186	153	20	13
5650	RV_pair650	FakeDesc650	FakeAnc650	SIMULPF00001	17	17	19	15	2	2
5651	RV_pair651	FakeDesc651	FakeAnc651	SIMULPF00001	437	451	486	402	49	35
5652	RV_pair652	FakeDesc652	FakeAnc652	SIMULPF00001	34	35	36	33	2	1
5653	RV_pair653	FakeDesc653	FakeAnc653	SIMULPF00001	37	39	40	36	3	1
5654	RV_pair654	FakeDesc654	FakeAnc654	SIMULPF00001	524	498	552	470	28	54
5655	RV_pair655	FakeDesc655	FakeAnc655	SIMULPF00001	288	279	312	255	24	33
5656	RV_pair656	FakeDesc656	FakeAnc656	SIMULPF00001	291	298	320	269	29	22
5657	RV_pair657	FakeDesc657	FakeAnc657	SIMULPF00001	513	506	559	460	46	53
5658	RV_pair658	FakeDesc658	FakeAnc658	SIMULPF00001	16	15	16	15	0	1
5659	RV_pair659	FakeDesc659	FakeAnc659	SIMULPF00001	184	193	210	167	26	17
5660	RV_pair660	FakeDesc660	FakeAnc660	SIMULPF00001	70	75	77	68	7	2
5661	RV_pair661	FakeDesc661	FakeAnc661	SIMULPF00001	467	455	501	421	34	46
5662	RV_pair662	FakeDesc662	FakeAnc662	SIMULPF00001	86	103	105	84	19	2
5663	RV_pair663	FakeDesc663	FakeAnc663	SIMULPF00001	1	1	1	1	0	0
5664	RV_pair664	FakeDesc664	FakeAnc664	SIMULPF00001	487	513	550	450	63	37
5665	RV_pair665	FakeDesc665	FakeAnc665	SIMULPF00001	732	732	808	656	76	76
5666	RV_pair666	FakeDesc666	FakeAnc666	SIMULPF00001	127	127	136	118	9	9
5667	RV_pair667	FakeDesc667	FakeAnc667	SIMULPF00001	52	45	57	40	5	12
5668	RV_pair668	FakeDesc668	FakeAnc668	SIMULPF00001	113	115	129	99	16	14
5669	RV_pair669	FakeDesc669	FakeAnc669	SIMULPF00001	48	48	56	40	8	8
5670	RV_pair670	FakeDesc670	FakeAnc670	SIMULPF00001	226	225	238	213	12	13
5671	RV_pair671	FakeDesc671	FakeAnc671	SIMULPF00001	25	26	28	23	3	2
5672	RV_pair672	FakeDesc672	FakeAnc672	SIMULPF00001	262	246	274	234	12	28
5673	RV_pair673	FakeDesc673	FakeAnc673	SIMULPF00001	455	462	503	414	48	41
5674	RV_pair674	FakeDesc674	FakeAnc674	SIMULPF00001	299	306	337	268	38	31
5675	RV_pair675	FakeDesc675	FakeAnc675	SIMULPF00001	46	46	51	41	5	5
5676	RV_pair676	FakeDesc676	FakeAnc676	SIMULPF00001	41	39	43	37	2	4
5677	RV_pair677	FakeDesc677	FakeAnc677	SIMULPF00001	278	284	309	253	31	25
5678	RV_pair678	FakeDesc678	FakeAnc678	SIMULPF00001	155	149	166	138	11	17
5679	RV_pair679	FakeDesc679	FakeAnc679	SIMULPF00001	106	114	120	100	14	6
5680	RV_pair680	FakeDesc680	FakeAnc680	SIMULPF00001	80	78	86	72	6	8
5681	RV_pair681	FakeDesc681	FakeAnc681	SIMULPF00001	433	463	490	406	57	27
5682	RV_pair682	FakeDesc682	FakeAnc682	SIMULPF00001	116	123	133	106	17	10
5683	RV_pair683	FakeDesc683	FakeAnc683	SIMULPF00001	423	419	457	385	34	38
5684	RV_pair684	FakeDesc684	FakeAnc684	SIMULPF00001	828	800	904	724	76	104
5685	RV_pair685	FakeDesc685	FakeAnc685	SIMULPF00001	14	16	16	14	2	0
5686	RV_pair686	FakeDesc686	FakeAnc686	SIMULPF00001	536	539	585	490	49	46
5687	RV_pair687	FakeDesc687	FakeAnc687	SIMULPF00001	231	239	257	213	26	18
5688	RV_pair688	FakeDesc688	FakeAnc688	SIMULPF00001	133	141	148	126	15	7
5689	RV_pair689	FakeDesc689	FakeAnc689	SIMULPF00001	553	571	622	502	69	51
5690	RV_pair690	FakeDesc690	FakeAnc690	SIMULPF00001	104	109	114	99	10	5
5691	RV_pair691	FakeDesc691	FakeAnc691	SIMULPF00001	259	261	292	228	33	31
5692	RV_pair692	FakeDesc692	FakeAnc692	SIMULPF00001	364	366	399	331	35	33
5693	RV_pair693	FakeDesc693	FakeAnc693	SIMULPF00001	122	121	131	112	9	10
5694	RV_pair694	FakeDesc694	FakeAnc694	SIMULPF00001	100	99	104	95	4	5
5695	RV_pair695	FakeDesc695	FakeAnc695	SIMULPF00001	349	363	380	332	31	17
5696	RV_pair696	FakeDesc696	FakeAnc696	SIMULPF00001	205	210	226	189	21	16
5697	RV_pair697	FakeDesc697	FakeAnc697	SIMULPF00001	247	240	267	220	20	27
5698	RV_pair698	FakeDesc698	FakeAnc698	SIMULPF00001	214	226	238	202	24	12
5699	RV_pair699	FakeDesc699	FakeAnc699	SIMULPF00001	144	149	159	134	15	10
5700	RV_pair700	FakeDesc700	FakeAnc700	SIMULPF00001	421	412	451	382	30	39
5701	RV_pair701	FakeDesc701	FakeAnc701	SIMULPF00001	227	234	257	204	30	23
5702	RV_pair702	FakeDesc702	FakeAnc702	SIMULPF00001	567	587	628	526	61	41
5703	RV_pair703	FakeDesc703	FakeAnc703	SIMULPF00001	40	40	44	36	4	4
5704	RV_pair704	FakeDesc704	FakeAnc704	SIMULPF00001	205	214	232	187	27	18
5705	RV_pair705	FakeDesc705	FakeAnc705	SIMULPF00001	135	131	144	122	9	13
5706	RV_pair706	FakeDesc706	FakeAnc706	SIMULPF00001	136	145	160	121	24	15
5707	RV_pair707	FakeDesc707	FakeAnc707	SIMULPF00001	25	28	30	23	5	2
5708	RV_pair708	FakeDesc708	FakeAnc708	SIMULPF00001	27	25	31	21	4	6
5709	RV_pair709	FakeDesc709	FakeAnc709	SIMULPF00001	809	820	890	739	81	70
5710	RV_pair710	FakeDesc710	FakeAnc710	SIMULPF00001	241	243	265	219	24	22
5711	RV_pair711	FakeDesc711	FakeAnc711	SIMULPF00001	138	139	146	131	8	7
5712	RV_pair712	FakeDesc712	FakeAnc712	SIMULPF00001	25	24	30	19	5	6
5713	RV_pair713	FakeDesc713	FakeAnc713	SIMULPF00001	32	31	36	27	4	5
5714	RV_pair714	FakeDesc714	FakeAnc714	SIMULPF00001	492	476	528	440	36	52
5715	RV_pair715	FakeDesc715	FakeAnc715	SIMULPF00001	67	68	73	62	6	5
5716	RV_pair716	FakeDesc716	FakeAnc716	SIMULPF00001	718	720	793	645	75	73
5717	RV_pair717	FakeDesc717	FakeAnc717	SIMULPF00001	83	84	89	78	6	5
5718	RV_pair718	FakeDesc718	FakeAnc718	SIMULPF00001	16	17	17	16	1	0
5719	RV_pair719	FakeDesc719	FakeAnc719	SIMULPF00001	46	46	49	43	3	3
5720	RV_pair720	FakeDesc720	FakeAnc720	SIMULPF00001	735	712	795	652	60	83
5721	RV_pair721	FakeDesc721	FakeAnc721	SIMULPF00001	29	32	34	27	5	2
5722	RV_pair722	FakeDesc722	FakeAnc722	SIMULPF00001	415	423	464	374	49	41
5723	RV_pair723	FakeDesc723	FakeAnc723	SIMULPF00001	273	272	291	254	18	19
5724	RV_pair724	FakeDesc724	FakeAnc724	SIMULPF00001	177	175	197	155	20	22
5725	RV_pair725	FakeDesc725	FakeAnc725	SIMULPF00001	79	86	94	71	15	8
5726	RV_pair726	FakeDesc726	FakeAnc726	SIMULPF00001	355	345	377	323	22	32
5727	RV_pair727	FakeDesc727	FakeAnc727	SIMULPF00001	58	54	61	51	3	7
5728	RV_pair728	FakeDesc728	FakeAnc728	SIMULPF00001	107	110	115	102	8	5
5729	RV_pair729	FakeDesc729	FakeAnc729	SIMULPF00001	216	213	238	191	22	25
5730	RV_pair730	FakeDesc730	FakeAnc730	SIMULPF00001	5	7	7	5	2	0
5731	RV_pair731	FakeDesc731	FakeAnc731	SIMULPF00001	290	293	323	260	33	30
5732	RV_pair732	FakeDesc732	FakeAnc732	SIMULPF00001	403	401	441	363	38	40
5733	RV_pair733	FakeDesc733	FakeAnc733	SIMULPF00001	426	423	476	373	50	53
5734	RV_pair734	FakeDesc734	FakeAnc734	SIMULPF00001	589	575	646	518	57	71
5735	RV_pair735	FakeDesc735	FakeAnc735	SIMULPF00001	15	16	17	14	2	1
5736	RV_pair736	FakeDesc736	FakeAnc736	SIMULPF00001	346	327	376	297	30	49
5737	RV_pair737	FakeDesc737	FakeAnc737	SIMULPF00001	110	112	120	102	10	8
5738	RV_pair738	FakeDesc738	FakeAnc738	SIMULPF00001	88	88	97	79	9	9
5739	RV_pair739	FakeDesc739	FakeAnc739	SIMULPF00001	99	98	108	89	9	10
5740	RV_pair740	FakeDesc740	FakeAnc740	SIMULPF00001	442	409	474	377	32	65
5741	RV_pair741	FakeDesc741	FakeAnc741	SIMULPF00001	247	246	272	221	25	26
5742	RV_pair742	FakeDesc742	FakeAnc742	SIMULPF00001	372	381	413	340	41	32
5743	RV_pair743	FakeDesc743	FakeAnc743	SIMULPF00001	93	92	103	82	10	11
5744	RV_pair744	FakeDesc744	FakeAnc744	SIMULPF00001	322	309	346	285	24	37
5745	RV_pair745	FakeDesc745	FakeAnc745	SIMULPF00001	637	613	683	567	46	70
5746	RV_pair746	FakeDesc746	FakeAnc746	SIMULPF00001	38	36	40	34	2	4
5747	RV_pair747	FakeDesc747	FakeAnc747	SIMULPF00001	83	89	96	76	13	7
5748	RV_pair748	FakeDesc748	FakeAnc748	SIMULPF00001	645	628	697	576	52	69
5749	RV_pair749	FakeDesc749	FakeAnc749	SIMULPF00001	39	37	43	33	4	6
5750	RV_pair750	FakeDesc750	FakeAnc750	SIMULPF00001	39	50	51	38	12	1
5751	RV_pair751	FakeDesc751	FakeAnc751	SIMULPF00001	87	86	91	82	4	5
5752	RV_pair752	FakeDesc752	FakeAnc752	SIMULPF00001	61	57	65	53	4	8
5753	RV_pair753	FakeDesc753	FakeAnc753	SIMULPF00001	145	139	153	131	8	14
5754	RV_pair754	FakeDesc754	FakeAnc754	SIMULPF00001	23	18	24	17	1	6
5755	RV_pair755	FakeDesc755	FakeAnc755	SIMULPF00001	2	3	3	2	1	0
5756	RV_pair756	FakeDesc756	FakeAnc756	SIMULPF00001	506	524	569	461	63	45
5757	RV_pair757	FakeDesc757	FakeAnc757	SIMULPF00001	176	163	185	154	9	22
5758	RV_pair758	FakeDesc758	FakeAnc758	SIMULPF00001	7	5	7	5	0	2
5759	RV_pair759	FakeDesc759	FakeAnc759	SIMULPF00001	103	111	117	97	14	6
5760	RV_pair760	FakeDesc760	FakeAnc760	SIMULPF00001	233	247	265	215	32	18
5761	RV_pair761	FakeDesc761	FakeAnc761	SIMULPF00001	25	24	25	24	0	1
5762	RV_pair762	FakeDesc762	FakeAnc762	SIMULPF00001	249	254	276	227	27	22
5763	RV_pair763	FakeDesc763	FakeAnc763	SIMULPF00001	487	486	535	438	48	49
5764	RV_pair764	FakeDesc764	FakeAnc764	SIMULPF00001	381	387	415	353	34	28
5765	RV_pair765	FakeDesc765	FakeAnc765	SIMULPF00001	686	675	752	609	66	77
5766	RV_pair766	FakeDesc766	FakeAnc766	SIMULPF00001	654	648	712	590	58	64
5767	RV_pair767	FakeDesc767	FakeAnc767	SIMULPF00001	39	33	41	31	2	8
5768	RV_pair768	FakeDesc768	FakeAnc768	SIMULPF00001	102	107	114	95	12	7
5769	RV_pair769	FakeDesc769	FakeAnc769	SIMULPF00001	66	69	76	59	10	7
5770	RV_pair770	FakeDesc770	FakeAnc770	SIMULPF00001	203	196	211	188	8	15
5771	RV_pair771	FakeDesc771	FakeAnc771	SIMULPF00001	40	41	42	39	2	1
5772	RV_pair772	FakeDesc772	FakeAnc772	SIMULPF00001	441	428	476	393	35	48
5773	RV_pair773	FakeDesc773	FakeAnc773	SIMULPF00001	62	54	66	50	4	12
5774	RV_pair774	FakeDesc774	FakeAnc774	SIMULPF00001	92	97	102	87	10	5
5775	RV_pair775	FakeDesc775	FakeAnc775	SIMULPF00001	526	512	568	470	42	56
5776	RV_pair776	FakeDesc776	FakeAnc776	SIMULPF00001	109	112	123	98	14	11
5777	RV_pair777	FakeDesc777	FakeAnc777	SIMULPF00001	149	149	166	132	17	17
5778	RV_pair778	FakeDesc778	FakeAnc778	SIMULPF00001	445	455	490	410	45	35
5779	RV_pair779	FakeDesc779	FakeAnc779	SIMULPF00001	228	234	253	209	25	19
5780	RV_pair780	FakeDesc780	FakeAnc780	SIMULPF00001	521	517	569	469	48	52
5781	RV_pair781	FakeDesc781	FakeAnc781	SIMULPF00001	369	367	404	332	35	37
5782	RV_pair782	FakeDesc782	FakeAnc782	SIMULPF00001	71	72	76	67	5	4
5783	RV_pair783	FakeDesc783	FakeAnc783	SIMULPF00001	44	43	50	37	6	7
5784	RV_pair784	FakeDesc784	FakeAnc784	SIMULPF00001	137	130	147	120	10	17
5785	RV_pair785	FakeDesc785	FakeAnc785	SIMULPF00001	396	412	445	363	49	33
5786	RV_pair786	FakeDesc786	FakeAnc786	SIMULPF00001	156	152	176	132	20	24
5787	RV_pair787	FakeDesc787	FakeAnc787	SIMULPF00001	394	381	429	346	35	48
5788	RV_pair788	FakeDesc788	FakeAnc788	SIMULPF00001	405	400	439	366	34	39
5789	RV_pair789	FakeDesc789	FakeAnc789	SIMULPF00001	107	111	116	102	9	5
5790	RV_pair790	FakeDesc790	FakeAnc790	SIMULPF00001	171	163	184	150	13	21
5791	RV_pair791	FakeDesc791	FakeAnc791	SIMULPF00001	70	66	75	61	5	9
5792	RV_pair792	FakeDesc792	FakeAnc792	SIMULPF00001	382	388	420	350	38	32
5793	RV_pair793	FakeDesc793	FakeAnc793	SIMULPF00001	174	182	204	152	30	22
5794	RV_pair794	FakeDesc794	FakeAnc794	SIMULPF00001	104	110	121	93	17	11
5795	RV_pair795	FakeDesc795	FakeAnc795	SIMULPF00001	804	810	881	733	77	71
5796	RV_pair796	FakeDesc796	FakeAnc796	SIMULPF00001	308	316	338	286	30	22
5797	RV_pair797	FakeDesc797	FakeAnc797	SIMULPF00001	29	35	35	29	6	0
5798	RV_pair798	FakeDesc798	FakeAnc798	SIMULPF00001	114	118	123	109	9	5
5799	RV_pair799	FakeDesc799	FakeAnc799	SIMULPF00001	15	15	15	15	0	0
5800	RV_pair800	FakeDesc800	FakeAnc800	SIMULPF00001	432	443	480	395	48	37
5801	RV_pair801	FakeDesc801	FakeAnc801	SIMULPF00001	178	174	193	159	15	19
5802	RV_pair802	FakeDesc802	FakeAnc802	SIMULPF00001	521	535	567	489	46	32
5803	RV_pair803	FakeDesc803	FakeAnc803	SIMULPF00001	299	306	337	268	38	31
5804	RV_pair804	FakeDesc804	FakeAnc804	SIMULPF00001	69	65	70	64	1	5
5805	RV_pair805	FakeDesc805	FakeAnc805	SIMULPF00001	49	54	55	48	6	1
5806	RV_pair806	FakeDesc806	FakeAnc806	SIMULPF00001	439	445	491	393	52	46
5807	RV_pair807	FakeDesc807	FakeAnc807	SIMULPF00001	164	168	185	147	21	17
5808	RV_pair808	FakeDesc808	FakeAnc808	SIMULPF00001	219	222	240	201	21	18
5809	RV_pair809	FakeDesc809	FakeAnc809	SIMULPF00001	417	389	440	366	23	51
5810	RV_pair810	FakeDesc810	FakeAnc810	SIMULPF00001	104	100	111	93	7	11
5811	RV_pair811	FakeDesc811	FakeAnc811	SIMULPF00001	124	124	136	112	12	12
5812	RV_pair812	FakeDesc812	FakeAnc812	SIMULPF00001	150	140	160	130	10	20
5813	RV_pair813	FakeDesc813	FakeAnc813	SIMULPF00001	411	410	444	377	33	34
5814	RV_pair814	FakeDesc814	FakeAnc814	SIMULPF00001	100	104	113	91	13	9
5815	RV_pair815	FakeDesc815	FakeAnc815	SIMULPF00001	155	148	173	130	18	25
5816	RV_pair816	FakeDesc816	FakeAnc816	SIMULPF00001	173	173	186	160	13	13
5817	RV_pair817	FakeDesc817	FakeAnc817	SIMULPF00001	46	46	51	41	5	5
5818	RV_pair818	FakeDesc818	FakeAnc818	SIMULPF00001	126	126	137	115	11	11
5819	RV_pair819	FakeDesc819	FakeAnc819	SIMULPF00001	22	23	23	22	1	0
5820	RV_pair820	FakeDesc820	FakeAnc820	SIMULPF00001	85	87	93	79	8	6
5821	RV_pair821	FakeDesc821	FakeAnc821	SIMULPF00001	32	26	32	26	0	6
5822	RV_pair822	FakeDesc822	FakeAnc822	SIMULPF00001	99	93	104	88	5	11
5823	RV_pair823	FakeDesc823	FakeAnc823	SIMULPF00001	95	91	101	85	6	10
5824	RV_pair824	FakeDesc824	FakeAnc824	SIMULPF00001	188	184	199	173	11	15
5825	RV_pair825	FakeDesc825	FakeAnc825	SIMULPF00001	165	169	181	153	16	12
5826	RV_pair826	FakeDesc826	FakeAnc826	SIMULPF00001	35	37	38	34	3	1
5827	RV_pair827	FakeDesc827	FakeAnc827	SIMULPF00001	332	348	374	306	42	26
5828	RV_pair828	FakeDesc828	FakeAnc828	SIMULPF00001	551	542	601	492	50	59
5829	RV_pair829	FakeDesc829	FakeAnc829	SIMULPF00001	26	28	29	25	3	1
5830	RV_pair830	FakeDesc830	FakeAnc830	SIMULPF00001	557	545	599	503	42	54
5831	RV_pair831	FakeDesc831	FakeAnc831	SIMULPF00001	135	134	148	121	13	14
5832	RV_pair832	FakeDesc832	FakeAnc832	SIMULPF00001	89	85	96	78	7	11
5833	RV_pair833	FakeDesc833	FakeAnc833	SIMULPF00001	119	120	130	109	11	10
5834	RV_pair834	FakeDesc834	FakeAnc834	SIMULPF00001	88	94	101	81	13	7
5835	RV_pair835	FakeDesc835	FakeAnc835	SIMULPF00001	394	412	439	367	45	27
5836	RV_pair836	FakeDesc836	FakeAnc836	SIMULPF00001	784	775	845	714	61	70
5837	RV_pair837	FakeDesc837	FakeAnc837	SIMULPF00001	505	498	547	456	42	49
5838	RV_pair838	FakeDesc838	FakeAnc838	SIMULPF00001	409	404	446	367	37	42
5839	RV_pair839	FakeDesc839	FakeAnc839	SIMULPF00001	54	50	56	48	2	6
5840	RV_pair840	FakeDesc840	FakeAnc840	SIMULPF00001	446	430	470	406	24	40
5841	RV_pair841	FakeDesc841	FakeAnc841	SIMULPF00001	119	127	136	110	17	9
5842	RV_pair842	FakeDesc842	FakeAnc842	SIMULPF00001	4	4	4	4	0	0
5843	RV_pair843	FakeDesc843	FakeAnc843	SIMULPF00001	406	421	444	383	38	23
5844	RV_pair844	FakeDesc844	FakeAnc844	SIMULPF00001	422	424	464	382	42	40
5845	RV_pair845	FakeDesc845	FakeAnc845	SIMULPF00001	3	4	4	3	1	0
5846	RV_pair846	FakeDesc846	FakeAnc846	SIMULPF00001	65	61	72	54	7	11
5847	RV_pair847	FakeDesc847	FakeAnc847	SIMULPF00001	181	182	197	166	16	15
5848	RV_pair848	FakeDesc848	FakeAnc848	SIMULPF00001	185	178	198	165	13	20
5849	RV_pair849	FakeDesc849	FakeAnc849	SIMULPF00001	799	811	882	728	83	71
5850	RV_pair850	FakeDesc850	FakeAnc850	SIMULPF00001	23	25	26	22	3	1
5851	RV_pair851	FakeDesc851	FakeAnc851	SIMULPF00001	333	316	355	294	22	39
5852	RV_pair852	FakeDesc852	FakeAnc852	SIMULPF00001	127	128	135	120	8	7
5853	RV_pair853	FakeDesc853	FakeAnc853	SIMULPF00001	228	227	249	206	21	22
5854	RV_pair854	FakeDesc854	FakeAnc854	SIMULPF00001	230	230	251	209	21	21
5855	RV_pair855	FakeDesc855	FakeAnc855	SIMULPF00001	103	98	109	92	6	11
5856	RV_pair856	FakeDesc856	FakeAnc856	SIMULPF00001	412	411	449	374	37	38
5857	RV_pair857	FakeDesc857	FakeAnc857	SIMULPF00001	156	177	184	149	28	7
5858	RV_pair858	FakeDesc858	FakeAnc858	SIMULPF00001	152	159	166	145	14	7
5859	RV_pair859	FakeDesc859	FakeAnc859	SIMULPF00001	29	29	31	27	2	2
5860	RV_pair860	FakeDesc860	FakeAnc860	SIMULPF00001	113	117	128	102	15	11
5861	RV_pair861	FakeDesc861	FakeAnc861	SIMULPF00001	318	322	343	297	25	21
5862	RV_pair862	FakeDesc862	FakeAnc862	SIMULPF00001	150	158	168	140	18	10
5863	RV_pair863	FakeDesc863	FakeAnc863	SIMULPF00001	36	30	37	29	1	7
5864	RV_pair864	FakeDesc864	FakeAnc864	SIMULPF00001	64	62	69	57	5	7
5865	RV_pair865	FakeDesc865	FakeAnc865	SIMULPF00001	285	276	309	252	24	33
5866	RV_pair866	FakeDesc866	FakeAnc866	SIMULPF00001	293	294	317	270	24	23
5867	RV_pair867	FakeDesc867	FakeAnc867	SIMULPF00001	140	133	149	124	9	16
5868	RV_pair868	FakeDesc868	FakeAnc868	SIMULPF00001	45	50	52	43	7	2
5869	RV_pair869	FakeDesc869	FakeAnc869	SIMULPF00001	149	153	169	133	20	16
5870	RV_pair870	FakeDesc870	FakeAnc870	SIMULPF00001	315	319	348	286	33	29
5871	RV_pair871	FakeDesc871	FakeAnc871	SIMULPF00001	275	279	309	245	34	30
5872	RV_pair872	FakeDesc872	FakeAnc872	SIMULPF00001	4	4	4	4	0	0
5873	RV_pair873	FakeDesc873	FakeAnc873	SIMULPF00001	223	219	241	201	18	22
5874	RV_pair874	FakeDesc874	FakeAnc874	SIMULPF00001	46	42	48	40	2	6
5875	RV_pair875	FakeDesc875	FakeAnc875	SIMULPF00001	227	232	252	207	25	20
5876	RV_pair876	FakeDesc876	FakeAnc876	SIMULPF00001	15	16	18	13	3	2
5877	RV_pair877	FakeDesc877	FakeAnc877	SIMULPF00001	152	164	170	146	18	6
5878	RV_pair878	FakeDesc878	FakeAnc878	SIMULPF00001	373	370	409	334	36	39
5879	RV_pair879	FakeDesc879	FakeAnc879	SIMULPF00001	154	162	168	148	14	6
5880	RV_pair880	FakeDesc880	FakeAnc880	SIMULPF00001	163	159	176	146	13	17
5881	RV_pair881	FakeDesc881	FakeAnc881	SIMULPF00001	11	11	12	10	1	1
5882	RV_pair882	FakeDesc882	FakeAnc882	SIMULPF00001	334	339	363	310	29	24
5883	RV_pair883	FakeDesc883	FakeAnc883	SIMULPF00001	252	242	264	230	12	22
5884	RV_pair884	FakeDesc884	FakeAnc884	SIMULPF00001	237	233	256	214	19	23
5885	RV_pair885	FakeDesc885	FakeAnc885	SIMULPF00001	32	32	34	30	2	2
5886	RV_pair886	FakeDesc886	FakeAnc886	SIMULPF00001	86	84	93	77	7	9
5887	RV_pair887	FakeDesc887	FakeAnc887	SIMULPF00001	795	804	863	736	68	59
5888	RV_pair888	FakeDesc888	FakeAnc888	SIMULPF00001	219	219	240	198	21	21
5889	RV_pair889	FakeDesc889	FakeAnc889	SIMULPF00001	470	472	511	431	41	39
5890	RV_pair890	FakeDesc890	FakeAnc890	SIMULPF00001	235	233	260	208	25	27
5891	RV_pair891	FakeDesc891	FakeAnc891	SIMULPF00001	85	83	88	80	3	5
5892	RV_pair892	FakeDesc892	FakeAnc892	SIMULPF00001	35	31	36	30	1	5
5893	RV_pair893	FakeDesc893	FakeAnc893	SIMULPF00001	4	6	6	4	2	0
5894	RV_pair894	FakeDesc894	FakeAnc894	SIMULPF00001	385	394	426	353	41	32
5895	RV_pair895	FakeDesc895	FakeAnc895	SIMULPF00001	148	144	158	134	10	14
5896	RV_pair896	FakeDesc896	FakeAnc896	SIMULPF00001	132	148	149	131	17	1
5897	RV_pair897	FakeDesc897	FakeAnc897	SIMULPF00001	150	144	162	132	12	18
5898	RV_pair898	FakeDesc898	FakeAnc898	SIMULPF00001	22	24	24	22	2	0
5899	RV_pair899	FakeDesc899	FakeAnc899	SIMULPF00001	60	70	71	59	11	1
5900	RV_pair900	FakeDesc900	FakeAnc900	SIMULPF00001	513	531	581	463	68	50
5901	RV_pair901	FakeDesc901	FakeAnc901	SIMULPF00001	89	90	99	80	10	9
5902	RV_pair902	FakeDesc902	FakeAnc902	SIMULPF00001	152	143	158	137	6	15
5903	RV_pair903	FakeDesc903	FakeAnc903	SIMULPF00001	107	106	118	95	11	12
5904	RV_pair904	FakeDesc904	FakeAnc904	SIMULPF00001	42	38	45	35	3	7
5905	RV_pair905	FakeDesc905	FakeAnc905	SIMULPF00001	129	136	143	122	14	7
5906	RV_pair906	FakeDesc906	FakeAnc906	SIMULPF00001	186	194	207	173	21	13
5907	RV_pair907	FakeDesc907	FakeAnc907	SIMULPF00001	56	46	58	44	2	12
5908	RV_pair908	FakeDesc908	FakeAnc908	SIMULPF00001	108	104	120	92	12	16
5909	RV_pair909	FakeDesc909	FakeAnc909	SIMULPF00001	547	550	602	495	55	52
5910	RV_pair910	FakeDesc910	FakeAnc910	SIMULPF00001	89	94	98	85	9	4
5911	RV_pair911	FakeDesc911	FakeAnc911	SIMULPF00001	234	234	259	209	25	25
5912	RV_pair912	FakeDesc912	FakeAnc912	SIMULPF00001	630	667	709	588	79	42
5913	RV_pair913	FakeDesc913	FakeAnc913	SIMULPF00001	710	728	785	653	75	57
5914	RV_pair914	FakeDesc914	FakeAnc914	SIMULPF00001	396	392	435	353	39	43
5915	RV_pair915	FakeDesc915	FakeAnc915	SIMULPF00001	114	126	130	110	16	4
5916	RV_pair916	FakeDesc916	FakeAnc916	SIMULPF00001	116	109	119	106	3	10
5917	RV_pair917	FakeDesc917	FakeAnc917	SIMULPF00001	186	182	197	171	11	15
5918	RV_pair918	FakeDesc918	FakeAnc918	SIMULPF00001	21	24	25	20	4	1
5919	RV_pair919	FakeDesc919	FakeAnc919	SIMULPF00001	302	293	323	272	21	30
5920	RV_pair920	FakeDesc920	FakeAnc920	SIMULPF00001	265	254	284	235	19	30
5921	RV_pair921	FakeDesc921	FakeAnc921	SIMULPF00001	58	59	66	51	8	7
5922	RV_pair922	FakeDesc922	FakeAnc922	SIMULPF00001	92	94	99	87	7	5
5923	RV_pair923	FakeDesc923	FakeAnc923	SIMULPF00001	917	925	995	847	78	70
5924	RV_pair924	FakeDesc924	FakeAnc924	SIMULPF00001	564	558	605	517	41	47
5925	RV_pair925	FakeDesc925	FakeAnc925	SIMULPF00001	272	276	289	259	17	13
5926	RV_pair926	FakeDesc926	FakeAnc926	SIMULPF00001	1	1	1	1	0	0
5927	RV_pair927	FakeDesc927	FakeAnc927	SIMULPF00001	274	284	296	262	22	12
5928	RV_pair928	FakeDesc928	FakeAnc928	SIMULPF00001	316	319	340	295	24	21
5929	RV_pair929	FakeDesc929	FakeAnc929	SIMULPF00001	429	411	466	374	37	55
5930	RV_pair930	FakeDesc930	FakeAnc930	SIMULPF00001	39	42	45	36	6	3
5931	RV_pair931	FakeDesc931	FakeAnc931	SIMULPF00001	144	153	159	138	15	6
5932	RV_pair932	FakeDesc932	FakeAnc932	SIMULPF00001	151	157	172	136	21	15
5933	RV_pair933	FakeDesc933	FakeAnc933	SIMULPF00001	236	238	263	211	27	25
5934	RV_pair934	FakeDesc934	FakeAnc934	SIMULPF00001	488	500	548	440	60	48
5935	RV_pair935	FakeDesc935	FakeAnc935	SIMULPF00001	121	123	135	109	14	12
5936	RV_pair936	FakeDesc936	FakeAnc936	SIMULPF00001	84	78	89	73	5	11
5937	RV_pair937	FakeDesc937	FakeAnc937	SIMULPF00001	490	477	534	433	44	57
5938	RV_pair938	FakeDesc938	FakeAnc938	SIMULPF00001	145	151	163	133	18	12
5939	RV_pair939	FakeDesc939	FakeAnc939	SIMULPF00001	200	193	214	179	14	21
5940	RV_pair940	FakeDesc940	FakeAnc940	SIMULPF00001	240	251	265	226	25	14
5941	RV_pair941	FakeDesc941	FakeAnc941	SIMULPF00001	450	459	489	420	39	30
5942	RV_pair942	FakeDesc942	FakeAnc942	SIMULPF00001	39	36	43	32	4	7
5943	RV_pair943	FakeDesc943	FakeAnc943	SIMULPF00001	570	563	619	514	49	56
5944	RV_pair944	FakeDesc944	FakeAnc944	SIMULPF00001	580	596	649	527	69	53
5945	RV_pair945	FakeDesc945	FakeAnc945	SIMULPF00001	152	144	160	136	8	16
5946	RV_pair946	FakeDesc946	FakeAnc946	SIMULPF00001	416	432	463	385	47	31
5947	RV_pair947	FakeDesc947	FakeAnc947	SIMULPF00001	512	508	554	466	42	46
5948	RV_pair948	FakeDesc948	FakeAnc948	SIMULPF00001	104	103	109	98	5	6
5949	RV_pair949	FakeDesc949	FakeAnc949	SIMULPF00001	121	119	131	109	10	12
5950	RV_pair950	FakeDesc950	FakeAnc950	SIMULPF00001	154	159	166	147	12	7
5951	RV_pair951	FakeDesc951	FakeAnc951	SIMULPF00001	141	137	154	124	13	17
5952	RV_pair952	FakeDesc952	FakeAnc952	SIMULPF00001	40	36	41	35	1	5
5953	RV_pair953	FakeDesc953	FakeAnc953	SIMULPF00001	46	46	48	44	2	2
5954	RV_pair954	FakeDesc954	FakeAnc954	SIMULPF00001	169	172	186	155	17	14
5955	RV_pair955	FakeDesc955	FakeAnc955	SIMULPF00001	392	383	422	353	30	39
5956	RV_pair956	FakeDesc956	FakeAnc956	SIMULPF00001	222	218	240	200	18	22
5957	RV_pair957	FakeDesc957	FakeAnc957	SIMULPF00001	487	495	538	444	51	43
5958	RV_pair958	FakeDesc958	FakeAnc958	SIMULPF00001	402	381	434	349	32	53
5959	RV_pair959	FakeDesc959	FakeAnc959	SIMULPF00001	126	129	138	117	12	9
5960	RV_pair960	FakeDesc960	FakeAnc960	SIMULPF00001	17	17	18	16	1	1
5961	RV_pair961	FakeDesc961	FakeAnc961	SIMULPF00001	7	11	11	7	4	0
5962	RV_pair962	FakeDesc962	FakeAnc962	SIMULPF00001	6	9	10	5	4	1
5963	RV_pair963	FakeDesc963	FakeAnc963	SIMULPF00001	187	199	211	175	24	12
5964	RV_pair964	FakeDesc964	FakeAnc964	SIMULPF00001	121	118	125	114	4	7
5965	RV_pair965	FakeDesc965	FakeAnc965	SIMULPF00001	312	309	332	289	20	23
5966	RV_pair966	FakeDesc966	FakeAnc966	SIMULPF00001	743	746	811	678	68	65
5967	RV_pair967	FakeDesc967	FakeAnc967	SIMULPF00001	811	837	901	747	90	64
5968	RV_pair968	FakeDesc968	FakeAnc968	SIMULPF00001	42	40	46	36	4	6
5969	RV_pair969	FakeDesc969	FakeAnc969	SIMULPF00001	441	432	480	393	39	48
5970	RV_pair970	FakeDesc970	FakeAnc970	SIMULPF00001	406	413	451	368	45	38
5971	RV_pair971	FakeDesc971	FakeAnc971	SIMULPF00001	109	108	120	97	11	12
5972	RV_pair972	FakeDesc972	FakeAnc972	SIMULPF00001	22	24	24	22	2	0
5973	RV_pair973	FakeDesc973	FakeAnc973	SIMULPF00001	103	103	111	95	8	8
5974	RV_pair974	FakeDesc974	FakeAnc974	SIMULPF00001	241	250	267	224	26	17
5975	RV_pair975	FakeDesc975	FakeAnc975	SIMULPF00001	261	270	293	238	32	23
5976	RV_pair976	FakeDesc976	FakeAnc976	SIMULPF00001	30	30	33	27	3	3
5977	RV_pair977	FakeDesc977	FakeAnc977	SIMULPF00001	124	121	138	107	14	17
5978	RV_pair978	FakeDesc978	FakeAnc978	SIMULPF00001	291	296	321	266	30	25
5979	RV_pair979	FakeDesc979	FakeAnc979	SIMULPF00001	105	97	109	93	4	12
5980	RV_pair980	FakeDesc980	FakeAnc980	SIMULPF00001	410	410	447	373	37	37
5981	RV_pair981	FakeDesc981	FakeAnc981	SIMULPF00001	83	78	89	72	6	11
5982	RV_pair982	FakeDesc982	FakeAnc982	SIMULPF00001	143	143	156	130	13	13
5983	RV_pair983	FakeDesc983	FakeAnc983	SIMULPF00001	13	12	13	12	0	1
5984	RV_pair984	FakeDesc984	FakeAnc984	SIMULPF00001	99	99	107	91	8	8
5985	RV_pair985	FakeDesc985	FakeAnc985	SIMULPF00001	32	36	36	32	4	0
5986	RV_pair986	FakeDesc986	FakeAnc986	SIMULPF00001	35	34	41	28	6	7
5987	RV_pair987	FakeDesc987	FakeAnc987	SIMULPF00001	701	708	779	630	78	71
5988	RV_pair988	FakeDesc988	FakeAnc988	SIMULPF00001	323	313	341	295	18	28
5989	RV_pair989	FakeDesc989	FakeAnc989	SIMULPF00001	12	13	13	12	1	0
5990	RV_pair990	FakeDesc990	FakeAnc990	SIMULPF00001	317	342	358	301	41	16
5991	RV_pair991	FakeDesc991	FakeAnc991	SIMULPF00001	578	571	622	527	44	51
5992	RV_pair992	FakeDesc992	FakeAnc992	SIMULPF00001	75	76	83	68	8	7
5993	RV_pair993	FakeDesc993	FakeAnc993	SIMULPF00001	157	152	168	141	11	16
5994	RV_pair994	FakeDesc994	FakeAnc994	SIMULPF00001	61	58	68	51	7	10
5995	RV_pair995	FakeDesc995	FakeAnc995	SIMULPF00001	186	182	201	167	15	19
5996	RV_pair996	FakeDesc996	FakeAnc996	SIMULPF00001	111	112	122	101	11	10
5997	RV_pair997	FakeDesc997	FakeAnc997	SIMULPF00001	75	70	79	66	4	9
5998	RV_pair998	FakeDesc998	FakeAnc998	SIMULPF00001	34	35	36	33	2	1
5999	RV_pair999	FakeDesc999	FakeAnc999	SIMULPF00001	440	436	487	389	47	51
6000	RV_pair1000	FakeDesc1000	FakeAnc1000	SIMULPF00001	455	443	499	399	44	56
6001	RV_pair1001	FakeDesc1001	FakeAnc1001	SIMULPF00001	26	24	28	22	2	4
6002	RV_pair1002	FakeDesc1002	FakeAnc1002	SIMULPF00001	361	335	385	311	24	50
6003	RV_pair1003	FakeDesc1003	FakeAnc1003	SIMULPF00001	60	67	70	57	10	3
6004	RV_pair1004	FakeDesc1004	FakeAnc1004	SIMULPF00001	160	157	178	139	18	21
6005	RV_pair1005	FakeDesc1005	FakeAnc1005	SIMULPF00001	690	704	764	630	74	60
6006	RV_pair1006	FakeDesc1006	FakeAnc1006	SIMULPF00001	413	410	453	370	40	43
6007	RV_pair1007	FakeDesc1007	FakeAnc1007	SIMULPF00001	214	217	238	193	24	21
6008	RV_pair1008	FakeDesc1008	FakeAnc1008	SIMULPF00001	287	276	302	261	15	26
6009	RV_pair1009	FakeDesc1009	FakeAnc1009	SIMULPF00001	88	95	95	88	7	0
6010	RV_pair1010	FakeDesc1010	FakeAnc1010	SIMULPF00001	47	47	50	44	3	3
6011	RV_pair1011	FakeDesc1011	FakeAnc1011	SIMULPF00001	312	302	336	278	24	34
6012	RV_pair1012	FakeDesc1012	FakeAnc1012	SIMULPF00001	24	21	24	21	0	3
6013	RV_pair1013	FakeDesc1013	FakeAnc1013	SIMULPF00001	34	34	38	30	4	4
6014	RV_pair1014	FakeDesc1014	FakeAnc1014	SIMULPF00001	41	40	44	37	3	4
6015	RV_pair1015	FakeDesc1015	FakeAnc1015	SIMULPF00001	241	254	269	226	28	15
6016	RV_pair1016	FakeDesc1016	FakeAnc1016	SIMULPF00001	251	266	283	234	32	17
6017	RV_pair1017	FakeDesc1017	FakeAnc1017	SIMULPF00001	711	686	763	634	52	77
6018	RV_pair1018	FakeDesc1018	FakeAnc1018	SIMULPF00001	458	453	497	414	39	44
6019	RV_pair1019	FakeDesc1019	FakeAnc1019	SIMULPF00001	54	49	59	44	5	10
6020	RV_pair1020	FakeDesc1020	FakeAnc1020	SIMULPF00001	690	693	765	618	75	72
6021	RV_pair1021	FakeDesc1021	FakeAnc1021	SIMULPF00001	87	95	100	82	13	5
6022	RV_pair1022	FakeDesc1022	FakeAnc1022	SIMULPF00001	69	66	70	65	1	4
6023	RV_pair1023	FakeDesc1023	FakeAnc1023	SIMULPF00001	526	519	575	470	49	56
6024	RV_pair1024	FakeDesc1024	FakeAnc1024	SIMULPF00001	113	108	123	98	10	15
6025	RV_pair1025	FakeDesc1025	FakeAnc1025	SIMULPF00001	222	206	234	194	12	28
6026	RV_pair1026	FakeDesc1026	FakeAnc1026	SIMULPF00001	736	750	809	677	73	59
6027	RV_pair1027	FakeDesc1027	FakeAnc1027	SIMULPF00001	102	97	104	95	2	7
6028	RV_pair1028	FakeDesc1028	FakeAnc1028	SIMULPF00001	404	398	439	363	35	41
6029	RV_pair1029	FakeDesc1029	FakeAnc1029	SIMULPF00001	15	15	16	14	1	1
6030	RV_pair1030	FakeDesc1030	FakeAnc1030	SIMULPF00001	350	347	384	313	34	37
6031	RV_pair1031	FakeDesc1031	FakeAnc1031	SIMULPF00001	136	145	152	129	16	7
6032	RV_pair1032	FakeDesc1032	FakeAnc1032	SIMULPF00001	339	348	371	316	32	23
6033	RV_pair1033	FakeDesc1033	FakeAnc1033	SIMULPF00001	286	278	311	253	25	33
6034	RV_pair1034	FakeDesc1034	FakeAnc1034	SIMULPF00001	168	174	188	154	20	14
6035	RV_pair1035	FakeDesc1035	FakeAnc1035	SIMULPF00001	113	108	119	102	6	11
6036	RV_pair1036	FakeDesc1036	FakeAnc1036	SIMULPF00001	388	397	438	347	50	41
6037	RV_pair1037	FakeDesc1037	FakeAnc1037	SIMULPF00001	404	409	443	370	39	34
6038	RV_pair1038	FakeDesc1038	FakeAnc1038	SIMULPF00001	459	460	500	419	41	40
6039	RV_pair1039	FakeDesc1039	FakeAnc1039	SIMULPF00001	120	118	130	108	10	12
6040	RV_pair1040	FakeDesc1040	FakeAnc1040	SIMULPF00001	418	435	468	385	50	33
6041	RV_pair1041	FakeDesc1041	FakeAnc1041	SIMULPF00001	367	363	396	334	29	33
6042	RV_pair1042	FakeDesc1042	FakeAnc1042	SIMULPF00001	46	43	48	41	2	5
6043	RV_pair1043	FakeDesc1043	FakeAnc1043	SIMULPF00001	725	708	773	660	48	65
6044	RV_pair1044	FakeDesc1044	FakeAnc1044	SIMULPF00001	92	94	101	85	9	7
6045	RV_pair1045	FakeDesc1045	FakeAnc1045	SIMULPF00001	67	63	73	57	6	10
6046	RV_pair1046	FakeDesc1046	FakeAnc1046	SIMULPF00001	704	705	764	645	60	59
6047	RV_pair1047	FakeDesc1047	FakeAnc1047	SIMULPF00001	137	126	150	113	13	24
6048	RV_pair1048	FakeDesc1048	FakeAnc1048	SIMULPF00001	44	41	46	39	2	5
6049	RV_pair1049	FakeDesc1049	FakeAnc1049	SIMULPF00001	248	248	264	232	16	16
6050	RV_pair1050	FakeDesc1050	FakeAnc1050	SIMULPF00001	279	293	314	258	35	21
6051	RV_pair1051	FakeDesc1051	FakeAnc1051	SIMULPF00001	135	138	145	128	10	7
6052	RV_pair1052	FakeDesc1052	FakeAnc1052	SIMULPF00001	309	313	337	285	28	24
6053	RV_pair1053	FakeDesc1053	FakeAnc1053	SIMULPF00001	29	32	35	26	6	3
6054	RV_pair1054	FakeDesc1054	FakeAnc1054	SIMULPF00001	28	25	29	24	1	4
6055	RV_pair1055	FakeDesc1055	FakeAnc1055	SIMULPF00001	136	140	154	122	18	14
6056	RV_pair1056	FakeDesc1056	FakeAnc1056	SIMULPF00001	526	526	570	482	44	44
6057	RV_pair1057	FakeDesc1057	FakeAnc1057	SIMULPF00001	161	157	170	148	9	13
6058	RV_pair1058	FakeDesc1058	FakeAnc1058	SIMULPF00001	76	78	87	67	11	9
6059	RV_pair1059	FakeDesc1059	FakeAnc1059	SIMULPF00001	242	250	271	221	29	21
6060	RV_pair1060	FakeDesc1060	FakeAnc1060	SIMULPF00001	493	490	539	444	46	49
6061	RV_pair1061	FakeDesc1061	FakeAnc1061	SIMULPF00001	33	33	37	29	4	4
6062	RV_pair1062	FakeDesc1062	FakeAnc1062	SIMULPF00001	71	68	74	65	3	6
6063	RV_pair1063	FakeDesc1063	FakeAnc1063	SIMULPF00001	498	489	540	447	42	51
6064	RV_pair1064	FakeDesc1064	FakeAnc1064	SIMULPF00001	540	539	594	485	54	55
6065	RV_pair1065	FakeDesc1065	FakeAnc1065	SIMULPF00001	352	358	393	317	41	35
6066	RV_pair1066	FakeDesc1066	FakeAnc1066	SIMULPF00001	204	203	227	180	23	24
6067	RV_pair1067	FakeDesc1067	FakeAnc1067	SIMULPF00001	125	127	141	111	16	14
6068	RV_pair1068	FakeDesc1068	FakeAnc1068	SIMULPF00001	2	5	5	2	3	0
6069	RV_pair1069	FakeDesc1069	FakeAnc1069	SIMULPF00001	415	424	457	382	42	33
6070	RV_pair1070	FakeDesc1070	FakeAnc1070	SIMULPF00001	366	370	399	337	33	29
6071	RV_pair1071	FakeDesc1071	FakeAnc1071	SIMULPF00001	66	63	70	59	4	7
6072	RV_pair1072	FakeDesc1072	FakeAnc1072	SIMULPF00001	411	416	456	371	45	40
6073	RV_pair1073	FakeDesc1073	FakeAnc1073	SIMULPF00001	85	77	87	75	2	10
6074	RV_pair1074	FakeDesc1074	FakeAnc1074	SIMULPF00001	110	115	123	102	13	8
6075	RV_pair1075	FakeDesc1075	FakeAnc1075	SIMULPF00001	229	230	254	205	25	24
6076	RV_pair1076	FakeDesc1076	FakeAnc1076	SIMULPF00001	638	659	701	596	63	42
6077	RV_pair1077	FakeDesc1077	FakeAnc1077	SIMULPF00001	268	274	305	237	37	31
6078	RV_pair1078	FakeDesc1078	FakeAnc1078	SIMULPF00001	92	83	95	80	3	12
6079	RV_pair1079	FakeDesc1079	FakeAnc1079	SIMULPF00001	84	82	92	74	8	10
6080	RV_pair1080	FakeDesc1080	FakeAnc1080	SIMULPF00001	17	18	18	17	1	0
6081	RV_pair1081	FakeDesc1081	FakeAnc1081	SIMULPF00001	43	45	45	43	2	0
6082	RV_pair1082	FakeDesc1082	FakeAnc1082	SIMULPF00001	12	17	17	12	5	0
6083	RV_pair1083	FakeDesc1083	FakeAnc1083	SIMULPF00001	533	536	572	497	39	36
6084	RV_pair1084	FakeDesc1084	FakeAnc1084	SIMULPF00001	290	299	316	273	26	17
6085	RV_pair1085	FakeDesc1085	FakeAnc1085	SIMULPF00001	175	171	189	157	14	18
6086	RV_pair1086	FakeDesc1086	FakeAnc1086	SIMULPF00001	521	523	569	475	48	46
6087	RV_pair1087	FakeDesc1087	FakeAnc1087	SIMULPF00001	237	247	263	221	26	16
6088	RV_pair1088	FakeDesc1088	FakeAnc1088	SIMULPF00001	311	323	352	282	41	29
6089	RV_pair1089	FakeDesc1089	FakeAnc1089	SIMULPF00001	25	23	27	21	2	4
6090	RV_pair1090	FakeDesc1090	FakeAnc1090	SIMULPF00001	334	335	364	305	30	29
6091	RV_pair1091	FakeDesc1091	FakeAnc1091	SIMULPF00001	158	162	168	152	10	6
6092	RV_pair1092	FakeDesc1092	FakeAnc1092	SIMULPF00001	127	121	135	113	8	14
6093	RV_pair1093	FakeDesc1093	FakeAnc1093	SIMULPF00001	141	140	153	128	12	13
6094	RV_pair1094	FakeDesc1094	FakeAnc1094	SIMULPF00001	109	110	122	97	13	12
6095	RV_pair1095	FakeDesc1095	FakeAnc1095	SIMULPF00001	133	134	142	125	9	8
6096	RV_pair1096	FakeDesc1096	FakeAnc1096	SIMULPF00001	427	430	476	381	49	46
6097	RV_pair1097	FakeDesc1097	FakeAnc1097	SIMULPF00001	174	168	194	148	20	26
6098	RV_pair1098	FakeDesc1098	FakeAnc1098	SIMULPF00001	202	205	227	180	25	22
6099	RV_pair1099	FakeDesc1099	FakeAnc1099	SIMULPF00001	843	834	931	746	88	97
6100	RV_pair1100	FakeDesc1100	FakeAnc1100	SIMULPF00001	747	751	826	672	79	75
6101	RV_pair1101	FakeDesc1101	FakeAnc1101	SIMULPF00001	35	28	39	24	4	11
6102	RV_pair1102	FakeDesc1102	FakeAnc1102	SIMULPF00001	247	235	271	211	24	36
6103	RV_pair1103	FakeDesc1103	FakeAnc1103	SIMULPF00001	8	9	10	7	2	1
6104	RV_pair1104	FakeDesc1104	FakeAnc1104	SIMULPF00001	276	282	305	253	29	23
6105	RV_pair1105	FakeDesc1105	FakeAnc1105	SIMULPF00001	230	231	262	199	32	31
6106	RV_pair1106	FakeDesc1106	FakeAnc1106	SIMULPF00001	18	21	22	17	4	1
6107	RV_pair1107	FakeDesc1107	FakeAnc1107	SIMULPF00001	106	112	122	96	16	10
6108	RV_pair1108	FakeDesc1108	FakeAnc1108	SIMULPF00001	424	433	474	383	50	41
6109	RV_pair1109	FakeDesc1109	FakeAnc1109	SIMULPF00001	281	289	312	258	31	23
6110	RV_pair1110	FakeDesc1110	FakeAnc1110	SIMULPF00001	180	193	201	172	21	8
6111	RV_pair1111	FakeDesc1111	FakeAnc1111	SIMULPF00001	268	263	299	232	31	36
6112	RV_pair1112	FakeDesc1112	FakeAnc1112	SIMULPF00001	34	35	37	32	3	2
6113	RV_pair1113	FakeDesc1113	FakeAnc1113	SIMULPF00001	199	198	211	186	12	13
6114	RV_pair1114	FakeDesc1114	FakeAnc1114	SIMULPF00001	52	50	54	48	2	4
6115	RV_pair1115	FakeDesc1115	FakeAnc1115	SIMULPF00001	123	115	133	105	10	18
6116	RV_pair1116	FakeDesc1116	FakeAnc1116	SIMULPF00001	273	265	294	244	21	29
6117	RV_pair1117	FakeDesc1117	FakeAnc1117	SIMULPF00001	79	77	85	71	6	8
6118	RV_pair1118	FakeDesc1118	FakeAnc1118	SIMULPF00001	429	433	481	381	52	48
6119	RV_pair1119	FakeDesc1119	FakeAnc1119	SIMULPF00001	284	291	319	256	35	28
6120	RV_pair1120	FakeDesc1120	FakeAnc1120	SIMULPF00001	71	66	72	65	1	6
6121	RV_pair1121	FakeDesc1121	FakeAnc1121	SIMULPF00001	515	514	565	464	50	51
6122	RV_pair1122	FakeDesc1122	FakeAnc1122	SIMULPF00001	337	333	370	300	33	37
6123	RV_pair1123	FakeDesc1123	FakeAnc1123	SIMULPF00001	538	517	584	471	46	67
6124	RV_pair1124	FakeDesc1124	FakeAnc1124	SIMULPF00001	151	159	174	136	23	15
6125	RV_pair1125	FakeDesc1125	FakeAnc1125	SIMULPF00001	193	194	217	170	24	23
6126	RV_pair1126	FakeDesc1126	FakeAnc1126	SIMULPF00001	108	111	116	103	8	5
6127	RV_pair1127	FakeDesc1127	FakeAnc1127	SIMULPF00001	30	35	38	27	8	3
6128	RV_pair1128	FakeDesc1128	FakeAnc1128	SIMULPF00001	195	212	232	175	37	20
6129	RV_pair1129	FakeDesc1129	FakeAnc1129	SIMULPF00001	368	372	403	337	35	31
6130	RV_pair1130	FakeDesc1130	FakeAnc1130	SIMULPF00001	539	546	589	496	50	43
6131	RV_pair1131	FakeDesc1131	FakeAnc1131	SIMULPF00001	117	110	128	99	11	18
6132	RV_pair1132	FakeDesc1132	FakeAnc1132	SIMULPF00001	873	875	947	801	74	72
6133	RV_pair1133	FakeDesc1133	FakeAnc1133	SIMULPF00001	22	21	26	17	4	5
6134	RV_pair1134	FakeDesc1134	FakeAnc1134	SIMULPF00001	192	193	214	171	22	21
6135	RV_pair1135	FakeDesc1135	FakeAnc1135	SIMULPF00001	148	148	160	136	12	12
6136	RV_pair1136	FakeDesc1136	FakeAnc1136	SIMULPF00001	324	332	349	307	25	17
6137	RV_pair1137	FakeDesc1137	FakeAnc1137	SIMULPF00001	761	730	814	677	53	84
6138	RV_pair1138	FakeDesc1138	FakeAnc1138	SIMULPF00001	1	1	1	1	0	0
6139	RV_pair1139	FakeDesc1139	FakeAnc1139	SIMULPF00001	259	261	283	237	24	22
6140	RV_pair1140	FakeDesc1140	FakeAnc1140	SIMULPF00001	474	444	504	414	30	60
6141	RV_pair1141	FakeDesc1141	FakeAnc1141	SIMULPF00001	740	728	818	650	78	90
6142	RV_pair1142	FakeDesc1142	FakeAnc1142	SIMULPF00001	341	339	382	298	41	43
6143	RV_pair1143	FakeDesc1143	FakeAnc1143	SIMULPF00001	5	2	5	2	0	3
6144	RV_pair1144	FakeDesc1144	FakeAnc1144	SIMULPF00001	54	60	62	52	8	2
6145	RV_pair1145	FakeDesc1145	FakeAnc1145	SIMULPF00001	229	229	254	204	25	25
6146	RV_pair1146	FakeDesc1146	FakeAnc1146	SIMULPF00001	677	675	737	615	60	62
6147	RV_pair1147	FakeDesc1147	FakeAnc1147	SIMULPF00001	465	472	508	429	43	36
6148	RV_pair1148	FakeDesc1148	FakeAnc1148	SIMULPF00001	484	487	535	436	51	48
6149	RV_pair1149	FakeDesc1149	FakeAnc1149	SIMULPF00001	79	82	89	72	10	7
6150	RV_pair1150	FakeDesc1150	FakeAnc1150	SIMULPF00001	235	231	253	213	18	22
6151	RV_pair1151	FakeDesc1151	FakeAnc1151	SIMULPF00001	517	536	568	485	51	32
6152	RV_pair1152	FakeDesc1152	FakeAnc1152	SIMULPF00001	7	4	7	4	0	3
6153	RV_pair1153	FakeDesc1153	FakeAnc1153	SIMULPF00001	163	169	179	153	16	10
6154	RV_pair1154	FakeDesc1154	FakeAnc1154	SIMULPF00001	54	51	58	47	4	7
6155	RV_pair1155	FakeDesc1155	FakeAnc1155	SIMULPF00001	23	21	25	19	2	4
6156	RV_pair1156	FakeDesc1156	FakeAnc1156	SIMULPF00001	59	67	68	58	9	1
6157	RV_pair1157	FakeDesc1157	FakeAnc1157	SIMULPF00001	30	32	32	30	2	0
6158	RV_pair1158	FakeDesc1158	FakeAnc1158	SIMULPF00001	198	204	215	187	17	11
6159	RV_pair1159	FakeDesc1159	FakeAnc1159	SIMULPF00001	151	159	167	143	16	8
6160	RV_pair1160	FakeDesc1160	FakeAnc1160	SIMULPF00001	144	141	152	133	8	11
6161	RV_pair1161	FakeDesc1161	FakeAnc1161	SIMULPF00001	73	77	81	69	8	4
6162	RV_pair1162	FakeDesc1162	FakeAnc1162	SIMULPF00001	617	617	659	575	42	42
6163	RV_pair1163	FakeDesc1163	FakeAnc1163	SIMULPF00001	133	135	146	122	13	11
6164	RV_pair1164	FakeDesc1164	FakeAnc1164	SIMULPF00001	156	145	161	140	5	16
6165	RV_pair1165	FakeDesc1165	FakeAnc1165	SIMULPF00001	124	130	137	117	13	7
6166	RV_pair1166	FakeDesc1166	FakeAnc1166	SIMULPF00001	615	632	679	568	64	47
6167	RV_pair1167	FakeDesc1167	FakeAnc1167	SIMULPF00001	288	271	303	256	15	32
6168	RV_pair1168	FakeDesc1168	FakeAnc1168	SIMULPF00001	368	365	405	328	37	40
6169	RV_pair1169	FakeDesc1169	FakeAnc1169	SIMULPF00001	72	68	79	61	7	11
6170	RV_pair1170	FakeDesc1170	FakeAnc1170	SIMULPF00001	38	38	39	37	1	1
6171	RV_pair1171	FakeDesc1171	FakeAnc1171	SIMULPF00001	6	5	6	5	0	1
6172	RV_pair1172	FakeDesc1172	FakeAnc1172	SIMULPF00001	207	204	223	188	16	19
6173	RV_pair1173	FakeDesc1173	FakeAnc1173	SIMULPF00001	177	164	187	154	10	23
6174	RV_pair1174	FakeDesc1174	FakeAnc1174	SIMULPF00001	214	202	229	187	15	27
6175	RV_pair1175	FakeDesc1175	FakeAnc1175	SIMULPF00001	199	189	212	176	13	23
6176	RV_pair1176	FakeDesc1176	FakeAnc1176	SIMULPF00001	43	36	45	34	2	9
6177	RV_pair1177	FakeDesc1177	FakeAnc1177	SIMULPF00001	253	250	273	230	20	23
6178	RV_pair1178	FakeDesc1178	FakeAnc1178	SIMULPF00001	207	198	218	187	11	20
6179	RV_pair1179	FakeDesc1179	FakeAnc1179	SIMULPF00001	251	247	277	221	26	30
6180	RV_pair1180	FakeDesc1180	FakeAnc1180	SIMULPF00001	66	63	68	61	2	5
6181	RV_pair1181	FakeDesc1181	FakeAnc1181	SIMULPF00001	694	705	761	638	67	56
6182	RV_pair1182	FakeDesc1182	FakeAnc1182	SIMULPF00001	81	78	87	72	6	9
6183	RV_pair1183	FakeDesc1183	FakeAnc1183	SIMULPF00001	41	43	47	37	6	4
6184	RV_pair1184	FakeDesc1184	FakeAnc1184	SIMULPF00001	29	36	36	29	7	0
6185	RV_pair1185	FakeDesc1185	FakeAnc1185	SIMULPF00001	134	141	149	126	15	8
6186	RV_pair1186	FakeDesc1186	FakeAnc1186	SIMULPF00001	241	223	253	211	12	30
6187	RV_pair1187	FakeDesc1187	FakeAnc1187	SIMULPF00001	243	238	263	218	20	25
6188	RV_pair1188	FakeDesc1188	FakeAnc1188	SIMULPF00001	54	60	64	50	10	4
6189	RV_pair1189	FakeDesc1189	FakeAnc1189	SIMULPF00001	71	69	76	64	5	7
6190	RV_pair1190	FakeDesc1190	FakeAnc1190	SIMULPF00001	44	45	47	42	3	2
6191	RV_pair1191	FakeDesc1191	FakeAnc1191	SIMULPF00001	54	50	57	47	3	7
6192	RV_pair1192	FakeDesc1192	FakeAnc1192	SIMULPF00001	84	81	87	78	3	6
6193	RV_pair1193	FakeDesc1193	FakeAnc1193	SIMULPF00001	81	75	88	68	7	13
6194	RV_pair1194	FakeDesc1194	FakeAnc1194	SIMULPF00001	175	180	191	164	16	11
6195	RV_pair1195	FakeDesc1195	FakeAnc1195	SIMULPF00001	76	80	91	65	15	11
6196	RV_pair1196	FakeDesc1196	FakeAnc1196	SIMULPF00001	289	300	314	275	25	14
6197	RV_pair1197	FakeDesc1197	FakeAnc1197	SIMULPF00001	188	193	209	172	21	16
6198	RV_pair1198	FakeDesc1198	FakeAnc1198	SIMULPF00001	366	366	400	332	34	34
6199	RV_pair1199	FakeDesc1199	FakeAnc1199	SIMULPF00001	107	97	110	94	3	13
6200	RV_pair1200	FakeDesc1200	FakeAnc1200	SIMULPF00001	368	370	405	333	37	35
6201	RV_pair1201	FakeDesc1201	FakeAnc1201	SIMULPF00001	42	37	45	34	3	8
6202	RV_pair1202	FakeDesc1202	FakeAnc1202	SIMULPF00001	42	46	46	42	4	0
6203	RV_pair1203	FakeDesc1203	FakeAnc1203	SIMULPF00001	11	11	12	10	1	1
6204	RV_pair1204	FakeDesc1204	FakeAnc1204	SIMULPF00001	626	655	716	565	90	61
6205	RV_pair1205	FakeDesc1205	FakeAnc1205	SIMULPF00001	25	24	26	23	1	2
6206	RV_pair1206	FakeDesc1206	FakeAnc1206	SIMULPF00001	182	181	210	153	28	29
6207	RV_pair1207	FakeDesc1207	FakeAnc1207	SIMULPF00001	105	102	117	90	12	15
6208	RV_pair1208	FakeDesc1208	FakeAnc1208	SIMULPF00001	111	120	124	107	13	4
6209	RV_pair1209	FakeDesc1209	FakeAnc1209	SIMULPF00001	77	75	84	68	7	9
6210	RV_pair1210	FakeDesc1210	FakeAnc1210	SIMULPF00001	328	356	376	308	48	20
6211	RV_pair1211	FakeDesc1211	FakeAnc1211	SIMULPF00001	97	98	105	90	8	7
6212	RV_pair1212	FakeDesc1212	FakeAnc1212	SIMULPF00001	303	312	330	285	27	18
6213	RV_pair1213	FakeDesc1213	FakeAnc1213	SIMULPF00001	47	50	52	45	5	2
6214	RV_pair1214	FakeDesc1214	FakeAnc1214	SIMULPF00001	6	6	6	6	0	0
6215	RV_pair1215	FakeDesc1215	FakeAnc1215	SIMULPF00001	611	636	699	548	88	63
6216	RV_pair1216	FakeDesc1216	FakeAnc1216	SIMULPF00001	346	345	383	308	37	38
6217	RV_pair1217	FakeDesc1217	FakeAnc1217	SIMULPF00001	677	664	724	617	47	60
6218	RV_pair1218	FakeDesc1218	FakeAnc1218	SIMULPF00001	84	84	95	73	11	11
6219	RV_pair1219	FakeDesc1219	FakeAnc1219	SIMULPF00001	157	144	164	137	7	20
6220	RV_pair1220	FakeDesc1220	FakeAnc1220	SIMULPF00001	96	98	107	87	11	9
6221	RV_pair1221	FakeDesc1221	FakeAnc1221	SIMULPF00001	378	395	424	349	46	29
6222	RV_pair1222	FakeDesc1222	FakeAnc1222	SIMULPF00001	19	20	24	15	5	4
6223	RV_pair1223	FakeDesc1223	FakeAnc1223	SIMULPF00001	499	510	544	465	45	34
6224	RV_pair1224	FakeDesc1224	FakeAnc1224	SIMULPF00001	222	246	266	202	44	20
6225	RV_pair1225	FakeDesc1225	FakeAnc1225	SIMULPF00001	8	8	8	8	0	0
6226	RV_pair1226	FakeDesc1226	FakeAnc1226	SIMULPF00001	16	18	19	15	3	1
6227	RV_pair1227	FakeDesc1227	FakeAnc1227	SIMULPF00001	157	159	181	135	24	22
6228	RV_pair1228	FakeDesc1228	FakeAnc1228	SIMULPF00001	83	92	98	77	15	6
6229	RV_pair1229	FakeDesc1229	FakeAnc1229	SIMULPF00001	183	181	199	165	16	18
6230	RV_pair1230	FakeDesc1230	FakeAnc1230	SIMULPF00001	560	548	608	500	48	60
6231	RV_pair1231	FakeDesc1231	FakeAnc1231	SIMULPF00001	48	51	56	43	8	5
6232	RV_pair1232	FakeDesc1232	FakeAnc1232	SIMULPF00001	27	32	32	27	5	0
6233	RV_pair1233	FakeDesc1233	FakeAnc1233	SIMULPF00001	257	275	287	245	30	12
6234	RV_pair1234	FakeDesc1234	FakeAnc1234	SIMULPF00001	17	13	18	12	1	5
6235	RV_pair1235	FakeDesc1235	FakeAnc1235	SIMULPF00001	68	54	68	54	0	14
6236	RV_pair1236	FakeDesc1236	FakeAnc1236	SIMULPF00001	42	41	45	38	3	4
6237	RV_pair1237	FakeDesc1237	FakeAnc1237	SIMULPF00001	30	33	33	30	3	0
6238	RV_pair1238	FakeDesc1238	FakeAnc1238	SIMULPF00001	574	573	626	521	52	53
6239	RV_pair1239	FakeDesc1239	FakeAnc1239	SIMULPF00001	113	117	124	106	11	7
6240	RV_pair1240	FakeDesc1240	FakeAnc1240	SIMULPF00001	163	161	170	154	7	9
6241	RV_pair1241	FakeDesc1241	FakeAnc1241	SIMULPF00001	205	196	220	181	15	24
6242	RV_pair1242	FakeDesc1242	FakeAnc1242	SIMULPF00001	107	106	114	99	7	8
6243	RV_pair1243	FakeDesc1243	FakeAnc1243	SIMULPF00001	178	180	198	160	20	18
6244	RV_pair1244	FakeDesc1244	FakeAnc1244	SIMULPF00001	240	233	258	215	18	25
6245	RV_pair1245	FakeDesc1245	FakeAnc1245	SIMULPF00001	48	46	49	45	1	3
6246	RV_pair1246	FakeDesc1246	FakeAnc1246	SIMULPF00001	369	366	399	336	30	33
6247	RV_pair1247	FakeDesc1247	FakeAnc1247	SIMULPF00001	730	731	792	669	62	61
6248	RV_pair1248	FakeDesc1248	FakeAnc1248	SIMULPF00001	22	24	24	22	2	0
6249	RV_pair1249	FakeDesc1249	FakeAnc1249	SIMULPF00001	103	104	111	96	8	7
6250	RV_pair1250	FakeDesc1250	FakeAnc1250	SIMULPF00001	217	215	234	198	17	19
6251	RV_pair1251	FakeDesc1251	FakeAnc1251	SIMULPF00001	145	151	161	135	16	10
6252	RV_pair1252	FakeDesc1252	FakeAnc1252	SIMULPF00001	180	185	198	167	18	13
6253	RV_pair1253	FakeDesc1253	FakeAnc1253	SIMULPF00001	56	59	64	51	8	5
6254	RV_pair1254	FakeDesc1254	FakeAnc1254	SIMULPF00001	199	199	220	178	21	21
6255	RV_pair1255	FakeDesc1255	FakeAnc1255	SIMULPF00001	114	104	126	92	12	22
6256	RV_pair1256	FakeDesc1256	FakeAnc1256	SIMULPF00001	243	250	263	230	20	13
6257	RV_pair1257	FakeDesc1257	FakeAnc1257	SIMULPF00001	420	407	455	372	35	48
6258	RV_pair1258	FakeDesc1258	FakeAnc1258	SIMULPF00001	409	413	453	369	44	40
6259	RV_pair1259	FakeDesc1259	FakeAnc1259	SIMULPF00001	254	257	274	237	20	17
6260	RV_pair1260	FakeDesc1260	FakeAnc1260	SIMULPF00001	137	138	142	133	5	4
6261	RV_pair1261	FakeDesc1261	FakeAnc1261	SIMULPF00001	150	141	155	136	5	14
6262	RV_pair1262	FakeDesc1262	FakeAnc1262	SIMULPF00001	27	29	30	26	3	1
6263	RV_pair1263	FakeDesc1263	FakeAnc1263	SIMULPF00001	425	425	476	374	51	51
6264	RV_pair1264	FakeDesc1264	FakeAnc1264	SIMULPF00001	237	237	261	213	24	24
6265	RV_pair1265	FakeDesc1265	FakeAnc1265	SIMULPF00001	391	396	434	353	43	38
6266	RV_pair1266	FakeDesc1266	FakeAnc1266	SIMULPF00001	292	300	326	266	34	26
6267	RV_pair1267	FakeDesc1267	FakeAnc1267	SIMULPF00001	43	34	43	34	0	9
6268	RV_pair1268	FakeDesc1268	FakeAnc1268	SIMULPF00001	350	349	379	320	29	30
6269	RV_pair1269	FakeDesc1269	FakeAnc1269	SIMULPF00001	31	39	43	27	12	4
6270	RV_pair1270	FakeDesc1270	FakeAnc1270	SIMULPF00001	148	164	171	141	23	7
6271	RV_pair1271	FakeDesc1271	FakeAnc1271	SIMULPF00001	216	226	235	207	19	9
6272	RV_pair1272	FakeDesc1272	FakeAnc1272	SIMULPF00001	424	419	471	372	47	52
6273	RV_pair1273	FakeDesc1273	FakeAnc1273	SIMULPF00001	44	41	45	40	1	4
6274	RV_pair1274	FakeDesc1274	FakeAnc1274	SIMULPF00001	49	50	57	42	8	7
6275	RV_pair1275	FakeDesc1275	FakeAnc1275	SIMULPF00001	184	198	205	177	21	7
6276	RV_pair1276	FakeDesc1276	FakeAnc1276	SIMULPF00001	490	501	542	449	52	41
6277	RV_pair1277	FakeDesc1277	FakeAnc1277	SIMULPF00001	67	62	70	59	3	8
6278	RV_pair1278	FakeDesc1278	FakeAnc1278	SIMULPF00001	607	632	677	562	70	45
6279	RV_pair1279	FakeDesc1279	FakeAnc1279	SIMULPF00001	249	252	271	230	22	19
6280	RV_pair1280	FakeDesc1280	FakeAnc1280	SIMULPF00001	735	747	810	672	75	63
6281	RV_pair1281	FakeDesc1281	FakeAnc1281	SIMULPF00001	438	439	479	398	41	40
6282	RV_pair1282	FakeDesc1282	FakeAnc1282	SIMULPF00001	167	173	183	157	16	10
6283	RV_pair1283	FakeDesc1283	FakeAnc1283	SIMULPF00001	100	104	112	92	12	8
6284	RV_pair1284	FakeDesc1284	FakeAnc1284	SIMULPF00001	57	51	58	50	1	7
6285	RV_pair1285	FakeDesc1285	FakeAnc1285	SIMULPF00001	616	614	685	545	69	71
6286	RV_pair1286	FakeDesc1286	FakeAnc1286	SIMULPF00001	26	25	26	25	0	1
6287	RV_pair1287	FakeDesc1287	FakeAnc1287	SIMULPF00001	125	115	130	110	5	15
6288	RV_pair1288	FakeDesc1288	FakeAnc1288	SIMULPF00001	1	1	1	1	0	0
6289	RV_pair1289	FakeDesc1289	FakeAnc1289	SIMULPF00001	98	95	105	88	7	10
6290	RV_pair1290	FakeDesc1290	FakeAnc1290	SIMULPF00001	16	15	17	14	1	2
6291	RV_pair1291	FakeDesc1291	FakeAnc1291	SIMULPF00001	499	496	542	453	43	46
6292	RV_pair1292	FakeDesc1292	FakeAnc1292	SIMULPF00001	2	5	5	2	3	0
6293	RV_pair1293	FakeDesc1293	FakeAnc1293	SIMULPF00001	27	23	28	22	1	5
6294	RV_pair1294	FakeDesc1294	FakeAnc1294	SIMULPF00001	7	7	8	6	1	1
6295	RV_pair1295	FakeDesc1295	FakeAnc1295	SIMULPF00001	90	91	103	78	13	12
6296	RV_pair1296	FakeDesc1296	FakeAnc1296	SIMULPF00001	76	77	85	68	9	8
6297	RV_pair1297	FakeDesc1297	FakeAnc1297	SIMULPF00001	387	391	422	356	35	31
6298	RV_pair1298	FakeDesc1298	FakeAnc1298	SIMULPF00001	449	456	492	413	43	36
6299	RV_pair1299	FakeDesc1299	FakeAnc1299	SIMULPF00001	85	89	94	80	9	5
6300	RV_pair1300	FakeDesc1300	FakeAnc1300	SIMULPF00001	209	211	226	194	17	15
6301	RV_pair1301	FakeDesc1301	FakeAnc1301	SIMULPF00001	12	12	12	12	0	0
6302	RV_pair1302	FakeDesc1302	FakeAnc1302	SIMULPF00001	142	138	151	129	9	13
6303	RV_pair1303	FakeDesc1303	FakeAnc1303	SIMULPF00001	366	374	402	338	36	28
6304	RV_pair1304	FakeDesc1304	FakeAnc1304	SIMULPF00001	174	174	188	160	14	14
6305	RV_pair1305	FakeDesc1305	FakeAnc1305	SIMULPF00001	455	455	504	406	49	49
6306	RV_pair1306	FakeDesc1306	FakeAnc1306	SIMULPF00001	448	450	490	408	42	40
6307	RV_pair1307	FakeDesc1307	FakeAnc1307	SIMULPF00001	100	111	115	96	15	4
6308	RV_pair1308	FakeDesc1308	FakeAnc1308	SIMULPF00001	335	338	370	303	35	32
6309	RV_pair1309	FakeDesc1309	FakeAnc1309	SIMULPF00001	188	186	213	161	25	27
6310	RV_pair1310	FakeDesc1310	FakeAnc1310	SIMULPF00001	279	268	301	246	22	33
6311	RV_pair1311	FakeDesc1311	FakeAnc1311	SIMULPF00001	152	153	172	133	20	19
6312	RV_pair1312	FakeDesc1312	FakeAnc1312	SIMULPF00001	69	67	75	61	6	8
6313	RV_pair1313	FakeDesc1313	FakeAnc1313	SIMULPF00001	6	12	13	5	7	1
6314	RV_pair1314	FakeDesc1314	FakeAnc1314	SIMULPF00001	666	666	719	613	53	53
6315	RV_pair1315	FakeDesc1315	FakeAnc1315	SIMULPF00001	354	363	394	323	40	31
6316	RV_pair1316	FakeDesc1316	FakeAnc1316	SIMULPF00001	55	53	59	49	4	6
6317	RV_pair1317	FakeDesc1317	FakeAnc1317	SIMULPF00001	475	451	502	424	27	51
6318	RV_pair1318	FakeDesc1318	FakeAnc1318	SIMULPF00001	31	34	36	29	5	2
6319	RV_pair1319	FakeDesc1319	FakeAnc1319	SIMULPF00001	158	152	170	140	12	18
6320	RV_pair1320	FakeDesc1320	FakeAnc1320	SIMULPF00001	79	88	91	76	12	3
6321	RV_pair1321	FakeDesc1321	FakeAnc1321	SIMULPF00001	437	467	496	408	59	29
6322	RV_pair1322	FakeDesc1322	FakeAnc1322	SIMULPF00001	71	72	78	65	7	6
6323	RV_pair1323	FakeDesc1323	FakeAnc1323	SIMULPF00001	362	354	389	327	27	35
6324	RV_pair1324	FakeDesc1324	FakeAnc1324	SIMULPF00001	27	25	32	20	5	7
6325	RV_pair1325	FakeDesc1325	FakeAnc1325	SIMULPF00001	288	287	319	256	31	32
6326	RV_pair1326	FakeDesc1326	FakeAnc1326	SIMULPF00001	106	106	114	98	8	8
6327	RV_pair1327	FakeDesc1327	FakeAnc1327	SIMULPF00001	135	122	141	116	6	19
6328	RV_pair1328	FakeDesc1328	FakeAnc1328	SIMULPF00001	64	65	69	60	5	4
6329	RV_pair1329	FakeDesc1329	FakeAnc1329	SIMULPF00001	502	484	530	456	28	46
6330	RV_pair1330	FakeDesc1330	FakeAnc1330	SIMULPF00001	58	61	69	50	11	8
6331	RV_pair1331	FakeDesc1331	FakeAnc1331	SIMULPF00001	294	287	314	267	20	27
6332	RV_pair1332	FakeDesc1332	FakeAnc1332	SIMULPF00001	108	118	122	104	14	4
6333	RV_pair1333	FakeDesc1333	FakeAnc1333	SIMULPF00001	27	26	29	24	2	3
6334	RV_pair1334	FakeDesc1334	FakeAnc1334	SIMULPF00001	32	32	33	31	1	1
6335	RV_pair1335	FakeDesc1335	FakeAnc1335	SIMULPF00001	118	128	139	107	21	11
6336	RV_pair1336	FakeDesc1336	FakeAnc1336	SIMULPF00001	146	143	161	128	15	18
6337	RV_pair1337	FakeDesc1337	FakeAnc1337	SIMULPF00001	18	21	22	17	4	1
6338	RV_pair1338	FakeDesc1338	FakeAnc1338	SIMULPF00001	28	29	32	25	4	3
6339	RV_pair1339	FakeDesc1339	FakeAnc1339	SIMULPF00001	283	293	316	260	33	23
6340	RV_pair1340	FakeDesc1340	FakeAnc1340	SIMULPF00001	281	299	319	261	38	20
6341	RV_pair1341	FakeDesc1341	FakeAnc1341	SIMULPF00001	268	274	292	250	24	18
6342	RV_pair1342	FakeDesc1342	FakeAnc1342	SIMULPF00001	1	2	2	1	1	0
6343	RV_pair1343	FakeDesc1343	FakeAnc1343	SIMULPF00001	319	309	343	285	24	34
6344	RV_pair1344	FakeDesc1344	FakeAnc1344	SIMULPF00001	143	140	154	129	11	14
6345	RV_pair1345	FakeDesc1345	FakeAnc1345	SIMULPF00001	92	93	103	82	11	10
6346	RV_pair1346	FakeDesc1346	FakeAnc1346	SIMULPF00001	525	535	582	478	57	47
6347	RV_pair1347	FakeDesc1347	FakeAnc1347	SIMULPF00001	187	176	200	163	13	24
6348	RV_pair1348	FakeDesc1348	FakeAnc1348	SIMULPF00001	6	7	7	6	1	0
6349	RV_pair1349	FakeDesc1349	FakeAnc1349	SIMULPF00001	54	55	56	53	2	1
6350	RV_pair1350	FakeDesc1350	FakeAnc1350	SIMULPF00001	420	428	461	387	41	33
6351	RV_pair1351	FakeDesc1351	FakeAnc1351	SIMULPF00001	206	204	218	192	12	14
6352	RV_pair1352	FakeDesc1352	FakeAnc1352	SIMULPF00001	441	446	489	398	48	43
6353	RV_pair1353	FakeDesc1353	FakeAnc1353	SIMULPF00001	352	354	389	317	37	35
6354	RV_pair1354	FakeDesc1354	FakeAnc1354	SIMULPF00001	132	131	144	119	12	13
6355	RV_pair1355	FakeDesc1355	FakeAnc1355	SIMULPF00001	172	180	190	162	18	10
6356	RV_pair1356	FakeDesc1356	FakeAnc1356	SIMULPF00001	21	15	22	14	1	7
6357	RV_pair1357	FakeDesc1357	FakeAnc1357	SIMULPF00001	99	102	109	92	10	7
6358	RV_pair1358	FakeDesc1358	FakeAnc1358	SIMULPF00001	813	774	876	711	63	102
6359	RV_pair1359	FakeDesc1359	FakeAnc1359	SIMULPF00001	93	87	105	75	12	18
6360	RV_pair1360	FakeDesc1360	FakeAnc1360	SIMULPF00001	143	144	156	131	13	12
6361	RV_pair1361	FakeDesc1361	FakeAnc1361	SIMULPF00001	320	311	353	278	33	42
6362	RV_pair1362	FakeDesc1362	FakeAnc1362	SIMULPF00001	106	111	119	98	13	8
6363	RV_pair1363	FakeDesc1363	FakeAnc1363	SIMULPF00001	68	65	73	60	5	8
6364	RV_pair1364	FakeDesc1364	FakeAnc1364	SIMULPF00001	54	46	56	44	2	10
6365	RV_pair1365	FakeDesc1365	FakeAnc1365	SIMULPF00001	274	286	307	253	33	21
6366	RV_pair1366	FakeDesc1366	FakeAnc1366	SIMULPF00001	40	38	42	36	2	4
6367	RV_pair1367	FakeDesc1367	FakeAnc1367	SIMULPF00001	72	69	78	63	6	9
6368	RV_pair1368	FakeDesc1368	FakeAnc1368	SIMULPF00001	270	275	295	250	25	20
6369	RV_pair1369	FakeDesc1369	FakeAnc1369	SIMULPF00001	99	101	107	93	8	6
6370	RV_pair1370	FakeDesc1370	FakeAnc1370	SIMULPF00001	150	148	163	135	13	15
6371	RV_pair1371	FakeDesc1371	FakeAnc1371	SIMULPF00001	319	327	358	288	39	31
6372	RV_pair1372	FakeDesc1372	FakeAnc1372	SIMULPF00001	3	2	3	2	0	1
6373	RV_pair1373	FakeDesc1373	FakeAnc1373	SIMULPF00001	202	197	220	179	18	23
6374	RV_pair1374	FakeDesc1374	FakeAnc1374	SIMULPF00001	313	319	345	287	32	26
6375	RV_pair1375	FakeDesc1375	FakeAnc1375	SIMULPF00001	135	131	141	125	6	10
6376	RV_pair1376	FakeDesc1376	FakeAnc1376	SIMULPF00001	230	223	247	206	17	24
6377	RV_pair1377	FakeDesc1377	FakeAnc1377	SIMULPF00001	46	45	47	44	1	2
6378	RV_pair1378	FakeDesc1378	FakeAnc1378	SIMULPF00001	13	11	13	11	0	2
6379	RV_pair1379	FakeDesc1379	FakeAnc1379	SIMULPF00001	176	167	189	154	13	22
6380	RV_pair1380	FakeDesc1380	FakeAnc1380	SIMULPF00001	42	38	44	36	2	6
6381	RV_pair1381	FakeDesc1381	FakeAnc1381	SIMULPF00001	911	903	987	827	76	84
6382	RV_pair1382	FakeDesc1382	FakeAnc1382	SIMULPF00001	204	215	234	185	30	19
6383	RV_pair1383	FakeDesc1383	FakeAnc1383	SIMULPF00001	206	204	228	182	22	24
6384	RV_pair1384	FakeDesc1384	FakeAnc1384	SIMULPF00001	262	278	299	241	37	21
6385	RV_pair1385	FakeDesc1385	FakeAnc1385	SIMULPF00001	689	696	750	635	61	54
6386	RV_pair1386	FakeDesc1386	FakeAnc1386	SIMULPF00001	7	6	7	6	0	1
6387	RV_pair1387	FakeDesc1387	FakeAnc1387	SIMULPF00001	11	14	14	11	3	0
6388	RV_pair1388	FakeDesc1388	FakeAnc1388	SIMULPF00001	64	61	70	55	6	9
6389	RV_pair1389	FakeDesc1389	FakeAnc1389	SIMULPF00001	247	256	275	228	28	19
6390	RV_pair1390	FakeDesc1390	FakeAnc1390	SIMULPF00001	68	73	76	65	8	3
6391	RV_pair1391	FakeDesc1391	FakeAnc1391	SIMULPF00001	369	381	410	340	41	29
6392	RV_pair1392	FakeDesc1392	FakeAnc1392	SIMULPF00001	33	32	33	32	0	1
6393	RV_pair1393	FakeDesc1393	FakeAnc1393	SIMULPF00001	441	435	470	406	29	35
6394	RV_pair1394	FakeDesc1394	FakeAnc1394	SIMULPF00001	120	129	136	113	16	7
6395	RV_pair1395	FakeDesc1395	FakeAnc1395	SIMULPF00001	23	21	24	20	1	3
6396	RV_pair1396	FakeDesc1396	FakeAnc1396	SIMULPF00001	39	35	39	35	0	4
6397	RV_pair1397	FakeDesc1397	FakeAnc1397	SIMULPF00001	51	52	60	43	9	8
6398	RV_pair1398	FakeDesc1398	FakeAnc1398	SIMULPF00001	130	139	150	119	20	11
6399	RV_pair1399	FakeDesc1399	FakeAnc1399	SIMULPF00001	28	28	31	25	3	3
6400	RV_pair1400	FakeDesc1400	FakeAnc1400	SIMULPF00001	857	838	933	762	76	95
6401	RV_pair1401	FakeDesc1401	FakeAnc1401	SIMULPF00001	15	12	15	12	0	3
6402	RV_pair1402	FakeDesc1402	FakeAnc1402	SIMULPF00001	197	194	215	176	18	21
6403	RV_pair1403	FakeDesc1403	FakeAnc1403	SIMULPF00001	530	518	570	478	40	52
6404	RV_pair1404	FakeDesc1404	FakeAnc1404	SIMULPF00001	202	200	226	176	24	26
6405	RV_pair1405	FakeDesc1405	FakeAnc1405	SIMULPF00001	821	847	913	755	92	66
6406	RV_pair1406	FakeDesc1406	FakeAnc1406	SIMULPF00001	132	142	148	126	16	6
6407	RV_pair1407	FakeDesc1407	FakeAnc1407	SIMULPF00001	48	55	60	43	12	5
6408	RV_pair1408	FakeDesc1408	FakeAnc1408	SIMULPF00001	291	293	323	261	32	30
6409	RV_pair1409	FakeDesc1409	FakeAnc1409	SIMULPF00001	76	86	90	72	14	4
6410	RV_pair1410	FakeDesc1410	FakeAnc1410	SIMULPF00001	44	41	49	36	5	8
6411	RV_pair1411	FakeDesc1411	FakeAnc1411	SIMULPF00001	271	268	302	237	31	34
6412	RV_pair1412	FakeDesc1412	FakeAnc1412	SIMULPF00001	224	208	238	194	14	30
6413	RV_pair1413	FakeDesc1413	FakeAnc1413	SIMULPF00001	663	658	744	577	81	86
6414	RV_pair1414	FakeDesc1414	FakeAnc1414	SIMULPF00001	4	6	6	4	2	0
6415	RV_pair1415	FakeDesc1415	FakeAnc1415	SIMULPF00001	162	170	182	150	20	12
6416	RV_pair1416	FakeDesc1416	FakeAnc1416	SIMULPF00001	175	187	201	161	26	14
6417	RV_pair1417	FakeDesc1417	FakeAnc1417	SIMULPF00001	34	37	39	32	5	2
6418	RV_pair1418	FakeDesc1418	FakeAnc1418	SIMULPF00001	87	89	96	80	9	7
6419	RV_pair1419	FakeDesc1419	FakeAnc1419	SIMULPF00001	152	153	165	140	13	12
6420	RV_pair1420	FakeDesc1420	FakeAnc1420	SIMULPF00001	2	2	2	2	0	0
6421	RV_pair1421	FakeDesc1421	FakeAnc1421	SIMULPF00001	17	14	17	14	0	3
6422	RV_pair1422	FakeDesc1422	FakeAnc1422	SIMULPF00001	366	360	405	321	39	45
6423	RV_pair1423	FakeDesc1423	FakeAnc1423	SIMULPF00001	126	131	140	117	14	9
6424	RV_pair1424	FakeDesc1424	FakeAnc1424	SIMULPF00001	273	257	292	238	19	35
6425	RV_pair1425	FakeDesc1425	FakeAnc1425	SIMULPF00001	82	83	87	78	5	4
6426	RV_pair1426	FakeDesc1426	FakeAnc1426	SIMULPF00001	47	53	55	45	8	2
6427	RV_pair1427	FakeDesc1427	FakeAnc1427	SIMULPF00001	317	303	339	281	22	36
6428	RV_pair1428	FakeDesc1428	FakeAnc1428	SIMULPF00001	126	124	136	114	10	12
6429	RV_pair1429	FakeDesc1429	FakeAnc1429	SIMULPF00001	265	250	281	234	16	31
6430	RV_pair1430	FakeDesc1430	FakeAnc1430	SIMULPF00001	9	8	9	8	0	1
6431	RV_pair1431	FakeDesc1431	FakeAnc1431	SIMULPF00001	44	46	51	39	7	5
6432	RV_pair1432	FakeDesc1432	FakeAnc1432	SIMULPF00001	3	5	5	3	2	0
6433	RV_pair1433	FakeDesc1433	FakeAnc1433	SIMULPF00001	28	31	32	27	4	1
6434	RV_pair1434	FakeDesc1434	FakeAnc1434	SIMULPF00001	48	42	50	40	2	8
6435	RV_pair1435	FakeDesc1435	FakeAnc1435	SIMULPF00001	51	56	58	49	7	2
6436	RV_pair1436	FakeDesc1436	FakeAnc1436	SIMULPF00001	66	65	72	59	6	7
6437	RV_pair1437	FakeDesc1437	FakeAnc1437	SIMULPF00001	176	186	202	160	26	16
6438	RV_pair1438	FakeDesc1438	FakeAnc1438	SIMULPF00001	620	618	686	552	66	68
6439	RV_pair1439	FakeDesc1439	FakeAnc1439	SIMULPF00001	191	191	211	171	20	20
6440	RV_pair1440	FakeDesc1440	FakeAnc1440	SIMULPF00001	382	367	415	334	33	48
6441	RV_pair1441	FakeDesc1441	FakeAnc1441	SIMULPF00001	498	505	555	448	57	50
6442	RV_pair1442	FakeDesc1442	FakeAnc1442	SIMULPF00001	116	118	124	110	8	6
6443	RV_pair1443	FakeDesc1443	FakeAnc1443	SIMULPF00001	106	103	116	93	10	13
6444	RV_pair1444	FakeDesc1444	FakeAnc1444	SIMULPF00001	375	398	417	356	42	19
6445	RV_pair1445	FakeDesc1445	FakeAnc1445	SIMULPF00001	64	67	71	60	7	4
6446	RV_pair1446	FakeDesc1446	FakeAnc1446	SIMULPF00001	382	375	416	341	34	41
6447	RV_pair1447	FakeDesc1447	FakeAnc1447	SIMULPF00001	341	342	382	301	41	40
6448	RV_pair1448	FakeDesc1448	FakeAnc1448	SIMULPF00001	84	87	91	80	7	4
6449	RV_pair1449	FakeDesc1449	FakeAnc1449	SIMULPF00001	703	718	763	658	60	45
6450	RV_pair1450	FakeDesc1450	FakeAnc1450	SIMULPF00001	448	443	477	414	29	34
6451	RV_pair1451	FakeDesc1451	FakeAnc1451	SIMULPF00001	89	86	97	78	8	11
6452	RV_pair1452	FakeDesc1452	FakeAnc1452	SIMULPF00001	71	73	77	67	6	4
6453	RV_pair1453	FakeDesc1453	FakeAnc1453	SIMULPF00001	254	257	280	231	26	23
6454	RV_pair1454	FakeDesc1454	FakeAnc1454	SIMULPF00001	574	574	636	512	62	62
6455	RV_pair1455	FakeDesc1455	FakeAnc1455	SIMULPF00001	323	340	366	297	43	26
6456	RV_pair1456	FakeDesc1456	FakeAnc1456	SIMULPF00001	38	35	39	34	1	4
6457	RV_pair1457	FakeDesc1457	FakeAnc1457	SIMULPF00001	115	119	124	110	9	5
6458	RV_pair1458	FakeDesc1458	FakeAnc1458	SIMULPF00001	481	467	516	432	35	49
6459	RV_pair1459	FakeDesc1459	FakeAnc1459	SIMULPF00001	114	112	128	98	14	16
6460	RV_pair1460	FakeDesc1460	FakeAnc1460	SIMULPF00001	498	494	537	455	39	43
6461	RV_pair1461	FakeDesc1461	FakeAnc1461	SIMULPF00001	39	42	44	37	5	2
6462	RV_pair1462	FakeDesc1462	FakeAnc1462	SIMULPF00001	34	35	35	34	1	0
6463	RV_pair1463	FakeDesc1463	FakeAnc1463	SIMULPF00001	220	220	242	198	22	22
6464	RV_pair1464	FakeDesc1464	FakeAnc1464	SIMULPF00001	165	169	179	155	14	10
6465	RV_pair1465	FakeDesc1465	FakeAnc1465	SIMULPF00001	155	153	170	138	15	17
6466	RV_pair1466	FakeDesc1466	FakeAnc1466	SIMULPF00001	325	337	362	300	37	25
6467	RV_pair1467	FakeDesc1467	FakeAnc1467	SIMULPF00001	314	302	342	274	28	40
6468	RV_pair1468	FakeDesc1468	FakeAnc1468	SIMULPF00001	350	355	372	333	22	17
6469	RV_pair1469	FakeDesc1469	FakeAnc1469	SIMULPF00001	63	58	66	55	3	8
6470	RV_pair1470	FakeDesc1470	FakeAnc1470	SIMULPF00001	613	627	685	555	72	58
6471	RV_pair1471	FakeDesc1471	FakeAnc1471	SIMULPF00001	104	96	109	91	5	13
6472	RV_pair1472	FakeDesc1472	FakeAnc1472	SIMULPF00001	3	4	4	3	1	0
6473	RV_pair1473	FakeDesc1473	FakeAnc1473	SIMULPF00001	342	349	373	318	31	24
6474	RV_pair1474	FakeDesc1474	FakeAnc1474	SIMULPF00001	409	403	445	367	36	42
6475	RV_pair1475	FakeDesc1475	FakeAnc1475	SIMULPF00001	164	180	188	156	24	8
6476	RV_pair1476	FakeDesc1476	FakeAnc1476	SIMULPF00001	8	8	8	8	0	0
6477	RV_pair1477	FakeDesc1477	FakeAnc1477	SIMULPF00001	198	211	227	182	29	16
6478	RV_pair1478	FakeDesc1478	FakeAnc1478	SIMULPF00001	101	103	112	92	11	9
6479	RV_pair1479	FakeDesc1479	FakeAnc1479	SIMULPF00001	236	242	256	222	20	14
6480	RV_pair1480	FakeDesc1480	FakeAnc1480	SIMULPF00001	48	50	51	47	3	1
6481	RV_pair1481	FakeDesc1481	FakeAnc1481	SIMULPF00001	205	205	222	188	17	17
6482	RV_pair1482	FakeDesc1482	FakeAnc1482	SIMULPF00001	441	441	482	400	41	41
6483	RV_pair1483	FakeDesc1483	FakeAnc1483	SIMULPF00001	116	111	122	105	6	11
6484	RV_pair1484	FakeDesc1484	FakeAnc1484	SIMULPF00001	90	86	95	81	5	9
6485	RV_pair1485	FakeDesc1485	FakeAnc1485	SIMULPF00001	529	528	571	486	42	43
6486	RV_pair1486	FakeDesc1486	FakeAnc1486	SIMULPF00001	310	322	350	282	40	28
6487	RV_pair1487	FakeDesc1487	FakeAnc1487	SIMULPF00001	184	194	202	176	18	8
6488	RV_pair1488	FakeDesc1488	FakeAnc1488	SIMULPF00001	313	332	363	282	50	31
6489	RV_pair1489	FakeDesc1489	FakeAnc1489	SIMULPF00001	13	14	17	10	4	3
6490	RV_pair1490	FakeDesc1490	FakeAnc1490	SIMULPF00001	56	58	62	52	6	4
6491	RV_pair1491	FakeDesc1491	FakeAnc1491	SIMULPF00001	13	17	17	13	4	0
6492	RV_pair1492	FakeDesc1492	FakeAnc1492	SIMULPF00001	36	38	40	34	4	2
6493	RV_pair1493	FakeDesc1493	FakeAnc1493	SIMULPF00001	175	181	194	162	19	13
6494	RV_pair1494	FakeDesc1494	FakeAnc1494	SIMULPF00001	192	181	205	168	13	24
6495	RV_pair1495	FakeDesc1495	FakeAnc1495	SIMULPF00001	5	5	5	5	0	0
6496	RV_pair1496	FakeDesc1496	FakeAnc1496	SIMULPF00001	113	107	126	94	13	19
6497	RV_pair1497	FakeDesc1497	FakeAnc1497	SIMULPF00001	381	385	422	344	41	37
6498	RV_pair1498	FakeDesc1498	FakeAnc1498	SIMULPF00001	200	212	220	192	20	8
6499	RV_pair1499	FakeDesc1499	FakeAnc1499	SIMULPF00001	135	123	144	114	9	21
6500	RV_pair1500	FakeDesc1500	FakeAnc1500	SIMULPF00001	138	129	144	123	6	15
6501	RV_pair1501	FakeDesc1501	FakeAnc1501	SIMULPF00001	293	304	324	273	31	20
6502	RV_pair1502	FakeDesc1502	FakeAnc1502	SIMULPF00001	74	78	81	71	7	3
6503	RV_pair1503	FakeDesc1503	FakeAnc1503	SIMULPF00001	23	24	24	23	1	0
6504	RV_pair1504	FakeDesc1504	FakeAnc1504	SIMULPF00001	646	632	704	574	58	72
6505	RV_pair1505	FakeDesc1505	FakeAnc1505	SIMULPF00001	45	65	66	44	21	1
6506	RV_pair1506	FakeDesc1506	FakeAnc1506	SIMULPF00001	234	232	253	213	19	21
6507	RV_pair1507	FakeDesc1507	FakeAnc1507	SIMULPF00001	532	516	572	476	40	56
6508	RV_pair1508	FakeDesc1508	FakeAnc1508	SIMULPF00001	22	24	24	22	2	0
6509	RV_pair1509	FakeDesc1509	FakeAnc1509	SIMULPF00001	108	109	116	101	8	7
6510	RV_pair1510	FakeDesc1510	FakeAnc1510	SIMULPF00001	1	1	1	1	0	0
6511	RV_pair1511	FakeDesc1511	FakeAnc1511	SIMULPF00001	319	324	347	296	28	23
6512	RV_pair1512	FakeDesc1512	FakeAnc1512	SIMULPF00001	389	399	445	343	56	46
6513	RV_pair1513	FakeDesc1513	FakeAnc1513	SIMULPF00001	793	766	852	707	59	86
6514	RV_pair1514	FakeDesc1514	FakeAnc1514	SIMULPF00001	251	248	277	222	26	29
6515	RV_pair1515	FakeDesc1515	FakeAnc1515	SIMULPF00001	251	246	268	229	17	22
6516	RV_pair1516	FakeDesc1516	FakeAnc1516	SIMULPF00001	313	306	343	276	30	37
6517	RV_pair1517	FakeDesc1517	FakeAnc1517	SIMULPF00001	56	56	59	53	3	3
6518	RV_pair1518	FakeDesc1518	FakeAnc1518	SIMULPF00001	236	235	258	213	22	23
6519	RV_pair1519	FakeDesc1519	FakeAnc1519	SIMULPF00001	28	29	32	25	4	3
6520	RV_pair1520	FakeDesc1520	FakeAnc1520	SIMULPF00001	29	31	33	27	4	2
6521	RV_pair1521	FakeDesc1521	FakeAnc1521	SIMULPF00001	235	247	264	218	29	17
6522	RV_pair1522	FakeDesc1522	FakeAnc1522	SIMULPF00001	35	34	36	33	1	2
6523	RV_pair1523	FakeDesc1523	FakeAnc1523	SIMULPF00001	1	1	1	1	0	0
6524	RV_pair1524	FakeDesc1524	FakeAnc1524	SIMULPF00001	36	39	44	31	8	5
6525	RV_pair1525	FakeDesc1525	FakeAnc1525	SIMULPF00001	145	152	163	134	18	11
6526	RV_pair1526	FakeDesc1526	FakeAnc1526	SIMULPF00001	26	29	30	25	4	1
6527	RV_pair1527	FakeDesc1527	FakeAnc1527	SIMULPF00001	104	110	118	96	14	8
6528	RV_pair1528	FakeDesc1528	FakeAnc1528	SIMULPF00001	438	436	482	392	44	46
6529	RV_pair1529	FakeDesc1529	FakeAnc1529	SIMULPF00001	425	429	465	389	40	36
6530	RV_pair1530	FakeDesc1530	FakeAnc1530	SIMULPF00001	179	174	197	156	18	23
6531	RV_pair1531	FakeDesc1531	FakeAnc1531	SIMULPF00001	355	357	382	330	27	25
6532	RV_pair1532	FakeDesc1532	FakeAnc1532	SIMULPF00001	80	88	93	75	13	5
6533	RV_pair1533	FakeDesc1533	FakeAnc1533	SIMULPF00001	111	110	121	100	10	11
6534	RV_pair1534	FakeDesc1534	FakeAnc1534	SIMULPF00001	152	169	179	142	27	10
6535	RV_pair1535	FakeDesc1535	FakeAnc1535	SIMULPF00001	218	211	238	191	20	27
6536	RV_pair1536	FakeDesc1536	FakeAnc1536	SIMULPF00001	199	200	217	182	18	17
6537	RV_pair1537	FakeDesc1537	FakeAnc1537	SIMULPF00001	20	22	23	19	3	1
6538	RV_pair1538	FakeDesc1538	FakeAnc1538	SIMULPF00001	187	177	199	165	12	22
6539	RV_pair1539	FakeDesc1539	FakeAnc1539	SIMULPF00001	61	66	69	58	8	3
6540	RV_pair1540	FakeDesc1540	FakeAnc1540	SIMULPF00001	110	117	125	102	15	8
6541	RV_pair1541	FakeDesc1541	FakeAnc1541	SIMULPF00001	88	84	94	78	6	10
6542	RV_pair1542	FakeDesc1542	FakeAnc1542	SIMULPF00001	189	183	206	166	17	23
6543	RV_pair1543	FakeDesc1543	FakeAnc1543	SIMULPF00001	721	723	778	666	57	55
6544	RV_pair1544	FakeDesc1544	FakeAnc1544	SIMULPF00001	310	292	333	269	23	41
6545	RV_pair1545	FakeDesc1545	FakeAnc1545	SIMULPF00001	74	74	82	66	8	8
6546	RV_pair1546	FakeDesc1546	FakeAnc1546	SIMULPF00001	372	370	403	339	31	33
6547	RV_pair1547	FakeDesc1547	FakeAnc1547	SIMULPF00001	86	90	98	78	12	8
6548	RV_pair1548	FakeDesc1548	FakeAnc1548	SIMULPF00001	70	65	74	61	4	9
6549	RV_pair1549	FakeDesc1549	FakeAnc1549	SIMULPF00001	548	567	610	505	62	43
6550	RV_pair1550	FakeDesc1550	FakeAnc1550	SIMULPF00001	6	7	7	6	1	0
6551	RV_pair1551	FakeDesc1551	FakeAnc1551	SIMULPF00001	233	224	246	211	13	22
6552	RV_pair1552	FakeDesc1552	FakeAnc1552	SIMULPF00001	143	147	158	132	15	11
6553	RV_pair1553	FakeDesc1553	FakeAnc1553	SIMULPF00001	268	258	290	236	22	32
6554	RV_pair1554	FakeDesc1554	FakeAnc1554	SIMULPF00001	89	82	94	77	5	12
6555	RV_pair1555	FakeDesc1555	FakeAnc1555	SIMULPF00001	176	175	190	161	14	15
6556	RV_pair1556	FakeDesc1556	FakeAnc1556	SIMULPF00001	757	780	851	686	94	71
6557	RV_pair1557	FakeDesc1557	FakeAnc1557	SIMULPF00001	123	116	138	101	15	22
6558	RV_pair1558	FakeDesc1558	FakeAnc1558	SIMULPF00001	79	73	83	69	4	10
6559	RV_pair1559	FakeDesc1559	FakeAnc1559	SIMULPF00001	417	400	447	370	30	47
6560	RV_pair1560	FakeDesc1560	FakeAnc1560	SIMULPF00001	12	14	14	12	2	0
6561	RV_pair1561	FakeDesc1561	FakeAnc1561	SIMULPF00001	160	166	180	146	20	14
6562	RV_pair1562	FakeDesc1562	FakeAnc1562	SIMULPF00001	48	55	58	45	10	3
6563	RV_pair1563	FakeDesc1563	FakeAnc1563	SIMULPF00001	65	66	70	61	5	4
6564	RV_pair1564	FakeDesc1564	FakeAnc1564	SIMULPF00001	216	223	238	201	22	15
6565	RV_pair1565	FakeDesc1565	FakeAnc1565	SIMULPF00001	172	183	197	158	25	14
6566	RV_pair1566	FakeDesc1566	FakeAnc1566	SIMULPF00001	313	310	340	283	27	30
6567	RV_pair1567	FakeDesc1567	FakeAnc1567	SIMULPF00001	393	403	428	368	35	25
6568	RV_pair1568	FakeDesc1568	FakeAnc1568	SIMULPF00001	96	106	110	92	14	4
6569	RV_pair1569	FakeDesc1569	FakeAnc1569	SIMULPF00001	48	53	55	46	7	2
6570	RV_pair1570	FakeDesc1570	FakeAnc1570	SIMULPF00001	66	75	77	64	11	2
6571	RV_pair1571	FakeDesc1571	FakeAnc1571	SIMULPF00001	54	55	60	49	6	5
6572	RV_pair1572	FakeDesc1572	FakeAnc1572	SIMULPF00001	29	32	33	28	4	1
6573	RV_pair1573	FakeDesc1573	FakeAnc1573	SIMULPF00001	9	8	9	8	0	1
6574	RV_pair1574	FakeDesc1574	FakeAnc1574	SIMULPF00001	105	101	114	92	9	13
6575	RV_pair1575	FakeDesc1575	FakeAnc1575	SIMULPF00001	123	122	141	104	18	19
6576	RV_pair1576	FakeDesc1576	FakeAnc1576	SIMULPF00001	185	186	202	169	17	16
6577	RV_pair1577	FakeDesc1577	FakeAnc1577	SIMULPF00001	37	40	40	37	3	0
6578	RV_pair1578	FakeDesc1578	FakeAnc1578	SIMULPF00001	278	281	306	253	28	25
6579	RV_pair1579	FakeDesc1579	FakeAnc1579	SIMULPF00001	93	95	101	87	8	6
6580	RV_pair1580	FakeDesc1580	FakeAnc1580	SIMULPF00001	372	372	407	337	35	35
6581	RV_pair1581	FakeDesc1581	FakeAnc1581	SIMULPF00001	396	390	435	351	39	45
6582	RV_pair1582	FakeDesc1582	FakeAnc1582	SIMULPF00001	110	100	114	96	4	14
6583	RV_pair1583	FakeDesc1583	FakeAnc1583	SIMULPF00001	187	185	203	169	16	18
6584	RV_pair1584	FakeDesc1584	FakeAnc1584	SIMULPF00001	223	237	253	207	30	16
6585	RV_pair1585	FakeDesc1585	FakeAnc1585	SIMULPF00001	232	225	246	211	14	21
6586	RV_pair1586	FakeDesc1586	FakeAnc1586	SIMULPF00001	20	18	21	17	1	3
6587	RV_pair1587	FakeDesc1587	FakeAnc1587	SIMULPF00001	26	22	26	22	0	4
6588	RV_pair1588	FakeDesc1588	FakeAnc1588	SIMULPF00001	75	78	84	69	9	6
6589	RV_pair1589	FakeDesc1589	FakeAnc1589	SIMULPF00001	54	58	61	51	7	3
6590	RV_pair1590	FakeDesc1590	FakeAnc1590	SIMULPF00001	460	455	503	412	43	48
6591	RV_pair1591	FakeDesc1591	FakeAnc1591	SIMULPF00001	693	680	741	632	48	61
6592	RV_pair1592	FakeDesc1592	FakeAnc1592	SIMULPF00001	241	252	273	220	32	21
6593	RV_pair1593	FakeDesc1593	FakeAnc1593	SIMULPF00001	106	98	117	87	11	19
6594	RV_pair1594	FakeDesc1594	FakeAnc1594	SIMULPF00001	362	380	408	334	46	28
6595	RV_pair1595	FakeDesc1595	FakeAnc1595	SIMULPF00001	740	738	802	676	62	64
6596	RV_pair1596	FakeDesc1596	FakeAnc1596	SIMULPF00001	275	286	310	251	35	24
6597	RV_pair1597	FakeDesc1597	FakeAnc1597	SIMULPF00001	75	80	88	67	13	8
6598	RV_pair1598	FakeDesc1598	FakeAnc1598	SIMULPF00001	328	344	363	309	35	19
6599	RV_pair1599	FakeDesc1599	FakeAnc1599	SIMULPF00001	148	146	162	132	14	16
6600	RV_pair1600	FakeDesc1600	FakeAnc1600	SIMULPF00001	8	8	8	8	0	0
6601	RV_pair1601	FakeDesc1601	FakeAnc1601	SIMULPF00001	79	78	88	69	9	10
6602	RV_pair1602	FakeDesc1602	FakeAnc1602	SIMULPF00001	20	15	20	15	0	5
6603	RV_pair1603	FakeDesc1603	FakeAnc1603	SIMULPF00001	94	91	102	83	8	11
6604	RV_pair1604	FakeDesc1604	FakeAnc1604	SIMULPF00001	99	89	103	85	4	14
6605	RV_pair1605	FakeDesc1605	FakeAnc1605	SIMULPF00001	223	218	233	208	10	15
6606	RV_pair1606	FakeDesc1606	FakeAnc1606	SIMULPF00001	279	294	310	263	31	16
6607	RV_pair1607	FakeDesc1607	FakeAnc1607	SIMULPF00001	126	127	134	119	8	7
6608	RV_pair1608	FakeDesc1608	FakeAnc1608	SIMULPF00001	81	82	89	74	8	7
6609	RV_pair1609	FakeDesc1609	FakeAnc1609	SIMULPF00001	359	348	399	308	40	51
6610	RV_pair1610	FakeDesc1610	FakeAnc1610	SIMULPF00001	297	312	337	272	40	25
6611	RV_pair1611	FakeDesc1611	FakeAnc1611	SIMULPF00001	774	786	865	695	91	79
6612	RV_pair1612	FakeDesc1612	FakeAnc1612	SIMULPF00001	644	618	687	575	43	69
6613	RV_pair1613	FakeDesc1613	FakeAnc1613	SIMULPF00001	522	542	592	472	70	50
6614	RV_pair1614	FakeDesc1614	FakeAnc1614	SIMULPF00001	125	127	137	115	12	10
6615	RV_pair1615	FakeDesc1615	FakeAnc1615	SIMULPF00001	447	449	494	402	47	45
6616	RV_pair1616	FakeDesc1616	FakeAnc1616	SIMULPF00001	24	19	25	18	1	6
6617	RV_pair1617	FakeDesc1617	FakeAnc1617	SIMULPF00001	745	726	798	673	53	72
6618	RV_pair1618	FakeDesc1618	FakeAnc1618	SIMULPF00001	282	274	307	249	25	33
6619	RV_pair1619	FakeDesc1619	FakeAnc1619	SIMULPF00001	631	635	694	572	63	59
6620	RV_pair1620	FakeDesc1620	FakeAnc1620	SIMULPF00001	315	304	356	263	41	52
6621	RV_pair1621	FakeDesc1621	FakeAnc1621	SIMULPF00001	11	11	11	11	0	0
6622	RV_pair1622	FakeDesc1622	FakeAnc1622	SIMULPF00001	132	142	150	124	18	8
6623	RV_pair1623	FakeDesc1623	FakeAnc1623	SIMULPF00001	57	61	64	54	7	3
6624	RV_pair1624	FakeDesc1624	FakeAnc1624	SIMULPF00001	212	214	231	195	19	17
6625	RV_pair1625	FakeDesc1625	FakeAnc1625	SIMULPF00001	542	521	582	481	40	61
6626	RV_pair1626	FakeDesc1626	FakeAnc1626	SIMULPF00001	773	797	853	717	80	56
6627	RV_pair1627	FakeDesc1627	FakeAnc1627	SIMULPF00001	87	84	93	78	6	9
6628	RV_pair1628	FakeDesc1628	FakeAnc1628	SIMULPF00001	472	485	517	440	45	32
6629	RV_pair1629	FakeDesc1629	FakeAnc1629	SIMULPF00001	569	581	626	524	57	45
6630	RV_pair1630	FakeDesc1630	FakeAnc1630	SIMULPF00001	245	248	270	223	25	22
6631	RV_pair1631	FakeDesc1631	FakeAnc1631	SIMULPF00001	553	543	597	499	44	54
6632	RV_pair1632	FakeDesc1632	FakeAnc1632	SIMULPF00001	356	354	397	313	41	43
6633	RV_pair1633	FakeDesc1633	FakeAnc1633	SIMULPF00001	428	444	477	395	49	33
6634	RV_pair1634	FakeDesc1634	FakeAnc1634	SIMULPF00001	94	90	97	87	3	7
6635	RV_pair1635	FakeDesc1635	FakeAnc1635	SIMULPF00001	132	128	144	116	12	16
6636	RV_pair1636	FakeDesc1636	FakeAnc1636	SIMULPF00001	103	107	115	95	12	8
6637	RV_pair1637	FakeDesc1637	FakeAnc1637	SIMULPF00001	62	67	73	56	11	6
6638	RV_pair1638	FakeDesc1638	FakeAnc1638	SIMULPF00001	316	306	336	286	20	30
6639	RV_pair1639	FakeDesc1639	FakeAnc1639	SIMULPF00001	117	122	126	113	9	4
6640	RV_pair1640	FakeDesc1640	FakeAnc1640	SIMULPF00001	77	83	87	73	10	4
6641	RV_pair1641	FakeDesc1641	FakeAnc1641	SIMULPF00001	214	213	241	186	27	28
6642	RV_pair1642	FakeDesc1642	FakeAnc1642	SIMULPF00001	203	194	216	181	13	22
6643	RV_pair1643	FakeDesc1643	FakeAnc1643	SIMULPF00001	26	36	36	26	10	0
6644	RV_pair1644	FakeDesc1644	FakeAnc1644	SIMULPF00001	314	296	334	276	20	38
6645	RV_pair1645	FakeDesc1645	FakeAnc1645	SIMULPF00001	474	449	507	416	33	58
6646	RV_pair1646	FakeDesc1646	FakeAnc1646	SIMULPF00001	84	85	92	77	8	7
6647	RV_pair1647	FakeDesc1647	FakeAnc1647	SIMULPF00001	252	245	272	225	20	27
6648	RV_pair1648	FakeDesc1648	FakeAnc1648	SIMULPF00001	45	52	55	42	10	3
6649	RV_pair1649	FakeDesc1649	FakeAnc1649	SIMULPF00001	282	290	312	260	30	22
6650	RV_pair1650	FakeDesc1650	FakeAnc1650	SIMULPF00001	426	419	459	386	33	40
6651	RV_pair1651	FakeDesc1651	FakeAnc1651	SIMULPF00001	104	104	111	97	7	7
6652	RV_pair1652	FakeDesc1652	FakeAnc1652	SIMULPF00001	667	645	715	597	48	70
6653	RV_pair1653	FakeDesc1653	FakeAnc1653	SIMULPF00001	549	540	596	493	47	56
6654	RV_pair1654	FakeDesc1654	FakeAnc1654	SIMULPF00001	67	65	72	60	5	7
6655	RV_pair1655	FakeDesc1655	FakeAnc1655	SIMULPF00001	343	325	360	308	17	35
6656	RV_pair1656	FakeDesc1656	FakeAnc1656	SIMULPF00001	60	66	70	56	10	4
6657	RV_pair1657	FakeDesc1657	FakeAnc1657	SIMULPF00001	343	335	374	304	31	39
6658	RV_pair1658	FakeDesc1658	FakeAnc1658	SIMULPF00001	141	142	156	127	15	14
6659	RV_pair1659	FakeDesc1659	FakeAnc1659	SIMULPF00001	244	259	279	224	35	20
6660	RV_pair1660	FakeDesc1660	FakeAnc1660	SIMULPF00001	221	211	238	194	17	27
6661	RV_pair1661	FakeDesc1661	FakeAnc1661	SIMULPF00001	375	373	414	334	39	41
6662	RV_pair1662	FakeDesc1662	FakeAnc1662	SIMULPF00001	99	104	112	91	13	8
6663	RV_pair1663	FakeDesc1663	FakeAnc1663	SIMULPF00001	75	70	78	67	3	8
6664	RV_pair1664	FakeDesc1664	FakeAnc1664	SIMULPF00001	15	18	18	15	3	0
6665	RV_pair1665	FakeDesc1665	FakeAnc1665	SIMULPF00001	80	91	93	78	13	2
6666	RV_pair1666	FakeDesc1666	FakeAnc1666	SIMULPF00001	316	329	354	291	38	25
6667	RV_pair1667	FakeDesc1667	FakeAnc1667	SIMULPF00001	589	574	642	521	53	68
6668	RV_pair1668	FakeDesc1668	FakeAnc1668	SIMULPF00001	37	36	37	36	0	1
6669	RV_pair1669	FakeDesc1669	FakeAnc1669	SIMULPF00001	101	103	110	94	9	7
6670	RV_pair1670	FakeDesc1670	FakeAnc1670	SIMULPF00001	63	60	68	55	5	8
6671	RV_pair1671	FakeDesc1671	FakeAnc1671	SIMULPF00001	303	304	320	287	17	16
6672	RV_pair1672	FakeDesc1672	FakeAnc1672	SIMULPF00001	88	83	94	77	6	11
6673	RV_pair1673	FakeDesc1673	FakeAnc1673	SIMULPF00001	594	592	655	531	61	63
6674	RV_pair1674	FakeDesc1674	FakeAnc1674	SIMULPF00001	42	41	49	34	7	8
6675	RV_pair1675	FakeDesc1675	FakeAnc1675	SIMULPF00001	53	59	63	49	10	4
6676	RV_pair1676	FakeDesc1676	FakeAnc1676	SIMULPF00001	229	219	250	198	21	31
6677	RV_pair1677	FakeDesc1677	FakeAnc1677	SIMULPF00001	219	224	246	197	27	22
6678	RV_pair1678	FakeDesc1678	FakeAnc1678	SIMULPF00001	122	109	124	107	2	15
6679	RV_pair1679	FakeDesc1679	FakeAnc1679	SIMULPF00001	119	134	136	117	17	2
6680	RV_pair1680	FakeDesc1680	FakeAnc1680	SIMULPF00001	16	17	19	14	3	2
6681	RV_pair1681	FakeDesc1681	FakeAnc1681	SIMULPF00001	155	165	178	142	23	13
6682	RV_pair1682	FakeDesc1682	FakeAnc1682	SIMULPF00001	185	185	204	166	19	19
6683	RV_pair1683	FakeDesc1683	FakeAnc1683	SIMULPF00001	157	157	164	150	7	7
6684	RV_pair1684	FakeDesc1684	FakeAnc1684	SIMULPF00001	60	61	70	51	10	9
6685	RV_pair1685	FakeDesc1685	FakeAnc1685	SIMULPF00001	284	283	319	248	35	36
6686	RV_pair1686	FakeDesc1686	FakeAnc1686	SIMULPF00001	135	133	145	123	10	12
6687	RV_pair1687	FakeDesc1687	FakeAnc1687	SIMULPF00001	283	281	309	255	26	28
6688	RV_pair1688	FakeDesc1688	FakeAnc1688	SIMULPF00001	94	88	102	80	8	14
6689	RV_pair1689	FakeDesc1689	FakeAnc1689	SIMULPF00001	141	150	155	136	14	5
6690	RV_pair1690	FakeDesc1690	FakeAnc1690	SIMULPF00001	120	123	136	107	16	13
6691	RV_pair1691	FakeDesc1691	FakeAnc1691	SIMULPF00001	137	139	150	126	13	11
6692	RV_pair1692	FakeDesc1692	FakeAnc1692	SIMULPF00001	57	61	64	54	7	3
6693	RV_pair1693	FakeDesc1693	FakeAnc1693	SIMULPF00001	111	112	118	105	7	6
6694	RV_pair1694	FakeDesc1694	FakeAnc1694	SIMULPF00001	47	47	49	45	2	2
6695	RV_pair1695	FakeDesc1695	FakeAnc1695	SIMULPF00001	26	25	26	25	0	1
6696	RV_pair1696	FakeDesc1696	FakeAnc1696	SIMULPF00001	26	28	31	23	5	3
6697	RV_pair1697	FakeDesc1697	FakeAnc1697	SIMULPF00001	20	18	21	17	1	3
6698	RV_pair1698	FakeDesc1698	FakeAnc1698	SIMULPF00001	51	47	53	45	2	6
6699	RV_pair1699	FakeDesc1699	FakeAnc1699	SIMULPF00001	493	483	535	441	42	52
6700	RV_pair1700	FakeDesc1700	FakeAnc1700	SIMULPF00001	549	577	627	499	78	50
6701	RV_pair1701	FakeDesc1701	FakeAnc1701	SIMULPF00001	655	651	714	592	59	63
6702	RV_pair1702	FakeDesc1702	FakeAnc1702	SIMULPF00001	98	102	106	94	8	4
6703	RV_pair1703	FakeDesc1703	FakeAnc1703	SIMULPF00001	165	164	181	148	16	17
6704	RV_pair1704	FakeDesc1704	FakeAnc1704	SIMULPF00001	98	90	106	82	8	16
6705	RV_pair1705	FakeDesc1705	FakeAnc1705	SIMULPF00001	41	43	47	37	6	4
6706	RV_pair1706	FakeDesc1706	FakeAnc1706	SIMULPF00001	75	68	76	67	1	8
6707	RV_pair1707	FakeDesc1707	FakeAnc1707	SIMULPF00001	7	5	7	5	0	2
6708	RV_pair1708	FakeDesc1708	FakeAnc1708	SIMULPF00001	296	277	324	249	28	47
6709	RV_pair1709	FakeDesc1709	FakeAnc1709	SIMULPF00001	29	29	31	27	2	2
6710	RV_pair1710	FakeDesc1710	FakeAnc1710	SIMULPF00001	81	85	94	72	13	9
6711	RV_pair1711	FakeDesc1711	FakeAnc1711	SIMULPF00001	50	48	52	46	2	4
6712	RV_pair1712	FakeDesc1712	FakeAnc1712	SIMULPF00001	349	334	362	321	13	28
6713	RV_pair1713	FakeDesc1713	FakeAnc1713	SIMULPF00001	205	195	218	182	13	23
6714	RV_pair1714	FakeDesc1714	FakeAnc1714	SIMULPF00001	293	270	309	254	16	39
6715	RV_pair1715	FakeDesc1715	FakeAnc1715	SIMULPF00001	107	100	110	97	3	10
6716	RV_pair1716	FakeDesc1716	FakeAnc1716	SIMULPF00001	144	149	152	141	8	3
6717	RV_pair1717	FakeDesc1717	FakeAnc1717	SIMULPF00001	441	444	491	394	50	47
6718	RV_pair1718	FakeDesc1718	FakeAnc1718	SIMULPF00001	168	175	188	155	20	13
6719	RV_pair1719	FakeDesc1719	FakeAnc1719	SIMULPF00001	792	786	862	716	70	76
6720	RV_pair1720	FakeDesc1720	FakeAnc1720	SIMULPF00001	291	292	313	270	22	21
6721	RV_pair1721	FakeDesc1721	FakeAnc1721	SIMULPF00001	185	202	211	176	26	9
6722	RV_pair1722	FakeDesc1722	FakeAnc1722	SIMULPF00001	380	385	411	354	31	26
6723	RV_pair1723	FakeDesc1723	FakeAnc1723	SIMULPF00001	47	52	56	43	9	4
6724	RV_pair1724	FakeDesc1724	FakeAnc1724	SIMULPF00001	57	56	61	52	4	5
6725	RV_pair1725	FakeDesc1725	FakeAnc1725	SIMULPF00001	58	57	64	51	6	7
6726	RV_pair1726	FakeDesc1726	FakeAnc1726	SIMULPF00001	593	583	636	540	43	53
6727	RV_pair1727	FakeDesc1727	FakeAnc1727	SIMULPF00001	82	84	87	79	5	3
6728	RV_pair1728	FakeDesc1728	FakeAnc1728	SIMULPF00001	79	75	80	74	1	5
6729	RV_pair1729	FakeDesc1729	FakeAnc1729	SIMULPF00001	507	506	534	479	27	28
6730	RV_pair1730	FakeDesc1730	FakeAnc1730	SIMULPF00001	34	36	40	30	6	4
6731	RV_pair1731	FakeDesc1731	FakeAnc1731	SIMULPF00001	307	328	352	283	45	24
6732	RV_pair1732	FakeDesc1732	FakeAnc1732	SIMULPF00001	71	66	80	57	9	14
6733	RV_pair1733	FakeDesc1733	FakeAnc1733	SIMULPF00001	761	768	843	686	82	75
6734	RV_pair1734	FakeDesc1734	FakeAnc1734	SIMULPF00001	290	311	337	264	47	26
6735	RV_pair1735	FakeDesc1735	FakeAnc1735	SIMULPF00001	227	217	244	200	17	27
6736	RV_pair1736	FakeDesc1736	FakeAnc1736	SIMULPF00001	638	652	701	589	63	49
6737	RV_pair1737	FakeDesc1737	FakeAnc1737	SIMULPF00001	135	126	145	116	10	19
6738	RV_pair1738	FakeDesc1738	FakeAnc1738	SIMULPF00001	424	429	461	392	37	32
6739	RV_pair1739	FakeDesc1739	FakeAnc1739	SIMULPF00001	295	281	320	256	25	39
6740	RV_pair1740	FakeDesc1740	FakeAnc1740	SIMULPF00001	165	160	173	152	8	13
6741	RV_pair1741	FakeDesc1741	FakeAnc1741	SIMULPF00001	34	37	41	30	7	4
6742	RV_pair1742	FakeDesc1742	FakeAnc1742	SIMULPF00001	81	89	93	77	12	4
6743	RV_pair1743	FakeDesc1743	FakeAnc1743	SIMULPF00001	58	59	65	52	7	6
6744	RV_pair1744	FakeDesc1744	FakeAnc1744	SIMULPF00001	142	145	158	129	16	13
6745	RV_pair1745	FakeDesc1745	FakeAnc1745	SIMULPF00001	174	180	191	163	17	11
6746	RV_pair1746	FakeDesc1746	FakeAnc1746	SIMULPF00001	469	467	514	422	45	47
6747	RV_pair1747	FakeDesc1747	FakeAnc1747	SIMULPF00001	192	179	205	166	13	26
6748	RV_pair1748	FakeDesc1748	FakeAnc1748	SIMULPF00001	34	35	39	30	5	4
6749	RV_pair1749	FakeDesc1749	FakeAnc1749	SIMULPF00001	289	278	311	256	22	33
6750	RV_pair1750	FakeDesc1750	FakeAnc1750	SIMULPF00001	127	126	137	116	10	11
6751	RV_pair1751	FakeDesc1751	FakeAnc1751	SIMULPF00001	622	609	678	553	56	69
6752	RV_pair1752	FakeDesc1752	FakeAnc1752	SIMULPF00001	104	107	114	97	10	7
6753	RV_pair1753	FakeDesc1753	FakeAnc1753	SIMULPF00001	9	10	10	9	1	0
6754	RV_pair1754	FakeDesc1754	FakeAnc1754	SIMULPF00001	82	85	90	77	8	5
6755	RV_pair1755	FakeDesc1755	FakeAnc1755	SIMULPF00001	168	158	177	149	9	19
6756	RV_pair1756	FakeDesc1756	FakeAnc1756	SIMULPF00001	795	798	885	708	90	87
6757	RV_pair1757	FakeDesc1757	FakeAnc1757	SIMULPF00001	279	281	310	250	31	29
6758	RV_pair1758	FakeDesc1758	FakeAnc1758	SIMULPF00001	651	674	742	583	91	68
6759	RV_pair1759	FakeDesc1759	FakeAnc1759	SIMULPF00001	71	74	78	67	7	4
6760	RV_pair1760	FakeDesc1760	FakeAnc1760	SIMULPF00001	11	8	11	8	0	3
6761	RV_pair1761	FakeDesc1761	FakeAnc1761	SIMULPF00001	324	335	358	301	34	23
6762	RV_pair1762	FakeDesc1762	FakeAnc1762	SIMULPF00001	75	71	84	62	9	13
6763	RV_pair1763	FakeDesc1763	FakeAnc1763	SIMULPF00001	6	6	6	6	0	0
6764	RV_pair1764	FakeDesc1764	FakeAnc1764	SIMULPF00001	170	166	185	151	15	19
6765	RV_pair1765	FakeDesc1765	FakeAnc1765	SIMULPF00001	57	57	62	52	5	5
6766	RV_pair1766	FakeDesc1766	FakeAnc1766	SIMULPF00001	713	731	790	654	77	59
6767	RV_pair1767	FakeDesc1767	FakeAnc1767	SIMULPF00001	106	105	116	95	10	11
6768	RV_pair1768	FakeDesc1768	FakeAnc1768	SIMULPF00001	137	139	152	124	15	13
6769	RV_pair1769	FakeDesc1769	FakeAnc1769	SIMULPF00001	151	150	164	137	13	14
6770	RV_pair1770	FakeDesc1770	FakeAnc1770	SIMULPF00001	151	151	164	138	13	13
6771	RV_pair1771	FakeDesc1771	FakeAnc1771	SIMULPF00001	109	106	118	97	9	12
6772	RV_pair1772	FakeDesc1772	FakeAnc1772	SIMULPF00001	33	33	34	32	1	1
6773	RV_pair1773	FakeDesc1773	FakeAnc1773	SIMULPF00001	35	31	38	28	3	7
6774	RV_pair1774	FakeDesc1774	FakeAnc1774	SIMULPF00001	14	14	15	13	1	1
6775	RV_pair1775	FakeDesc1775	FakeAnc1775	SIMULPF00001	133	129	140	122	7	11
6776	RV_pair1776	FakeDesc1776	FakeAnc1776	SIMULPF00001	396	392	434	354	38	42
6777	RV_pair1777	FakeDesc1777	FakeAnc1777	SIMULPF00001	460	463	503	420	43	40
6778	RV_pair1778	FakeDesc1778	FakeAnc1778	SIMULPF00001	20	22	23	19	3	1
6779	RV_pair1779	FakeDesc1779	FakeAnc1779	SIMULPF00001	147	146	158	135	11	12
6780	RV_pair1780	FakeDesc1780	FakeAnc1780	SIMULPF00001	30	25	31	24	1	6
6781	RV_pair1781	FakeDesc1781	FakeAnc1781	SIMULPF00001	136	143	155	124	19	12
6782	RV_pair1782	FakeDesc1782	FakeAnc1782	SIMULPF00001	145	144	157	132	12	13
6783	RV_pair1783	FakeDesc1783	FakeAnc1783	SIMULPF00001	243	238	269	212	26	31
6784	RV_pair1784	FakeDesc1784	FakeAnc1784	SIMULPF00001	895	892	974	813	79	82
6785	RV_pair1785	FakeDesc1785	FakeAnc1785	SIMULPF00001	3	3	3	3	0	0
6786	RV_pair1786	FakeDesc1786	FakeAnc1786	SIMULPF00001	362	352	396	318	34	44
6787	RV_pair1787	FakeDesc1787	FakeAnc1787	SIMULPF00001	103	101	108	96	5	7
6788	RV_pair1788	FakeDesc1788	FakeAnc1788	SIMULPF00001	852	848	944	756	92	96
6789	RV_pair1789	FakeDesc1789	FakeAnc1789	SIMULPF00001	74	78	86	66	12	8
6790	RV_pair1790	FakeDesc1790	FakeAnc1790	SIMULPF00001	248	242	269	221	21	27
6791	RV_pair1791	FakeDesc1791	FakeAnc1791	SIMULPF00001	423	433	463	393	40	30
6792	RV_pair1792	FakeDesc1792	FakeAnc1792	SIMULPF00001	294	291	322	263	28	31
6793	RV_pair1793	FakeDesc1793	FakeAnc1793	SIMULPF00001	861	850	946	765	85	96
6794	RV_pair1794	FakeDesc1794	FakeAnc1794	SIMULPF00001	302	312	336	278	34	24
6795	RV_pair1795	FakeDesc1795	FakeAnc1795	SIMULPF00001	125	114	132	107	7	18
6796	RV_pair1796	FakeDesc1796	FakeAnc1796	SIMULPF00001	542	533	584	491	42	51
6797	RV_pair1797	FakeDesc1797	FakeAnc1797	SIMULPF00001	64	61	69	56	5	8
6798	RV_pair1798	FakeDesc1798	FakeAnc1798	SIMULPF00001	290	272	314	248	24	42
6799	RV_pair1799	FakeDesc1799	FakeAnc1799	SIMULPF00001	36	35	40	31	4	5
6800	RV_pair1800	FakeDesc1800	FakeAnc1800	SIMULPF00001	128	128	138	118	10	10
6801	RV_pair1801	FakeDesc1801	FakeAnc1801	SIMULPF00001	147	149	157	139	10	8
6802	RV_pair1802	FakeDesc1802	FakeAnc1802	SIMULPF00001	80	86	93	73	13	7
6803	RV_pair1803	FakeDesc1803	FakeAnc1803	SIMULPF00001	853	839	923	769	70	84
6804	RV_pair1804	FakeDesc1804	FakeAnc1804	SIMULPF00001	119	121	127	113	8	6
6805	RV_pair1805	FakeDesc1805	FakeAnc1805	SIMULPF00001	272	297	325	244	53	28
6806	RV_pair1806	FakeDesc1806	FakeAnc1806	SIMULPF00001	904	888	974	818	70	86
6807	RV_pair1807	FakeDesc1807	FakeAnc1807	SIMULPF00001	135	144	151	128	16	7
6808	RV_pair1808	FakeDesc1808	FakeAnc1808	SIMULPF00001	165	156	180	141	15	24
6809	RV_pair1809	FakeDesc1809	FakeAnc1809	SIMULPF00001	10	9	10	9	0	1
6810	RV_pair1810	FakeDesc1810	FakeAnc1810	SIMULPF00001	118	116	124	110	6	8
6811	RV_pair1811	FakeDesc1811	FakeAnc1811	SIMULPF00001	722	710	779	653	57	69
6812	RV_pair1812	FakeDesc1812	FakeAnc1812	SIMULPF00001	245	253	273	225	28	20
6813	RV_pair1813	FakeDesc1813	FakeAnc1813	SIMULPF00001	436	428	484	380	48	56
6814	RV_pair1814	FakeDesc1814	FakeAnc1814	SIMULPF00001	84	86	99	71	15	13
6815	RV_pair1815	FakeDesc1815	FakeAnc1815	SIMULPF00001	514	546	582	478	68	36
6816	RV_pair1816	FakeDesc1816	FakeAnc1816	SIMULPF00001	143	141	156	128	13	15
6817	RV_pair1817	FakeDesc1817	FakeAnc1817	SIMULPF00001	306	306	331	281	25	25
6818	RV_pair1818	FakeDesc1818	FakeAnc1818	SIMULPF00001	139	131	147	123	8	16
6819	RV_pair1819	FakeDesc1819	FakeAnc1819	SIMULPF00001	60	60	66	54	6	6
6820	RV_pair1820	FakeDesc1820	FakeAnc1820	SIMULPF00001	291	308	326	273	35	18
6821	RV_pair1821	FakeDesc1821	FakeAnc1821	SIMULPF00001	205	206	220	191	15	14
6822	RV_pair1822	FakeDesc1822	FakeAnc1822	SIMULPF00001	72	65	76	61	4	11
6823	RV_pair1823	FakeDesc1823	FakeAnc1823	SIMULPF00001	126	109	129	106	3	20
6824	RV_pair1824	FakeDesc1824	FakeAnc1824	SIMULPF00001	159	161	174	146	15	13
6825	RV_pair1825	FakeDesc1825	FakeAnc1825	SIMULPF00001	7	7	7	7	0	0
6826	RV_pair1826	FakeDesc1826	FakeAnc1826	SIMULPF00001	290	291	318	263	28	27
6827	RV_pair1827	FakeDesc1827	FakeAnc1827	SIMULPF00001	193	196	210	179	17	14
6828	RV_pair1828	FakeDesc1828	FakeAnc1828	SIMULPF00001	8	8	8	8	0	0
6829	RV_pair1829	FakeDesc1829	FakeAnc1829	SIMULPF00001	206	218	231	193	25	13
6830	RV_pair1830	FakeDesc1830	FakeAnc1830	SIMULPF00001	510	520	563	467	53	43
6831	RV_pair1831	FakeDesc1831	FakeAnc1831	SIMULPF00001	206	211	230	187	24	19
6832	RV_pair1832	FakeDesc1832	FakeAnc1832	SIMULPF00001	223	218	239	202	16	21
6833	RV_pair1833	FakeDesc1833	FakeAnc1833	SIMULPF00001	247	242	268	221	21	26
6834	RV_pair1834	FakeDesc1834	FakeAnc1834	SIMULPF00001	196	190	215	171	19	25
6835	RV_pair1835	FakeDesc1835	FakeAnc1835	SIMULPF00001	144	143	157	130	13	14
6836	RV_pair1836	FakeDesc1836	FakeAnc1836	SIMULPF00001	823	836	914	745	91	78
6837	RV_pair1837	FakeDesc1837	FakeAnc1837	SIMULPF00001	201	219	227	193	26	8
6838	RV_pair1838	FakeDesc1838	FakeAnc1838	SIMULPF00001	399	402	432	369	33	30
6839	RV_pair1839	FakeDesc1839	FakeAnc1839	SIMULPF00001	23	25	26	22	3	1
6840	RV_pair1840	FakeDesc1840	FakeAnc1840	SIMULPF00001	145	146	162	129	17	16
6841	RV_pair1841	FakeDesc1841	FakeAnc1841	SIMULPF00001	93	86	100	79	7	14
6842	RV_pair1842	FakeDesc1842	FakeAnc1842	SIMULPF00001	50	45	52	43	2	7
6843	RV_pair1843	FakeDesc1843	FakeAnc1843	SIMULPF00001	95	102	110	87	15	8
6844	RV_pair1844	FakeDesc1844	FakeAnc1844	SIMULPF00001	198	204	220	182	22	16
6845	RV_pair1845	FakeDesc1845	FakeAnc1845	SIMULPF00001	19	21	21	19	2	0
6846	RV_pair1846	FakeDesc1846	FakeAnc1846	SIMULPF00001	43	45	47	41	4	2
6847	RV_pair1847	FakeDesc1847	FakeAnc1847	SIMULPF00001	75	70	79	66	4	9
6848	RV_pair1848	FakeDesc1848	FakeAnc1848	SIMULPF00001	449	444	491	402	42	47
6849	RV_pair1849	FakeDesc1849	FakeAnc1849	SIMULPF00001	273	260	292	241	19	32
6850	RV_pair1850	FakeDesc1850	FakeAnc1850	SIMULPF00001	212	207	228	191	16	21
6851	RV_pair1851	FakeDesc1851	FakeAnc1851	SIMULPF00001	86	87	94	79	8	7
6852	RV_pair1852	FakeDesc1852	FakeAnc1852	SIMULPF00001	252	258	277	233	25	19
6853	RV_pair1853	FakeDesc1853	FakeAnc1853	SIMULPF00001	270	272	299	243	29	27
6854	RV_pair1854	FakeDesc1854	FakeAnc1854	SIMULPF00001	214	199	224	189	10	25
6855	RV_pair1855	FakeDesc1855	FakeAnc1855	SIMULPF00001	224	225	249	200	25	24
6856	RV_pair1856	FakeDesc1856	FakeAnc1856	SIMULPF00001	693	686	750	629	57	64
6857	RV_pair1857	FakeDesc1857	FakeAnc1857	SIMULPF00001	164	174	187	151	23	13
6858	RV_pair1858	FakeDesc1858	FakeAnc1858	SIMULPF00001	149	140	158	131	9	18
6859	RV_pair1859	FakeDesc1859	FakeAnc1859	SIMULPF00001	253	248	282	219	29	34
6860	RV_pair1860	FakeDesc1860	FakeAnc1860	SIMULPF00001	613	617	667	563	54	50
6861	RV_pair1861	FakeDesc1861	FakeAnc1861	SIMULPF00001	15	14	16	13	1	2
6862	RV_pair1862	FakeDesc1862	FakeAnc1862	SIMULPF00001	649	653	719	583	70	66
6863	RV_pair1863	FakeDesc1863	FakeAnc1863	SIMULPF00001	116	117	127	106	11	10
6864	RV_pair1864	FakeDesc1864	FakeAnc1864	SIMULPF00001	66	61	72	55	6	11
6865	RV_pair1865	FakeDesc1865	FakeAnc1865	SIMULPF00001	45	49	50	44	5	1
6866	RV_pair1866	FakeDesc1866	FakeAnc1866	SIMULPF00001	13	13	14	12	1	1
6867	RV_pair1867	FakeDesc1867	FakeAnc1867	SIMULPF00001	158	153	170	141	12	17
6868	RV_pair1868	FakeDesc1868	FakeAnc1868	SIMULPF00001	400	397	435	362	35	38
6869	RV_pair1869	FakeDesc1869	FakeAnc1869	SIMULPF00001	208	193	221	180	13	28
6870	RV_pair1870	FakeDesc1870	FakeAnc1870	SIMULPF00001	103	103	114	92	11	11
6871	RV_pair1871	FakeDesc1871	FakeAnc1871	SIMULPF00001	66	68	71	63	5	3
6872	RV_pair1872	FakeDesc1872	FakeAnc1872	SIMULPF00001	404	410	450	364	46	40
6873	RV_pair1873	FakeDesc1873	FakeAnc1873	SIMULPF00001	321	319	350	290	29	31
6874	RV_pair1874	FakeDesc1874	FakeAnc1874	SIMULPF00001	285	282	314	253	29	32
6875	RV_pair1875	FakeDesc1875	FakeAnc1875	SIMULPF00001	504	503	536	471	32	33
6876	RV_pair1876	FakeDesc1876	FakeAnc1876	SIMULPF00001	136	135	144	127	8	9
6877	RV_pair1877	FakeDesc1877	FakeAnc1877	SIMULPF00001	24	25	26	23	2	1
6878	RV_pair1878	FakeDesc1878	FakeAnc1878	SIMULPF00001	444	429	471	402	27	42
6879	RV_pair1879	FakeDesc1879	FakeAnc1879	SIMULPF00001	439	443	473	409	34	30
6880	RV_pair1880	FakeDesc1880	FakeAnc1880	SIMULPF00001	77	77	86	68	9	9
6881	RV_pair1881	FakeDesc1881	FakeAnc1881	SIMULPF00001	3	1	3	1	0	2
6882	RV_pair1882	FakeDesc1882	FakeAnc1882	SIMULPF00001	189	189	206	172	17	17
6883	RV_pair1883	FakeDesc1883	FakeAnc1883	SIMULPF00001	22	20	23	19	1	3
6884	RV_pair1884	FakeDesc1884	FakeAnc1884	SIMULPF00001	295	302	334	263	39	32
6885	RV_pair1885	FakeDesc1885	FakeAnc1885	SIMULPF00001	447	462	502	407	55	40
6886	RV_pair1886	FakeDesc1886	FakeAnc1886	SIMULPF00001	262	259	290	231	28	31
6887	RV_pair1887	FakeDesc1887	FakeAnc1887	SIMULPF00001	388	379	419	348	31	40
6888	RV_pair1888	FakeDesc1888	FakeAnc1888	SIMULPF00001	18	18	19	17	1	1
6889	RV_pair1889	FakeDesc1889	FakeAnc1889	SIMULPF00001	227	229	242	214	15	13
6890	RV_pair1890	FakeDesc1890	FakeAnc1890	SIMULPF00001	286	286	310	262	24	24
6891	RV_pair1891	FakeDesc1891	FakeAnc1891	SIMULPF00001	104	95	109	90	5	14
6892	RV_pair1892	FakeDesc1892	FakeAnc1892	SIMULPF00001	173	171	190	154	17	19
6893	RV_pair1893	FakeDesc1893	FakeAnc1893	SIMULPF00001	222	242	252	212	30	10
6894	RV_pair1894	FakeDesc1894	FakeAnc1894	SIMULPF00001	715	690	766	639	51	76
6895	RV_pair1895	FakeDesc1895	FakeAnc1895	SIMULPF00001	641	646	706	581	65	60
6896	RV_pair1896	FakeDesc1896	FakeAnc1896	SIMULPF00001	13	17	17	13	4	0
6897	RV_pair1897	FakeDesc1897	FakeAnc1897	SIMULPF00001	27	21	28	20	1	7
6898	RV_pair1898	FakeDesc1898	FakeAnc1898	SIMULPF00001	186	185	205	166	19	20
6899	RV_pair1899	FakeDesc1899	FakeAnc1899	SIMULPF00001	275	275	304	246	29	29
6900	RV_pair1900	FakeDesc1900	FakeAnc1900	SIMULPF00001	421	415	450	386	29	35
6901	RV_pair1901	FakeDesc1901	FakeAnc1901	SIMULPF00001	227	230	252	205	25	22
6902	RV_pair1902	FakeDesc1902	FakeAnc1902	SIMULPF00001	705	720	787	638	82	67
6903	RV_pair1903	FakeDesc1903	FakeAnc1903	SIMULPF00001	97	95	105	87	8	10
6904	RV_pair1904	FakeDesc1904	FakeAnc1904	SIMULPF00001	522	514	567	469	45	53
6905	RV_pair1905	FakeDesc1905	FakeAnc1905	SIMULPF00001	7	8	8	7	1	0
6906	RV_pair1906	FakeDesc1906	FakeAnc1906	SIMULPF00001	895	887	968	814	73	81
6907	RV_pair1907	FakeDesc1907	FakeAnc1907	SIMULPF00001	288	298	322	264	34	24
6908	RV_pair1908	FakeDesc1908	FakeAnc1908	SIMULPF00001	18	17	18	17	0	1
6909	RV_pair1909	FakeDesc1909	FakeAnc1909	SIMULPF00001	64	60	67	57	3	7
6910	RV_pair1910	FakeDesc1910	FakeAnc1910	SIMULPF00001	22	25	26	21	4	1
6911	RV_pair1911	FakeDesc1911	FakeAnc1911	SIMULPF00001	106	104	112	98	6	8
6912	RV_pair1912	FakeDesc1912	FakeAnc1912	SIMULPF00001	468	474	518	424	50	44
6913	RV_pair1913	FakeDesc1913	FakeAnc1913	SIMULPF00001	317	303	336	284	19	33
6914	RV_pair1914	FakeDesc1914	FakeAnc1914	SIMULPF00001	271	288	309	250	38	21
6915	RV_pair1915	FakeDesc1915	FakeAnc1915	SIMULPF00001	1	1	1	1	0	0
6916	RV_pair1916	FakeDesc1916	FakeAnc1916	SIMULPF00001	32	33	34	31	2	1
6917	RV_pair1917	FakeDesc1917	FakeAnc1917	SIMULPF00001	97	109	114	92	17	5
6918	RV_pair1918	FakeDesc1918	FakeAnc1918	SIMULPF00001	31	27	32	26	1	5
6919	RV_pair1919	FakeDesc1919	FakeAnc1919	SIMULPF00001	95	87	103	79	8	16
6920	RV_pair1920	FakeDesc1920	FakeAnc1920	SIMULPF00001	430	435	473	392	43	38
6921	RV_pair1921	FakeDesc1921	FakeAnc1921	SIMULPF00001	358	356	393	321	35	37
6922	RV_pair1922	FakeDesc1922	FakeAnc1922	SIMULPF00001	393	400	442	351	49	42
6923	RV_pair1923	FakeDesc1923	FakeAnc1923	SIMULPF00001	232	240	259	213	27	19
6924	RV_pair1924	FakeDesc1924	FakeAnc1924	SIMULPF00001	23	27	27	23	4	0
6925	RV_pair1925	FakeDesc1925	FakeAnc1925	SIMULPF00001	94	103	112	85	18	9
6926	RV_pair1926	FakeDesc1926	FakeAnc1926	SIMULPF00001	16	16	17	15	1	1
6927	RV_pair1927	FakeDesc1927	FakeAnc1927	SIMULPF00001	21	20	23	18	2	3
6928	RV_pair1928	FakeDesc1928	FakeAnc1928	SIMULPF00001	206	207	225	188	19	18
6929	RV_pair1929	FakeDesc1929	FakeAnc1929	SIMULPF00001	87	82	94	75	7	12
6930	RV_pair1930	FakeDesc1930	FakeAnc1930	SIMULPF00001	220	211	240	191	20	29
6931	RV_pair1931	FakeDesc1931	FakeAnc1931	SIMULPF00001	145	146	154	137	9	8
6932	RV_pair1932	FakeDesc1932	FakeAnc1932	SIMULPF00001	807	811	886	732	79	75
6933	RV_pair1933	FakeDesc1933	FakeAnc1933	SIMULPF00001	435	453	490	398	55	37
6934	RV_pair1934	FakeDesc1934	FakeAnc1934	SIMULPF00001	21	27	27	21	6	0
6935	RV_pair1935	FakeDesc1935	FakeAnc1935	SIMULPF00001	80	85	90	75	10	5
6936	RV_pair1936	FakeDesc1936	FakeAnc1936	SIMULPF00001	54	53	56	51	2	3
6937	RV_pair1937	FakeDesc1937	FakeAnc1937	SIMULPF00001	367	375	409	333	42	34
6938	RV_pair1938	FakeDesc1938	FakeAnc1938	SIMULPF00001	13	14	14	13	1	0
6939	RV_pair1939	FakeDesc1939	FakeAnc1939	SIMULPF00001	296	298	330	264	34	32
6940	RV_pair1940	FakeDesc1940	FakeAnc1940	SIMULPF00001	396	403	439	360	43	36
6941	RV_pair1941	FakeDesc1941	FakeAnc1941	SIMULPF00001	385	393	424	354	39	31
6942	RV_pair1942	FakeDesc1942	FakeAnc1942	SIMULPF00001	251	253	276	228	25	23
6943	RV_pair1943	FakeDesc1943	FakeAnc1943	SIMULPF00001	64	60	67	57	3	7
6944	RV_pair1944	FakeDesc1944	FakeAnc1944	SIMULPF00001	22	28	29	21	7	1
6945	RV_pair1945	FakeDesc1945	FakeAnc1945	SIMULPF00001	116	119	128	107	12	9
6946	RV_pair1946	FakeDesc1946	FakeAnc1946	SIMULPF00001	113	106	117	102	4	11
6947	RV_pair1947	FakeDesc1947	FakeAnc1947	SIMULPF00001	153	160	174	139	21	14
6948	RV_pair1948	FakeDesc1948	FakeAnc1948	SIMULPF00001	267	255	289	233	22	34
6949	RV_pair1949	FakeDesc1949	FakeAnc1949	SIMULPF00001	109	97	114	92	5	17
6950	RV_pair1950	FakeDesc1950	FakeAnc1950	SIMULPF00001	5	7	7	5	2	0
6951	RV_pair1951	FakeDesc1951	FakeAnc1951	SIMULPF00001	61	54	62	53	1	8
6952	RV_pair1952	FakeDesc1952	FakeAnc1952	SIMULPF00001	163	159	175	147	12	16
6953	RV_pair1953	FakeDesc1953	FakeAnc1953	SIMULPF00001	47	52	60	39	13	8
6954	RV_pair1954	FakeDesc1954	FakeAnc1954	SIMULPF00001	10	9	10	9	0	1
6955	RV_pair1955	FakeDesc1955	FakeAnc1955	SIMULPF00001	518	519	561	476	43	42
6956	RV_pair1956	FakeDesc1956	FakeAnc1956	SIMULPF00001	3	3	3	3	0	0
6957	RV_pair1957	FakeDesc1957	FakeAnc1957	SIMULPF00001	94	89	103	80	9	14
6958	RV_pair1958	FakeDesc1958	FakeAnc1958	SIMULPF00001	4	5	5	4	1	0
6959	RV_pair1959	FakeDesc1959	FakeAnc1959	SIMULPF00001	185	185	198	172	13	13
6960	RV_pair1960	FakeDesc1960	FakeAnc1960	SIMULPF00001	189	191	204	176	15	13
6961	RV_pair1961	FakeDesc1961	FakeAnc1961	SIMULPF00001	183	178	193	168	10	15
6962	RV_pair1962	FakeDesc1962	FakeAnc1962	SIMULPF00001	20	23	23	20	3	0
6963	RV_pair1963	FakeDesc1963	FakeAnc1963	SIMULPF00001	210	203	219	194	9	16
6964	RV_pair1964	FakeDesc1964	FakeAnc1964	SIMULPF00001	144	140	152	132	8	12
6965	RV_pair1965	FakeDesc1965	FakeAnc1965	SIMULPF00001	19	15	19	15	0	4
6966	RV_pair1966	FakeDesc1966	FakeAnc1966	SIMULPF00001	38	36	41	33	3	5
6967	RV_pair1967	FakeDesc1967	FakeAnc1967	SIMULPF00001	93	85	94	84	1	9
6968	RV_pair1968	FakeDesc1968	FakeAnc1968	SIMULPF00001	225	218	241	202	16	23
6969	RV_pair1969	FakeDesc1969	FakeAnc1969	SIMULPF00001	104	108	118	94	14	10
6970	RV_pair1970	FakeDesc1970	FakeAnc1970	SIMULPF00001	21	20	21	20	0	1
6971	RV_pair1971	FakeDesc1971	FakeAnc1971	SIMULPF00001	48	46	48	46	0	2
6972	RV_pair1972	FakeDesc1972	FakeAnc1972	SIMULPF00001	19	20	24	15	5	4
6973	RV_pair1973	FakeDesc1973	FakeAnc1973	SIMULPF00001	283	288	315	256	32	27
6974	RV_pair1974	FakeDesc1974	FakeAnc1974	SIMULPF00001	766	776	842	700	76	66
6975	RV_pair1975	FakeDesc1975	FakeAnc1975	SIMULPF00001	241	247	268	220	27	21
6976	RV_pair1976	FakeDesc1976	FakeAnc1976	SIMULPF00001	431	435	468	398	37	33
6977	RV_pair1977	FakeDesc1977	FakeAnc1977	SIMULPF00001	710	726	792	644	82	66
6978	RV_pair1978	FakeDesc1978	FakeAnc1978	SIMULPF00001	452	452	496	408	44	44
6979	RV_pair1979	FakeDesc1979	FakeAnc1979	SIMULPF00001	854	856	934	776	80	78
6980	RV_pair1980	FakeDesc1980	FakeAnc1980	SIMULPF00001	148	144	155	137	7	11
6981	RV_pair1981	FakeDesc1981	FakeAnc1981	SIMULPF00001	100	94	105	89	5	11
6982	RV_pair1982	FakeDesc1982	FakeAnc1982	SIMULPF00001	259	264	285	238	26	21
6983	RV_pair1983	FakeDesc1983	FakeAnc1983	SIMULPF00001	25	23	26	22	1	3
6984	RV_pair1984	FakeDesc1984	FakeAnc1984	SIMULPF00001	5	4	5	4	0	1
6985	RV_pair1985	FakeDesc1985	FakeAnc1985	SIMULPF00001	474	485	528	431	54	43
6986	RV_pair1986	FakeDesc1986	FakeAnc1986	SIMULPF00001	147	151	162	136	15	11
6987	RV_pair1987	FakeDesc1987	FakeAnc1987	SIMULPF00001	38	34	44	28	6	10
6988	RV_pair1988	FakeDesc1988	FakeAnc1988	SIMULPF00001	58	56	60	54	2	4
6989	RV_pair1989	FakeDesc1989	FakeAnc1989	SIMULPF00001	58	56	62	52	4	6
6990	RV_pair1990	FakeDesc1990	FakeAnc1990	SIMULPF00001	57	61	65	53	8	4
6991	RV_pair1991	FakeDesc1991	FakeAnc1991	SIMULPF00001	171	160	187	144	16	27
6992	RV_pair1992	FakeDesc1992	FakeAnc1992	SIMULPF00001	151	155	172	134	21	17
6993	RV_pair1993	FakeDesc1993	FakeAnc1993	SIMULPF00001	390	387	417	360	27	30
6994	RV_pair1994	FakeDesc1994	FakeAnc1994	SIMULPF00001	552	549	605	496	53	56
6995	RV_pair1995	FakeDesc1995	FakeAnc1995	SIMULPF00001	95	90	97	88	2	7
6996	RV_pair1996	FakeDesc1996	FakeAnc1996	SIMULPF00001	371	374	404	341	33	30
6997	RV_pair1997	FakeDesc1997	FakeAnc1997	SIMULPF00001	366	363	404	325	38	41
6998	RV_pair1998	FakeDesc1998	FakeAnc1998	SIMULPF00001	503	517	560	460	57	43
6999	RV_pair1999	FakeDesc1999	FakeAnc1999	SIMULPF00001	32	29	35	26	3	6
7000	RV_pair2000	FakeDesc2000	FakeAnc2000	SIMULPF00001	58	63	66	55	8	3
7001	RV_pair2001	FakeDesc2001	FakeAnc2001	SIMULPF00001	59	57	63	53	4	6
7002	RV_pair2002	FakeDesc2002	FakeAnc2002	SIMULPF00001	233	242	258	217	25	16
7003	RV_pair2003	FakeDesc2003	FakeAnc2003	SIMULPF00001	72	63	76	59	4	13
7004	RV_pair2004	FakeDesc2004	FakeAnc2004	SIMULPF00001	10	10	11	9	1	1
7005	RV_pair2005	FakeDesc2005	FakeAnc2005	SIMULPF00001	27	29	31	25	4	2
7006	RV_pair2006	FakeDesc2006	FakeAnc2006	SIMULPF00001	21	24	25	20	4	1
7007	RV_pair2007	FakeDesc2007	FakeAnc2007	SIMULPF00001	203	191	214	180	11	23
7008	RV_pair2008	FakeDesc2008	FakeAnc2008	SIMULPF00001	307	299	331	275	24	32
7009	RV_pair2009	FakeDesc2009	FakeAnc2009	SIMULPF00001	138	140	156	122	18	16
7010	RV_pair2010	FakeDesc2010	FakeAnc2010	SIMULPF00001	166	161	180	147	14	19
7011	RV_pair2011	FakeDesc2011	FakeAnc2011	SIMULPF00001	39	42	42	39	3	0
7012	RV_pair2012	FakeDesc2012	FakeAnc2012	SIMULPF00001	154	152	169	137	15	17
7013	RV_pair2013	FakeDesc2013	FakeAnc2013	SIMULPF00001	154	152	169	137	15	17
7014	RV_pair2014	FakeDesc2014	FakeAnc2014	SIMULPF00001	94	91	100	85	6	9
7015	RV_pair2015	FakeDesc2015	FakeAnc2015	SIMULPF00001	289	284	318	255	29	34
7016	RV_pair2016	FakeDesc2016	FakeAnc2016	SIMULPF00001	240	240	265	215	25	25
7017	RV_pair2017	FakeDesc2017	FakeAnc2017	SIMULPF00001	510	508	552	466	42	44
7018	RV_pair2018	FakeDesc2018	FakeAnc2018	SIMULPF00001	84	83	89	78	5	6
7019	RV_pair2019	FakeDesc2019	FakeAnc2019	SIMULPF00001	114	112	124	102	10	12
7020	RV_pair2020	FakeDesc2020	FakeAnc2020	SIMULPF00001	783	785	861	707	78	76
7021	RV_pair2021	FakeDesc2021	FakeAnc2021	SIMULPF00001	104	112	118	98	14	6
7022	RV_pair2022	FakeDesc2022	FakeAnc2022	SIMULPF00001	250	260	279	231	29	19
7023	RV_pair2023	FakeDesc2023	FakeAnc2023	SIMULPF00001	709	692	760	641	51	68
7024	RV_pair2024	FakeDesc2024	FakeAnc2024	SIMULPF00001	226	234	253	207	27	19
7025	RV_pair2025	FakeDesc2025	FakeAnc2025	SIMULPF00001	340	336	361	315	21	25
7026	RV_pair2026	FakeDesc2026	FakeAnc2026	SIMULPF00001	19	19	22	16	3	3
7027	RV_pair2027	FakeDesc2027	FakeAnc2027	SIMULPF00001	31	24	31	24	0	7
7028	RV_pair2028	FakeDesc2028	FakeAnc2028	SIMULPF00001	32	31	32	31	0	1
7029	RV_pair2029	FakeDesc2029	FakeAnc2029	SIMULPF00001	563	568	607	524	44	39
7030	RV_pair2030	FakeDesc2030	FakeAnc2030	SIMULPF00001	380	388	428	340	48	40
7031	RV_pair2031	FakeDesc2031	FakeAnc2031	SIMULPF00001	699	709	766	642	67	57
7032	RV_pair2032	FakeDesc2032	FakeAnc2032	SIMULPF00001	213	206	228	191	15	22
7033	RV_pair2033	FakeDesc2033	FakeAnc2033	SIMULPF00001	209	212	232	189	23	20
7034	RV_pair2034	FakeDesc2034	FakeAnc2034	SIMULPF00001	17	17	19	15	2	2
7035	RV_pair2035	FakeDesc2035	FakeAnc2035	SIMULPF00001	425	415	463	377	38	48
7036	RV_pair2036	FakeDesc2036	FakeAnc2036	SIMULPF00001	605	612	661	556	56	49
7037	RV_pair2037	FakeDesc2037	FakeAnc2037	SIMULPF00001	13	11	13	11	0	2
7038	RV_pair2038	FakeDesc2038	FakeAnc2038	SIMULPF00001	123	112	128	107	5	16
7039	RV_pair2039	FakeDesc2039	FakeAnc2039	SIMULPF00001	84	86	90	80	6	4
7040	RV_pair2040	FakeDesc2040	FakeAnc2040	SIMULPF00001	38	41	43	36	5	2
7041	RV_pair2041	FakeDesc2041	FakeAnc2041	SIMULPF00001	275	266	301	240	26	35
7042	RV_pair2042	FakeDesc2042	FakeAnc2042	SIMULPF00001	172	172	186	158	14	14
7043	RV_pair2043	FakeDesc2043	FakeAnc2043	SIMULPF00001	97	106	115	88	18	9
7044	RV_pair2044	FakeDesc2044	FakeAnc2044	SIMULPF00001	34	31	35	30	1	4
7045	RV_pair2045	FakeDesc2045	FakeAnc2045	SIMULPF00001	258	265	287	236	29	22
7046	RV_pair2046	FakeDesc2046	FakeAnc2046	SIMULPF00001	49	58	60	47	11	2
7047	RV_pair2047	FakeDesc2047	FakeAnc2047	SIMULPF00001	104	101	110	95	6	9
7048	RV_pair2048	FakeDesc2048	FakeAnc2048	SIMULPF00001	97	104	116	85	19	12
7049	RV_pair2049	FakeDesc2049	FakeAnc2049	SIMULPF00001	121	128	133	116	12	5
7050	RV_pair2050	FakeDesc2050	FakeAnc2050	SIMULPF00001	52	52	59	45	7	7
7051	RV_pair2051	FakeDesc2051	FakeAnc2051	SIMULPF00001	30	27	30	27	0	3
7052	RV_pair2052	FakeDesc2052	FakeAnc2052	SIMULPF00001	387	399	442	344	55	43
7053	RV_pair2053	FakeDesc2053	FakeAnc2053	SIMULPF00001	450	446	487	409	37	41
7054	RV_pair2054	FakeDesc2054	FakeAnc2054	SIMULPF00001	59	59	63	55	4	4
7055	RV_pair2055	FakeDesc2055	FakeAnc2055	SIMULPF00001	312	321	346	287	34	25
7056	RV_pair2056	FakeDesc2056	FakeAnc2056	SIMULPF00001	9	7	10	6	1	3
7057	RV_pair2057	FakeDesc2057	FakeAnc2057	SIMULPF00001	698	689	771	616	73	82
7058	RV_pair2058	FakeDesc2058	FakeAnc2058	SIMULPF00001	133	128	141	120	8	13
7059	RV_pair2059	FakeDesc2059	FakeAnc2059	SIMULPF00001	48	46	50	44	2	4
7060	RV_pair2060	FakeDesc2060	FakeAnc2060	SIMULPF00001	209	194	222	181	13	28
7061	RV_pair2061	FakeDesc2061	FakeAnc2061	SIMULPF00001	187	196	205	178	18	9
7062	RV_pair2062	FakeDesc2062	FakeAnc2062	SIMULPF00001	144	136	150	130	6	14
7063	RV_pair2063	FakeDesc2063	FakeAnc2063	SIMULPF00001	58	58	61	55	3	3
7064	RV_pair2064	FakeDesc2064	FakeAnc2064	SIMULPF00001	341	339	366	314	25	27
7065	RV_pair2065	FakeDesc2065	FakeAnc2065	SIMULPF00001	17	22	22	17	5	0
7066	RV_pair2066	FakeDesc2066	FakeAnc2066	SIMULPF00001	35	37	38	34	3	1
7067	RV_pair2067	FakeDesc2067	FakeAnc2067	SIMULPF00001	344	357	389	312	45	32
7068	RV_pair2068	FakeDesc2068	FakeAnc2068	SIMULPF00001	210	226	233	203	23	7
7069	RV_pair2069	FakeDesc2069	FakeAnc2069	SIMULPF00001	3	5	6	2	3	1
7070	RV_pair2070	FakeDesc2070	FakeAnc2070	SIMULPF00001	223	228	249	202	26	21
7071	RV_pair2071	FakeDesc2071	FakeAnc2071	SIMULPF00001	147	146	163	130	16	17
7072	RV_pair2072	FakeDesc2072	FakeAnc2072	SIMULPF00001	42	40	43	39	1	3
7073	RV_pair2073	FakeDesc2073	FakeAnc2073	SIMULPF00001	156	152	169	139	13	17
7074	RV_pair2074	FakeDesc2074	FakeAnc2074	SIMULPF00001	185	189	201	173	16	12
7075	RV_pair2075	FakeDesc2075	FakeAnc2075	SIMULPF00001	673	677	727	623	54	50
7076	RV_pair2076	FakeDesc2076	FakeAnc2076	SIMULPF00001	52	56	57	51	5	1
7077	RV_pair2077	FakeDesc2077	FakeAnc2077	SIMULPF00001	140	133	147	126	7	14
7078	RV_pair2078	FakeDesc2078	FakeAnc2078	SIMULPF00001	65	62	70	57	5	8
7079	RV_pair2079	FakeDesc2079	FakeAnc2079	SIMULPF00001	86	84	94	76	8	10
7080	RV_pair2080	FakeDesc2080	FakeAnc2080	SIMULPF00001	34	33	37	30	3	4
7081	RV_pair2081	FakeDesc2081	FakeAnc2081	SIMULPF00001	188	168	198	158	10	30
7082	RV_pair2082	FakeDesc2082	FakeAnc2082	SIMULPF00001	28	31	32	27	4	1
7083	RV_pair2083	FakeDesc2083	FakeAnc2083	SIMULPF00001	156	151	170	137	14	19
7084	RV_pair2084	FakeDesc2084	FakeAnc2084	SIMULPF00001	344	346	374	316	30	28
7085	RV_pair2085	FakeDesc2085	FakeAnc2085	SIMULPF00001	158	156	171	143	13	15
7086	RV_pair2086	FakeDesc2086	FakeAnc2086	SIMULPF00001	21	20	25	16	4	5
7087	RV_pair2087	FakeDesc2087	FakeAnc2087	SIMULPF00001	24	23	25	22	1	2
7088	RV_pair2088	FakeDesc2088	FakeAnc2088	SIMULPF00001	65	71	74	62	9	3
7089	RV_pair2089	FakeDesc2089	FakeAnc2089	SIMULPF00001	141	149	163	127	22	14
7090	RV_pair2090	FakeDesc2090	FakeAnc2090	SIMULPF00001	203	204	226	181	23	22
7091	RV_pair2091	FakeDesc2091	FakeAnc2091	SIMULPF00001	319	325	345	299	26	20
7092	RV_pair2092	FakeDesc2092	FakeAnc2092	SIMULPF00001	99	110	121	88	22	11
7093	RV_pair2093	FakeDesc2093	FakeAnc2093	SIMULPF00001	132	130	144	118	12	14
7094	RV_pair2094	FakeDesc2094	FakeAnc2094	SIMULPF00001	291	278	304	265	13	26
7095	RV_pair2095	FakeDesc2095	FakeAnc2095	SIMULPF00001	304	320	346	278	42	26
7096	RV_pair2096	FakeDesc2096	FakeAnc2096	SIMULPF00001	487	500	539	448	52	39
7097	RV_pair2097	FakeDesc2097	FakeAnc2097	SIMULPF00001	679	678	749	608	70	71
7098	RV_pair2098	FakeDesc2098	FakeAnc2098	SIMULPF00001	143	145	161	127	18	16
7099	RV_pair2099	FakeDesc2099	FakeAnc2099	SIMULPF00001	129	116	138	107	9	22
7100	RV_pair2100	FakeDesc2100	FakeAnc2100	SIMULPF00001	117	126	140	103	23	14
7101	RV_pair2101	FakeDesc2101	FakeAnc2101	SIMULPF00001	232	223	243	212	11	20
7102	RV_pair2102	FakeDesc2102	FakeAnc2102	SIMULPF00001	182	181	197	166	15	16
7103	RV_pair2103	FakeDesc2103	FakeAnc2103	SIMULPF00001	502	495	556	441	54	61
7104	RV_pair2104	FakeDesc2104	FakeAnc2104	SIMULPF00001	97	101	107	91	10	6
7105	RV_pair2105	FakeDesc2105	FakeAnc2105	SIMULPF00001	39	41	45	35	6	4
7106	RV_pair2106	FakeDesc2106	FakeAnc2106	SIMULPF00001	35	40	41	34	6	1
7107	RV_pair2107	FakeDesc2107	FakeAnc2107	SIMULPF00001	536	525	586	475	50	61
7108	RV_pair2108	FakeDesc2108	FakeAnc2108	SIMULPF00001	260	267	282	245	22	15
7109	RV_pair2109	FakeDesc2109	FakeAnc2109	SIMULPF00001	252	251	277	226	25	26
7110	RV_pair2110	FakeDesc2110	FakeAnc2110	SIMULPF00001	207	200	227	180	20	27
7111	RV_pair2111	FakeDesc2111	FakeAnc2111	SIMULPF00001	534	515	568	481	34	53
7112	RV_pair2112	FakeDesc2112	FakeAnc2112	SIMULPF00001	22	24	25	21	3	1
7113	RV_pair2113	FakeDesc2113	FakeAnc2113	SIMULPF00001	387	374	417	344	30	43
7114	RV_pair2114	FakeDesc2114	FakeAnc2114	SIMULPF00001	63	59	69	53	6	10
7115	RV_pair2115	FakeDesc2115	FakeAnc2115	SIMULPF00001	509	525	572	462	63	47
7116	RV_pair2116	FakeDesc2116	FakeAnc2116	SIMULPF00001	173	164	185	152	12	21
7117	RV_pair2117	FakeDesc2117	FakeAnc2117	SIMULPF00001	287	289	317	259	30	28
7118	RV_pair2118	FakeDesc2118	FakeAnc2118	SIMULPF00001	185	192	206	171	21	14
7119	RV_pair2119	FakeDesc2119	FakeAnc2119	SIMULPF00001	745	736	808	673	63	72
7120	RV_pair2120	FakeDesc2120	FakeAnc2120	SIMULPF00001	195	188	210	173	15	22
7121	RV_pair2121	FakeDesc2121	FakeAnc2121	SIMULPF00001	25	28	28	25	3	0
7122	RV_pair2122	FakeDesc2122	FakeAnc2122	SIMULPF00001	309	290	335	264	26	45
7123	RV_pair2123	FakeDesc2123	FakeAnc2123	SIMULPF00001	366	372	398	340	32	26
7124	RV_pair2124	FakeDesc2124	FakeAnc2124	SIMULPF00001	295	291	319	267	24	28
7125	RV_pair2125	FakeDesc2125	FakeAnc2125	SIMULPF00001	292	284	321	255	29	37
7126	RV_pair2126	FakeDesc2126	FakeAnc2126	SIMULPF00001	171	175	187	159	16	12
7127	RV_pair2127	FakeDesc2127	FakeAnc2127	SIMULPF00001	269	275	290	254	21	15
7128	RV_pair2128	FakeDesc2128	FakeAnc2128	SIMULPF00001	70	66	73	63	3	7
7129	RV_pair2129	FakeDesc2129	FakeAnc2129	SIMULPF00001	24	23	24	23	0	1
7130	RV_pair2130	FakeDesc2130	FakeAnc2130	SIMULPF00001	173	175	192	156	19	17
7131	RV_pair2131	FakeDesc2131	FakeAnc2131	SIMULPF00001	87	85	90	82	3	5
7132	RV_pair2132	FakeDesc2132	FakeAnc2132	SIMULPF00001	262	262	287	237	25	25
7133	RV_pair2133	FakeDesc2133	FakeAnc2133	SIMULPF00001	669	674	736	607	67	62
7134	RV_pair2134	FakeDesc2134	FakeAnc2134	SIMULPF00001	751	748	816	683	65	68
7135	RV_pair2135	FakeDesc2135	FakeAnc2135	SIMULPF00001	181	190	202	169	21	12
7136	RV_pair2136	FakeDesc2136	FakeAnc2136	SIMULPF00001	503	489	545	447	42	56
7137	RV_pair2137	FakeDesc2137	FakeAnc2137	SIMULPF00001	250	251	278	223	28	27
7138	RV_pair2138	FakeDesc2138	FakeAnc2138	SIMULPF00001	25	27	28	24	3	1
7139	RV_pair2139	FakeDesc2139	FakeAnc2139	SIMULPF00001	209	199	227	181	18	28
7140	RV_pair2140	FakeDesc2140	FakeAnc2140	SIMULPF00001	156	155	168	143	12	13
7141	RV_pair2141	FakeDesc2141	FakeAnc2141	SIMULPF00001	120	109	125	104	5	16
7142	RV_pair2142	FakeDesc2142	FakeAnc2142	SIMULPF00001	14	19	19	14	5	0
7143	RV_pair2143	FakeDesc2143	FakeAnc2143	SIMULPF00001	114	120	128	106	14	8
7144	RV_pair2144	FakeDesc2144	FakeAnc2144	SIMULPF00001	80	88	94	74	14	6
7145	RV_pair2145	FakeDesc2145	FakeAnc2145	SIMULPF00001	135	134	147	122	12	13
7146	RV_pair2146	FakeDesc2146	FakeAnc2146	SIMULPF00001	115	107	123	99	8	16
7147	RV_pair2147	FakeDesc2147	FakeAnc2147	SIMULPF00001	256	242	278	220	22	36
7148	RV_pair2148	FakeDesc2148	FakeAnc2148	SIMULPF00001	327	315	358	284	31	43
7149	RV_pair2149	FakeDesc2149	FakeAnc2149	SIMULPF00001	387	393	431	349	44	38
7150	RV_pair2150	FakeDesc2150	FakeAnc2150	SIMULPF00001	155	157	165	147	10	8
7151	RV_pair2151	FakeDesc2151	FakeAnc2151	SIMULPF00001	13	14	14	13	1	0
7152	RV_pair2152	FakeDesc2152	FakeAnc2152	SIMULPF00001	106	111	120	97	14	9
7153	RV_pair2153	FakeDesc2153	FakeAnc2153	SIMULPF00001	551	552	590	513	39	38
7154	RV_pair2154	FakeDesc2154	FakeAnc2154	SIMULPF00001	76	79	91	64	15	12
7155	RV_pair2155	FakeDesc2155	FakeAnc2155	SIMULPF00001	452	461	496	417	44	35
7156	RV_pair2156	FakeDesc2156	FakeAnc2156	SIMULPF00001	304	298	326	276	22	28
7157	RV_pair2157	FakeDesc2157	FakeAnc2157	SIMULPF00001	67	73	77	63	10	4
7158	RV_pair2158	FakeDesc2158	FakeAnc2158	SIMULPF00001	233	223	262	194	29	39
7159	RV_pair2159	FakeDesc2159	FakeAnc2159	SIMULPF00001	134	132	144	122	10	12
7160	RV_pair2160	FakeDesc2160	FakeAnc2160	SIMULPF00001	90	91	97	84	7	6
7161	RV_pair2161	FakeDesc2161	FakeAnc2161	SIMULPF00001	567	554	605	516	38	51
7162	RV_pair2162	FakeDesc2162	FakeAnc2162	SIMULPF00001	106	108	116	98	10	8
7163	RV_pair2163	FakeDesc2163	FakeAnc2163	SIMULPF00001	53	49	54	48	1	5
7164	RV_pair2164	FakeDesc2164	FakeAnc2164	SIMULPF00001	232	227	254	205	22	27
7165	RV_pair2165	FakeDesc2165	FakeAnc2165	SIMULPF00001	339	340	374	305	35	34
7166	RV_pair2166	FakeDesc2166	FakeAnc2166	SIMULPF00001	59	62	65	56	6	3
7167	RV_pair2167	FakeDesc2167	FakeAnc2167	SIMULPF00001	8	8	9	7	1	1
7168	RV_pair2168	FakeDesc2168	FakeAnc2168	SIMULPF00001	409	385	441	353	32	56
7169	RV_pair2169	FakeDesc2169	FakeAnc2169	SIMULPF00001	62	62	67	57	5	5
7170	RV_pair2170	FakeDesc2170	FakeAnc2170	SIMULPF00001	569	575	617	527	48	42
7171	RV_pair2171	FakeDesc2171	FakeAnc2171	SIMULPF00001	39	41	46	34	7	5
7172	RV_pair2172	FakeDesc2172	FakeAnc2172	SIMULPF00001	7	9	10	6	3	1
7173	RV_pair2173	FakeDesc2173	FakeAnc2173	SIMULPF00001	160	146	170	136	10	24
7174	RV_pair2174	FakeDesc2174	FakeAnc2174	SIMULPF00001	160	168	182	146	22	14
7175	RV_pair2175	FakeDesc2175	FakeAnc2175	SIMULPF00001	15	14	15	14	0	1
7176	RV_pair2176	FakeDesc2176	FakeAnc2176	SIMULPF00001	234	229	255	208	21	26
7177	RV_pair2177	FakeDesc2177	FakeAnc2177	SIMULPF00001	190	188	206	172	16	18
7178	RV_pair2178	FakeDesc2178	FakeAnc2178	SIMULPF00001	205	220	233	192	28	13
7179	RV_pair2179	FakeDesc2179	FakeAnc2179	SIMULPF00001	132	138	148	122	16	10
7180	RV_pair2180	FakeDesc2180	FakeAnc2180	SIMULPF00001	10	9	11	8	1	2
7181	RV_pair2181	FakeDesc2181	FakeAnc2181	SIMULPF00001	74	74	80	68	6	6
7182	RV_pair2182	FakeDesc2182	FakeAnc2182	SIMULPF00001	274	275	299	250	25	24
7183	RV_pair2183	FakeDesc2183	FakeAnc2183	SIMULPF00001	590	588	634	544	44	46
7184	RV_pair2184	FakeDesc2184	FakeAnc2184	SIMULPF00001	117	111	124	104	7	13
7185	RV_pair2185	FakeDesc2185	FakeAnc2185	SIMULPF00001	135	137	154	118	19	17
7186	RV_pair2186	FakeDesc2186	FakeAnc2186	SIMULPF00001	11	12	12	11	1	0
7187	RV_pair2187	FakeDesc2187	FakeAnc2187	SIMULPF00001	534	526	583	477	49	57
7188	RV_pair2188	FakeDesc2188	FakeAnc2188	SIMULPF00001	290	292	317	265	27	25
7189	RV_pair2189	FakeDesc2189	FakeAnc2189	SIMULPF00001	89	90	101	78	12	11
7190	RV_pair2190	FakeDesc2190	FakeAnc2190	SIMULPF00001	45	42	49	38	4	7
7191	RV_pair2191	FakeDesc2191	FakeAnc2191	SIMULPF00001	87	81	96	72	9	15
7192	RV_pair2192	FakeDesc2192	FakeAnc2192	SIMULPF00001	379	376	405	350	26	29
7193	RV_pair2193	FakeDesc2193	FakeAnc2193	SIMULPF00001	265	259	283	241	18	24
7194	RV_pair2194	FakeDesc2194	FakeAnc2194	SIMULPF00001	419	433	476	376	57	43
7195	RV_pair2195	FakeDesc2195	FakeAnc2195	SIMULPF00001	115	109	125	99	10	16
7196	RV_pair2196	FakeDesc2196	FakeAnc2196	SIMULPF00001	194	194	218	170	24	24
7197	RV_pair2197	FakeDesc2197	FakeAnc2197	SIMULPF00001	112	118	122	108	10	4
7198	RV_pair2198	FakeDesc2198	FakeAnc2198	SIMULPF00001	290	265	300	255	10	35
7199	RV_pair2199	FakeDesc2199	FakeAnc2199	SIMULPF00001	2	2	2	2	0	0
7200	RV_pair2200	FakeDesc2200	FakeAnc2200	SIMULPF00001	223	218	235	206	12	17
7201	RV_pair2201	FakeDesc2201	FakeAnc2201	SIMULPF00001	229	220	244	205	15	24
7202	RV_pair2202	FakeDesc2202	FakeAnc2202	SIMULPF00001	86	86	93	79	7	7
7203	RV_pair2203	FakeDesc2203	FakeAnc2203	SIMULPF00001	81	77	90	68	9	13
7204	RV_pair2204	FakeDesc2204	FakeAnc2204	SIMULPF00001	277	278	304	251	27	26
7205	RV_pair2205	FakeDesc2205	FakeAnc2205	SIMULPF00001	31	33	36	28	5	3
7206	RV_pair2206	FakeDesc2206	FakeAnc2206	SIMULPF00001	76	78	85	69	9	7
7207	RV_pair2207	FakeDesc2207	FakeAnc2207	SIMULPF00001	259	247	281	225	22	34
7208	RV_pair2208	FakeDesc2208	FakeAnc2208	SIMULPF00001	31	30	32	29	1	2
7209	RV_pair2209	FakeDesc2209	FakeAnc2209	SIMULPF00001	243	240	267	216	24	27
7210	RV_pair2210	FakeDesc2210	FakeAnc2210	SIMULPF00001	288	280	309	259	21	29
7211	RV_pair2211	FakeDesc2211	FakeAnc2211	SIMULPF00001	391	386	424	353	33	38
7212	RV_pair2212	FakeDesc2212	FakeAnc2212	SIMULPF00001	425	433	472	386	47	39
7213	RV_pair2213	FakeDesc2213	FakeAnc2213	SIMULPF00001	599	597	658	538	59	61
7214	RV_pair2214	FakeDesc2214	FakeAnc2214	SIMULPF00001	52	50	56	46	4	6
7215	RV_pair2215	FakeDesc2215	FakeAnc2215	SIMULPF00001	77	85	90	72	13	5
7216	RV_pair2216	FakeDesc2216	FakeAnc2216	SIMULPF00001	270	273	294	249	24	21
7217	RV_pair2217	FakeDesc2217	FakeAnc2217	SIMULPF00001	147	156	169	134	22	13
7218	RV_pair2218	FakeDesc2218	FakeAnc2218	SIMULPF00001	446	426	471	401	25	45
7219	RV_pair2219	FakeDesc2219	FakeAnc2219	SIMULPF00001	801	819	884	736	83	65
7220	RV_pair2220	FakeDesc2220	FakeAnc2220	SIMULPF00001	255	251	280	226	25	29
7221	RV_pair2221	FakeDesc2221	FakeAnc2221	SIMULPF00001	114	113	120	107	6	7
7222	RV_pair2222	FakeDesc2222	FakeAnc2222	SIMULPF00001	86	94	97	83	11	3
7223	RV_pair2223	FakeDesc2223	FakeAnc2223	SIMULPF00001	348	341	378	311	30	37
7224	RV_pair2224	FakeDesc2224	FakeAnc2224	SIMULPF00001	364	365	400	329	36	35
7225	RV_pair2225	FakeDesc2225	FakeAnc2225	SIMULPF00001	58	59	64	53	6	5
7226	RV_pair2226	FakeDesc2226	FakeAnc2226	SIMULPF00001	10	10	10	10	0	0
7227	RV_pair2227	FakeDesc2227	FakeAnc2227	SIMULPF00001	258	255	278	235	20	23
7228	RV_pair2228	FakeDesc2228	FakeAnc2228	SIMULPF00001	3	2	3	2	0	1
7229	RV_pair2229	FakeDesc2229	FakeAnc2229	SIMULPF00001	111	123	132	102	21	9
7230	RV_pair2230	FakeDesc2230	FakeAnc2230	SIMULPF00001	414	426	458	382	44	32
7231	RV_pair2231	FakeDesc2231	FakeAnc2231	SIMULPF00001	110	111	125	96	15	14
7232	RV_pair2232	FakeDesc2232	FakeAnc2232	SIMULPF00001	21	22	23	20	2	1
7233	RV_pair2233	FakeDesc2233	FakeAnc2233	SIMULPF00001	131	123	141	113	10	18
7234	RV_pair2234	FakeDesc2234	FakeAnc2234	SIMULPF00001	81	85	87	79	6	2
7235	RV_pair2235	FakeDesc2235	FakeAnc2235	SIMULPF00001	407	395	436	366	29	41
7236	RV_pair2236	FakeDesc2236	FakeAnc2236	SIMULPF00001	249	255	273	231	24	18
7237	RV_pair2237	FakeDesc2237	FakeAnc2237	SIMULPF00001	13	16	16	13	3	0
7238	RV_pair2238	FakeDesc2238	FakeAnc2238	SIMULPF00001	63	67	73	57	10	6
7239	RV_pair2239	FakeDesc2239	FakeAnc2239	SIMULPF00001	123	132	148	107	25	16
7240	RV_pair2240	FakeDesc2240	FakeAnc2240	SIMULPF00001	119	120	132	107	13	12
7241	RV_pair2241	FakeDesc2241	FakeAnc2241	SIMULPF00001	152	147	164	135	12	17
7242	RV_pair2242	FakeDesc2242	FakeAnc2242	SIMULPF00001	143	141	154	130	11	13
7243	RV_pair2243	FakeDesc2243	FakeAnc2243	SIMULPF00001	33	32	37	28	4	5
7244	RV_pair2244	FakeDesc2244	FakeAnc2244	SIMULPF00001	251	253	279	225	28	26
7245	RV_pair2245	FakeDesc2245	FakeAnc2245	SIMULPF00001	305	303	330	278	25	27
7246	RV_pair2246	FakeDesc2246	FakeAnc2246	SIMULPF00001	15	15	15	15	0	0
7247	RV_pair2247	FakeDesc2247	FakeAnc2247	SIMULPF00001	316	322	346	292	30	24
7248	RV_pair2248	FakeDesc2248	FakeAnc2248	SIMULPF00001	11	11	12	10	1	1
7249	RV_pair2249	FakeDesc2249	FakeAnc2249	SIMULPF00001	724	712	785	651	61	73
7250	RV_pair2250	FakeDesc2250	FakeAnc2250	SIMULPF00001	57	56	63	50	6	7
7251	RV_pair2251	FakeDesc2251	FakeAnc2251	SIMULPF00001	104	106	115	95	11	9
7252	RV_pair2252	FakeDesc2252	FakeAnc2252	SIMULPF00001	53	55	60	48	7	5
7253	RV_pair2253	FakeDesc2253	FakeAnc2253	SIMULPF00001	355	361	391	325	36	30
7254	RV_pair2254	FakeDesc2254	FakeAnc2254	SIMULPF00001	192	183	204	171	12	21
7255	RV_pair2255	FakeDesc2255	FakeAnc2255	SIMULPF00001	3	3	3	3	0	0
7256	RV_pair2256	FakeDesc2256	FakeAnc2256	SIMULPF00001	8	9	9	8	1	0
7257	RV_pair2257	FakeDesc2257	FakeAnc2257	SIMULPF00001	247	239	265	221	18	26
7258	RV_pair2258	FakeDesc2258	FakeAnc2258	SIMULPF00001	274	271	295	250	21	24
7259	RV_pair2259	FakeDesc2259	FakeAnc2259	SIMULPF00001	64	62	65	61	1	3
7260	RV_pair2260	FakeDesc2260	FakeAnc2260	SIMULPF00001	34	34	41	27	7	7
7261	RV_pair2261	FakeDesc2261	FakeAnc2261	SIMULPF00001	140	154	159	135	19	5
7262	RV_pair2262	FakeDesc2262	FakeAnc2262	SIMULPF00001	284	293	321	256	37	28
7263	RV_pair2263	FakeDesc2263	FakeAnc2263	SIMULPF00001	233	241	257	217	24	16
7264	RV_pair2264	FakeDesc2264	FakeAnc2264	SIMULPF00001	322	301	339	284	17	38
7265	RV_pair2265	FakeDesc2265	FakeAnc2265	SIMULPF00001	136	128	145	119	9	17
7266	RV_pair2266	FakeDesc2266	FakeAnc2266	SIMULPF00001	344	351	385	310	41	34
7267	RV_pair2267	FakeDesc2267	FakeAnc2267	SIMULPF00001	8	10	10	8	2	0
7268	RV_pair2268	FakeDesc2268	FakeAnc2268	SIMULPF00001	177	199	208	168	31	9
7269	RV_pair2269	FakeDesc2269	FakeAnc2269	SIMULPF00001	314	312	346	280	32	34
7270	RV_pair2270	FakeDesc2270	FakeAnc2270	SIMULPF00001	37	43	44	36	7	1
7271	RV_pair2271	FakeDesc2271	FakeAnc2271	SIMULPF00001	759	755	817	697	58	62
7272	RV_pair2272	FakeDesc2272	FakeAnc2272	SIMULPF00001	488	492	544	436	56	52
7273	RV_pair2273	FakeDesc2273	FakeAnc2273	SIMULPF00001	209	204	226	187	17	22
7274	RV_pair2274	FakeDesc2274	FakeAnc2274	SIMULPF00001	287	290	318	259	31	28
7275	RV_pair2275	FakeDesc2275	FakeAnc2275	SIMULPF00001	138	145	153	130	15	8
7276	RV_pair2276	FakeDesc2276	FakeAnc2276	SIMULPF00001	506	496	554	448	48	58
7277	RV_pair2277	FakeDesc2277	FakeAnc2277	SIMULPF00001	10	8	10	8	0	2
7278	RV_pair2278	FakeDesc2278	FakeAnc2278	SIMULPF00001	363	366	402	327	39	36
7279	RV_pair2279	FakeDesc2279	FakeAnc2279	SIMULPF00001	100	94	105	89	5	11
7280	RV_pair2280	FakeDesc2280	FakeAnc2280	SIMULPF00001	507	508	555	460	48	47
7281	RV_pair2281	FakeDesc2281	FakeAnc2281	SIMULPF00001	208	209	230	187	22	21
7282	RV_pair2282	FakeDesc2282	FakeAnc2282	SIMULPF00001	90	82	95	77	5	13
7283	RV_pair2283	FakeDesc2283	FakeAnc2283	SIMULPF00001	135	122	139	118	4	17
7284	RV_pair2284	FakeDesc2284	FakeAnc2284	SIMULPF00001	700	683	750	633	50	67
7285	RV_pair2285	FakeDesc2285	FakeAnc2285	SIMULPF00001	203	209	228	184	25	19
7286	RV_pair2286	FakeDesc2286	FakeAnc2286	SIMULPF00001	181	182	195	168	14	13
7287	RV_pair2287	FakeDesc2287	FakeAnc2287	SIMULPF00001	161	146	165	142	4	19
7288	RV_pair2288	FakeDesc2288	FakeAnc2288	SIMULPF00001	83	81	89	75	6	8
7289	RV_pair2289	FakeDesc2289	FakeAnc2289	SIMULPF00001	40	42	44	38	4	2
7290	RV_pair2290	FakeDesc2290	FakeAnc2290	SIMULPF00001	448	457	493	412	45	36
7291	RV_pair2291	FakeDesc2291	FakeAnc2291	SIMULPF00001	190	195	209	176	19	14
7292	RV_pair2292	FakeDesc2292	FakeAnc2292	SIMULPF00001	93	93	98	88	5	5
7293	RV_pair2293	FakeDesc2293	FakeAnc2293	SIMULPF00001	23	20	23	20	0	3
7294	RV_pair2294	FakeDesc2294	FakeAnc2294	SIMULPF00001	128	131	147	112	19	16
7295	RV_pair2295	FakeDesc2295	FakeAnc2295	SIMULPF00001	172	172	190	154	18	18
7296	RV_pair2296	FakeDesc2296	FakeAnc2296	SIMULPF00001	35	35	37	33	2	2
7297	RV_pair2297	FakeDesc2297	FakeAnc2297	SIMULPF00001	102	106	114	94	12	8
7298	RV_pair2298	FakeDesc2298	FakeAnc2298	SIMULPF00001	15	14	20	9	5	6
7299	RV_pair2299	FakeDesc2299	FakeAnc2299	SIMULPF00001	7	7	7	7	0	0
7300	RV_pair2300	FakeDesc2300	FakeAnc2300	SIMULPF00001	185	190	200	175	15	10
7301	RV_pair2301	FakeDesc2301	FakeAnc2301	SIMULPF00001	54	50	54	50	0	4
7302	RV_pair2302	FakeDesc2302	FakeAnc2302	SIMULPF00001	64	68	75	57	11	7
7303	RV_pair2303	FakeDesc2303	FakeAnc2303	SIMULPF00001	88	91	97	82	9	6
7304	RV_pair2304	FakeDesc2304	FakeAnc2304	SIMULPF00001	196	193	220	169	24	27
7305	RV_pair2305	FakeDesc2305	FakeAnc2305	SIMULPF00001	545	537	595	487	50	58
7306	RV_pair2306	FakeDesc2306	FakeAnc2306	SIMULPF00001	107	90	114	83	7	24
7307	RV_pair2307	FakeDesc2307	FakeAnc2307	SIMULPF00001	272	275	298	249	26	23
7308	RV_pair2308	FakeDesc2308	FakeAnc2308	SIMULPF00001	421	425	469	377	48	44
7309	RV_pair2309	FakeDesc2309	FakeAnc2309	SIMULPF00001	30	30	32	28	2	2
7310	RV_pair2310	FakeDesc2310	FakeAnc2310	SIMULPF00001	593	579	636	536	43	57
7311	RV_pair2311	FakeDesc2311	FakeAnc2311	SIMULPF00001	53	43	54	42	1	11
7312	RV_pair2312	FakeDesc2312	FakeAnc2312	SIMULPF00001	480	480	530	430	50	50
7313	RV_pair2313	FakeDesc2313	FakeAnc2313	SIMULPF00001	30	29	33	26	3	4
7314	RV_pair2314	FakeDesc2314	FakeAnc2314	SIMULPF00001	169	167	181	155	12	14
7315	RV_pair2315	FakeDesc2315	FakeAnc2315	SIMULPF00001	318	306	350	274	32	44
7316	RV_pair2316	FakeDesc2316	FakeAnc2316	SIMULPF00001	8	9	9	8	1	0
7317	RV_pair2317	FakeDesc2317	FakeAnc2317	SIMULPF00001	84	82	93	73	9	11
7318	RV_pair2318	FakeDesc2318	FakeAnc2318	SIMULPF00001	42	42	44	40	2	2
7319	RV_pair2319	FakeDesc2319	FakeAnc2319	SIMULPF00001	160	160	174	146	14	14
7320	RV_pair2320	FakeDesc2320	FakeAnc2320	SIMULPF00001	88	89	93	84	5	4
7321	RV_pair2321	FakeDesc2321	FakeAnc2321	SIMULPF00001	241	241	266	216	25	25
7322	RV_pair2322	FakeDesc2322	FakeAnc2322	SIMULPF00001	11	10	12	9	1	2
7323	RV_pair2323	FakeDesc2323	FakeAnc2323	SIMULPF00001	340	348	382	306	42	34
7324	RV_pair2324	FakeDesc2324	FakeAnc2324	SIMULPF00001	19	20	22	17	3	2
7325	RV_pair2325	FakeDesc2325	FakeAnc2325	SIMULPF00001	360	353	387	326	27	34
7326	RV_pair2326	FakeDesc2326	FakeAnc2326	SIMULPF00001	621	617	693	545	72	76
7327	RV_pair2327	FakeDesc2327	FakeAnc2327	SIMULPF00001	397	387	431	353	34	44
7328	RV_pair2328	FakeDesc2328	FakeAnc2328	SIMULPF00001	304	298	329	273	25	31
7329	RV_pair2329	FakeDesc2329	FakeAnc2329	SIMULPF00001	687	679	747	619	60	68
7330	RV_pair2330	FakeDesc2330	FakeAnc2330	SIMULPF00001	105	98	114	89	9	16
7331	RV_pair2331	FakeDesc2331	FakeAnc2331	SIMULPF00001	186	190	202	174	16	12
7332	RV_pair2332	FakeDesc2332	FakeAnc2332	SIMULPF00001	266	261	288	239	22	27
7333	RV_pair2333	FakeDesc2333	FakeAnc2333	SIMULPF00001	126	133	140	119	14	7
7334	RV_pair2334	FakeDesc2334	FakeAnc2334	SIMULPF00001	49	54	57	46	8	3
7335	RV_pair2335	FakeDesc2335	FakeAnc2335	SIMULPF00001	433	434	474	393	41	40
7336	RV_pair2336	FakeDesc2336	FakeAnc2336	SIMULPF00001	238	237	253	222	15	16
7337	RV_pair2337	FakeDesc2337	FakeAnc2337	SIMULPF00001	207	220	241	186	34	21
7338	RV_pair2338	FakeDesc2338	FakeAnc2338	SIMULPF00001	89	83	92	80	3	9
7339	RV_pair2339	FakeDesc2339	FakeAnc2339	SIMULPF00001	27	25	27	25	0	2
7340	RV_pair2340	FakeDesc2340	FakeAnc2340	SIMULPF00001	161	168	183	146	22	15
7341	RV_pair2341	FakeDesc2341	FakeAnc2341	SIMULPF00001	261	242	273	230	12	31
7342	RV_pair2342	FakeDesc2342	FakeAnc2342	SIMULPF00001	123	124	137	110	14	13
7343	RV_pair2343	FakeDesc2343	FakeAnc2343	SIMULPF00001	648	654	714	588	66	60
7344	RV_pair2344	FakeDesc2344	FakeAnc2344	SIMULPF00001	123	132	138	117	15	6
7345	RV_pair2345	FakeDesc2345	FakeAnc2345	SIMULPF00001	500	497	538	459	38	41
7346	RV_pair2346	FakeDesc2346	FakeAnc2346	SIMULPF00001	193	197	211	179	18	14
7347	RV_pair2347	FakeDesc2347	FakeAnc2347	SIMULPF00001	102	95	109	88	7	14
7348	RV_pair2348	FakeDesc2348	FakeAnc2348	SIMULPF00001	73	70	78	65	5	8
7349	RV_pair2349	FakeDesc2349	FakeAnc2349	SIMULPF00001	166	175	186	155	20	11
7350	RV_pair2350	FakeDesc2350	FakeAnc2350	SIMULPF00001	161	157	174	144	13	17
7351	RV_pair2351	FakeDesc2351	FakeAnc2351	SIMULPF00001	120	128	139	109	19	11
7352	RV_pair2352	FakeDesc2352	FakeAnc2352	SIMULPF00001	259	238	275	222	16	37
7353	RV_pair2353	FakeDesc2353	FakeAnc2353	SIMULPF00001	696	709	770	635	74	61
7354	RV_pair2354	FakeDesc2354	FakeAnc2354	SIMULPF00001	887	923	999	811	112	76
7355	RV_pair2355	FakeDesc2355	FakeAnc2355	SIMULPF00001	516	517	567	466	51	50
7356	RV_pair2356	FakeDesc2356	FakeAnc2356	SIMULPF00001	66	66	70	62	4	4
7357	RV_pair2357	FakeDesc2357	FakeAnc2357	SIMULPF00001	191	201	210	182	19	9
7358	RV_pair2358	FakeDesc2358	FakeAnc2358	SIMULPF00001	787	785	853	719	66	68
7359	RV_pair2359	FakeDesc2359	FakeAnc2359	SIMULPF00001	42	44	48	38	6	4
7360	RV_pair2360	FakeDesc2360	FakeAnc2360	SIMULPF00001	357	371	389	339	32	18
7361	RV_pair2361	FakeDesc2361	FakeAnc2361	SIMULPF00001	353	351	385	319	32	34
7362	RV_pair2362	FakeDesc2362	FakeAnc2362	SIMULPF00001	245	235	262	218	17	27
7363	RV_pair2363	FakeDesc2363	FakeAnc2363	SIMULPF00001	32	31	32	31	0	1
7364	RV_pair2364	FakeDesc2364	FakeAnc2364	SIMULPF00001	109	104	118	95	9	14
7365	RV_pair2365	FakeDesc2365	FakeAnc2365	SIMULPF00001	494	478	536	436	42	58
7366	RV_pair2366	FakeDesc2366	FakeAnc2366	SIMULPF00001	143	149	161	131	18	12
7367	RV_pair2367	FakeDesc2367	FakeAnc2367	SIMULPF00001	225	230	245	210	20	15
7368	RV_pair2368	FakeDesc2368	FakeAnc2368	SIMULPF00001	92	93	99	86	7	6
7369	RV_pair2369	FakeDesc2369	FakeAnc2369	SIMULPF00001	142	144	154	132	12	10
7370	RV_pair2370	FakeDesc2370	FakeAnc2370	SIMULPF00001	133	130	141	122	8	11
7371	RV_pair2371	FakeDesc2371	FakeAnc2371	SIMULPF00001	204	202	223	183	19	21
7372	RV_pair2372	FakeDesc2372	FakeAnc2372	SIMULPF00001	137	142	152	127	15	10
7373	RV_pair2373	FakeDesc2373	FakeAnc2373	SIMULPF00001	69	66	73	62	4	7
7374	RV_pair2374	FakeDesc2374	FakeAnc2374	SIMULPF00001	304	299	324	279	20	25
7375	RV_pair2375	FakeDesc2375	FakeAnc2375	SIMULPF00001	750	753	815	688	65	62
7376	RV_pair2376	FakeDesc2376	FakeAnc2376	SIMULPF00001	336	341	368	309	32	27
7377	RV_pair2377	FakeDesc2377	FakeAnc2377	SIMULPF00001	572	560	621	511	49	61
7378	RV_pair2378	FakeDesc2378	FakeAnc2378	SIMULPF00001	77	79	88	68	11	9
7379	RV_pair2379	FakeDesc2379	FakeAnc2379	SIMULPF00001	96	98	108	86	12	10
7380	RV_pair2380	FakeDesc2380	FakeAnc2380	SIMULPF00001	115	117	127	105	12	10
7381	RV_pair2381	FakeDesc2381	FakeAnc2381	SIMULPF00001	408	396	443	361	35	47
7382	RV_pair2382	FakeDesc2382	FakeAnc2382	SIMULPF00001	275	278	316	237	41	38
7383	RV_pair2383	FakeDesc2383	FakeAnc2383	SIMULPF00001	66	64	70	60	4	6
7384	RV_pair2384	FakeDesc2384	FakeAnc2384	SIMULPF00001	345	352	385	312	40	33
7385	RV_pair2385	FakeDesc2385	FakeAnc2385	SIMULPF00001	886	864	943	807	57	79
7386	RV_pair2386	FakeDesc2386	FakeAnc2386	SIMULPF00001	170	177	190	157	20	13
7387	RV_pair2387	FakeDesc2387	FakeAnc2387	SIMULPF00001	61	56	64	53	3	8
7388	RV_pair2388	FakeDesc2388	FakeAnc2388	SIMULPF00001	374	380	417	337	43	37
7389	RV_pair2389	FakeDesc2389	FakeAnc2389	SIMULPF00001	323	320	357	286	34	37
7390	RV_pair2390	FakeDesc2390	FakeAnc2390	SIMULPF00001	305	313	330	288	25	17
7391	RV_pair2391	FakeDesc2391	FakeAnc2391	SIMULPF00001	242	244	269	217	27	25
7392	RV_pair2392	FakeDesc2392	FakeAnc2392	SIMULPF00001	50	53	57	46	7	4
7393	RV_pair2393	FakeDesc2393	FakeAnc2393	SIMULPF00001	269	265	281	253	12	16
7394	RV_pair2394	FakeDesc2394	FakeAnc2394	SIMULPF00001	21	24	25	20	4	1
7395	RV_pair2395	FakeDesc2395	FakeAnc2395	SIMULPF00001	758	741	811	688	53	70
7396	RV_pair2396	FakeDesc2396	FakeAnc2396	SIMULPF00001	298	308	336	270	38	28
7397	RV_pair2397	FakeDesc2397	FakeAnc2397	SIMULPF00001	63	66	69	60	6	3
7398	RV_pair2398	FakeDesc2398	FakeAnc2398	SIMULPF00001	201	210	226	185	25	16
7399	RV_pair2399	FakeDesc2399	FakeAnc2399	SIMULPF00001	666	658	725	599	59	67
7400	RV_pair2400	FakeDesc2400	FakeAnc2400	SIMULPF00001	140	135	148	127	8	13
7401	RV_pair2401	FakeDesc2401	FakeAnc2401	SIMULPF00001	635	652	704	583	69	52
7402	RV_pair2402	FakeDesc2402	FakeAnc2402	SIMULPF00001	231	227	258	200	27	31
7403	RV_pair2403	FakeDesc2403	FakeAnc2403	SIMULPF00001	164	165	177	152	13	12
7404	RV_pair2404	FakeDesc2404	FakeAnc2404	SIMULPF00001	179	175	188	166	9	13
7405	RV_pair2405	FakeDesc2405	FakeAnc2405	SIMULPF00001	185	179	199	165	14	20
7406	RV_pair2406	FakeDesc2406	FakeAnc2406	SIMULPF00001	44	42	47	39	3	5
7407	RV_pair2407	FakeDesc2407	FakeAnc2407	SIMULPF00001	89	86	91	84	2	5
7408	RV_pair2408	FakeDesc2408	FakeAnc2408	SIMULPF00001	32	32	34	30	2	2
7409	RV_pair2409	FakeDesc2409	FakeAnc2409	SIMULPF00001	87	93	101	79	14	8
7410	RV_pair2410	FakeDesc2410	FakeAnc2410	SIMULPF00001	526	507	576	457	50	69
7411	RV_pair2411	FakeDesc2411	FakeAnc2411	SIMULPF00001	115	117	129	103	14	12
7412	RV_pair2412	FakeDesc2412	FakeAnc2412	SIMULPF00001	112	109	115	106	3	6
7413	RV_pair2413	FakeDesc2413	FakeAnc2413	SIMULPF00001	81	84	92	73	11	8
7414	RV_pair2414	FakeDesc2414	FakeAnc2414	SIMULPF00001	155	141	158	138	3	17
7415	RV_pair2415	FakeDesc2415	FakeAnc2415	SIMULPF00001	135	133	147	121	12	14
7416	RV_pair2416	FakeDesc2416	FakeAnc2416	SIMULPF00001	185	187	207	165	22	20
7417	RV_pair2417	FakeDesc2417	FakeAnc2417	SIMULPF00001	35	36	37	34	2	1
7418	RV_pair2418	FakeDesc2418	FakeAnc2418	SIMULPF00001	164	169	185	148	21	16
7419	RV_pair2419	FakeDesc2419	FakeAnc2419	SIMULPF00001	310	320	341	289	31	21
7420	RV_pair2420	FakeDesc2420	FakeAnc2420	SIMULPF00001	69	68	75	62	6	7
7421	RV_pair2421	FakeDesc2421	FakeAnc2421	SIMULPF00001	374	371	413	332	39	42
7422	RV_pair2422	FakeDesc2422	FakeAnc2422	SIMULPF00001	26	24	27	23	1	3
7423	RV_pair2423	FakeDesc2423	FakeAnc2423	SIMULPF00001	224	227	246	205	22	19
7424	RV_pair2424	FakeDesc2424	FakeAnc2424	SIMULPF00001	7	8	10	5	3	2
7425	RV_pair2425	FakeDesc2425	FakeAnc2425	SIMULPF00001	3	3	3	3	0	0
7426	RV_pair2426	FakeDesc2426	FakeAnc2426	SIMULPF00001	118	120	131	107	13	11
7427	RV_pair2427	FakeDesc2427	FakeAnc2427	SIMULPF00001	364	358	398	324	34	40
7428	RV_pair2428	FakeDesc2428	FakeAnc2428	SIMULPF00001	224	229	239	214	15	10
7429	RV_pair2429	FakeDesc2429	FakeAnc2429	SIMULPF00001	241	232	259	214	18	27
7430	RV_pair2430	FakeDesc2430	FakeAnc2430	SIMULPF00001	362	375	408	329	46	33
7431	RV_pair2431	FakeDesc2431	FakeAnc2431	SIMULPF00001	191	190	215	166	24	25
7432	RV_pair2432	FakeDesc2432	FakeAnc2432	SIMULPF00001	142	136	151	127	9	15
7433	RV_pair2433	FakeDesc2433	FakeAnc2433	SIMULPF00001	113	112	122	103	9	10
7434	RV_pair2434	FakeDesc2434	FakeAnc2434	SIMULPF00001	555	538	605	488	50	67
7435	RV_pair2435	FakeDesc2435	FakeAnc2435	SIMULPF00001	731	706	790	647	59	84
7436	RV_pair2436	FakeDesc2436	FakeAnc2436	SIMULPF00001	217	215	238	194	21	23
7437	RV_pair2437	FakeDesc2437	FakeAnc2437	SIMULPF00001	245	226	264	207	19	38
7438	RV_pair2438	FakeDesc2438	FakeAnc2438	SIMULPF00001	343	362	387	318	44	25
7439	RV_pair2439	FakeDesc2439	FakeAnc2439	SIMULPF00001	173	177	189	161	16	12
7440	RV_pair2440	FakeDesc2440	FakeAnc2440	SIMULPF00001	53	53	60	46	7	7
7441	RV_pair2441	FakeDesc2441	FakeAnc2441	SIMULPF00001	453	456	497	412	44	41
7442	RV_pair2442	FakeDesc2442	FakeAnc2442	SIMULPF00001	58	58	64	52	6	6
7443	RV_pair2443	FakeDesc2443	FakeAnc2443	SIMULPF00001	279	278	299	258	20	21
7444	RV_pair2444	FakeDesc2444	FakeAnc2444	SIMULPF00001	109	119	130	98	21	11
7445	RV_pair2445	FakeDesc2445	FakeAnc2445	SIMULPF00001	45	42	47	40	2	5
7446	RV_pair2446	FakeDesc2446	FakeAnc2446	SIMULPF00001	245	238	262	221	17	24
7447	RV_pair2447	FakeDesc2447	FakeAnc2447	SIMULPF00001	186	172	193	165	7	21
7448	RV_pair2448	FakeDesc2448	FakeAnc2448	SIMULPF00001	219	211	233	197	14	22
7449	RV_pair2449	FakeDesc2449	FakeAnc2449	SIMULPF00001	914	896	985	825	71	89
7450	RV_pair2450	FakeDesc2450	FakeAnc2450	SIMULPF00001	251	258	279	230	28	21
7451	RV_pair2451	FakeDesc2451	FakeAnc2451	SIMULPF00001	45	44	47	42	2	3
7452	RV_pair2452	FakeDesc2452	FakeAnc2452	SIMULPF00001	273	257	290	240	17	33
7453	RV_pair2453	FakeDesc2453	FakeAnc2453	SIMULPF00001	520	526	569	477	49	43
7454	RV_pair2454	FakeDesc2454	FakeAnc2454	SIMULPF00001	173	176	182	167	9	6
7455	RV_pair2455	FakeDesc2455	FakeAnc2455	SIMULPF00001	182	176	192	166	10	16
7456	RV_pair2456	FakeDesc2456	FakeAnc2456	SIMULPF00001	657	645	713	589	56	68
7457	RV_pair2457	FakeDesc2457	FakeAnc2457	SIMULPF00001	36	36	40	32	4	4
7458	RV_pair2458	FakeDesc2458	FakeAnc2458	SIMULPF00001	344	337	368	313	24	31
7459	RV_pair2459	FakeDesc2459	FakeAnc2459	SIMULPF00001	152	152	168	136	16	16
7460	RV_pair2460	FakeDesc2460	FakeAnc2460	SIMULPF00001	370	372	396	346	26	24
7461	RV_pair2461	FakeDesc2461	FakeAnc2461	SIMULPF00001	497	503	560	440	63	57
7462	RV_pair2462	FakeDesc2462	FakeAnc2462	SIMULPF00001	485	502	539	448	54	37
7463	RV_pair2463	FakeDesc2463	FakeAnc2463	SIMULPF00001	97	97	104	90	7	7
7464	RV_pair2464	FakeDesc2464	FakeAnc2464	SIMULPF00001	187	181	200	168	13	19
7465	RV_pair2465	FakeDesc2465	FakeAnc2465	SIMULPF00001	90	87	93	84	3	6
7466	RV_pair2466	FakeDesc2466	FakeAnc2466	SIMULPF00001	29	28	30	27	1	2
7467	RV_pair2467	FakeDesc2467	FakeAnc2467	SIMULPF00001	326	322	359	289	33	37
7468	RV_pair2468	FakeDesc2468	FakeAnc2468	SIMULPF00001	77	72	79	70	2	7
7469	RV_pair2469	FakeDesc2469	FakeAnc2469	SIMULPF00001	15	15	16	14	1	1
7470	RV_pair2470	FakeDesc2470	FakeAnc2470	SIMULPF00001	262	253	280	235	18	27
7471	RV_pair2471	FakeDesc2471	FakeAnc2471	SIMULPF00001	244	247	266	225	22	19
7472	RV_pair2472	FakeDesc2472	FakeAnc2472	SIMULPF00001	640	639	699	580	59	60
7473	RV_pair2473	FakeDesc2473	FakeAnc2473	SIMULPF00001	85	74	86	73	1	12
7474	RV_pair2474	FakeDesc2474	FakeAnc2474	SIMULPF00001	498	476	536	438	38	60
7475	RV_pair2475	FakeDesc2475	FakeAnc2475	SIMULPF00001	158	154	166	146	8	12
7476	RV_pair2476	FakeDesc2476	FakeAnc2476	SIMULPF00001	182	167	197	152	15	30
7477	RV_pair2477	FakeDesc2477	FakeAnc2477	SIMULPF00001	152	145	163	134	11	18
7478	RV_pair2478	FakeDesc2478	FakeAnc2478	SIMULPF00001	76	78	82	72	6	4
7479	RV_pair2479	FakeDesc2479	FakeAnc2479	SIMULPF00001	250	258	277	231	27	19
7480	RV_pair2480	FakeDesc2480	FakeAnc2480	SIMULPF00001	129	125	142	112	13	17
7481	RV_pair2481	FakeDesc2481	FakeAnc2481	SIMULPF00001	47	52	54	45	7	2
7482	RV_pair2482	FakeDesc2482	FakeAnc2482	SIMULPF00001	112	116	125	103	13	9
7483	RV_pair2483	FakeDesc2483	FakeAnc2483	SIMULPF00001	39	39	41	37	2	2
7484	RV_pair2484	FakeDesc2484	FakeAnc2484	SIMULPF00001	79	71	82	68	3	11
7485	RV_pair2485	FakeDesc2485	FakeAnc2485	SIMULPF00001	270	270	292	248	22	22
7486	RV_pair2486	FakeDesc2486	FakeAnc2486	SIMULPF00001	26	27	27	26	1	0
7487	RV_pair2487	FakeDesc2487	FakeAnc2487	SIMULPF00001	120	121	132	109	12	11
7488	RV_pair2488	FakeDesc2488	FakeAnc2488	SIMULPF00001	286	276	312	250	26	36
7489	RV_pair2489	FakeDesc2489	FakeAnc2489	SIMULPF00001	93	93	99	87	6	6
7490	RV_pair2490	FakeDesc2490	FakeAnc2490	SIMULPF00001	140	144	154	130	14	10
7491	RV_pair2491	FakeDesc2491	FakeAnc2491	SIMULPF00001	194	203	214	183	20	11
7492	RV_pair2492	FakeDesc2492	FakeAnc2492	SIMULPF00001	116	113	123	106	7	10
7493	RV_pair2493	FakeDesc2493	FakeAnc2493	SIMULPF00001	68	76	79	65	11	3
7494	RV_pair2494	FakeDesc2494	FakeAnc2494	SIMULPF00001	648	660	716	592	68	56
7495	RV_pair2495	FakeDesc2495	FakeAnc2495	SIMULPF00001	42	47	49	40	7	2
7496	RV_pair2496	FakeDesc2496	FakeAnc2496	SIMULPF00001	218	217	234	201	16	17
7497	RV_pair2497	FakeDesc2497	FakeAnc2497	SIMULPF00001	20	24	24	20	4	0
7498	RV_pair2498	FakeDesc2498	FakeAnc2498	SIMULPF00001	300	310	332	278	32	22
7499	RV_pair2499	FakeDesc2499	FakeAnc2499	SIMULPF00001	108	117	123	102	15	6
7500	RV_pair2500	FakeDesc2500	FakeAnc2500	SIMULPF00001	250	252	282	220	32	30
7501	RV_pair2501	FakeDesc2501	FakeAnc2501	SIMULPF00001	874	862	955	781	81	93
7502	RV_pair2502	FakeDesc2502	FakeAnc2502	SIMULPF00001	6	6	6	6	0	0
7503	RV_pair2503	FakeDesc2503	FakeAnc2503	SIMULPF00001	88	88	97	79	9	9
7504	RV_pair2504	FakeDesc2504	FakeAnc2504	SIMULPF00001	726	727	791	662	65	64
7505	RV_pair2505	FakeDesc2505	FakeAnc2505	SIMULPF00001	321	328	356	293	35	28
7506	RV_pair2506	FakeDesc2506	FakeAnc2506	SIMULPF00001	89	88	98	79	9	10
7507	RV_pair2507	FakeDesc2507	FakeAnc2507	SIMULPF00001	95	105	113	87	18	8
7508	RV_pair2508	FakeDesc2508	FakeAnc2508	SIMULPF00001	302	293	327	268	25	34
7509	RV_pair2509	FakeDesc2509	FakeAnc2509	SIMULPF00001	157	157	170	144	13	13
7510	RV_pair2510	FakeDesc2510	FakeAnc2510	SIMULPF00001	118	114	125	107	7	11
7511	RV_pair2511	FakeDesc2511	FakeAnc2511	SIMULPF00001	769	767	842	694	73	75
7512	RV_pair2512	FakeDesc2512	FakeAnc2512	SIMULPF00001	51	50	57	44	6	7
7513	RV_pair2513	FakeDesc2513	FakeAnc2513	SIMULPF00001	454	446	495	405	41	49
7514	RV_pair2514	FakeDesc2514	FakeAnc2514	SIMULPF00001	15	16	16	15	1	0
7515	RV_pair2515	FakeDesc2515	FakeAnc2515	SIMULPF00001	126	132	138	120	12	6
7516	RV_pair2516	FakeDesc2516	FakeAnc2516	SIMULPF00001	77	79	82	74	5	3
7517	RV_pair2517	FakeDesc2517	FakeAnc2517	SIMULPF00001	234	242	268	208	34	26
7518	RV_pair2518	FakeDesc2518	FakeAnc2518	SIMULPF00001	763	793	842	714	79	49
7519	RV_pair2519	FakeDesc2519	FakeAnc2519	SIMULPF00001	22	22	24	20	2	2
7520	RV_pair2520	FakeDesc2520	FakeAnc2520	SIMULPF00001	24	28	30	22	6	2
7521	RV_pair2521	FakeDesc2521	FakeAnc2521	SIMULPF00001	203	207	225	185	22	18
7522	RV_pair2522	FakeDesc2522	FakeAnc2522	SIMULPF00001	24	25	26	23	2	1
7523	RV_pair2523	FakeDesc2523	FakeAnc2523	SIMULPF00001	247	246	264	229	17	18
7524	RV_pair2524	FakeDesc2524	FakeAnc2524	SIMULPF00001	1	1	1	1	0	0
7525	RV_pair2525	FakeDesc2525	FakeAnc2525	SIMULPF00001	80	82	86	76	6	4
7526	RV_pair2526	FakeDesc2526	FakeAnc2526	SIMULPF00001	286	301	325	262	39	24
7527	RV_pair2527	FakeDesc2527	FakeAnc2527	SIMULPF00001	485	477	529	433	44	52
7528	RV_pair2528	FakeDesc2528	FakeAnc2528	SIMULPF00001	57	56	60	53	3	4
7529	RV_pair2529	FakeDesc2529	FakeAnc2529	SIMULPF00001	68	66	74	60	6	8
7530	RV_pair2530	FakeDesc2530	FakeAnc2530	SIMULPF00001	42	43	46	39	4	3
7531	RV_pair2531	FakeDesc2531	FakeAnc2531	SIMULPF00001	82	79	86	75	4	7
7532	RV_pair2532	FakeDesc2532	FakeAnc2532	SIMULPF00001	161	145	170	136	9	25
7533	RV_pair2533	FakeDesc2533	FakeAnc2533	SIMULPF00001	7	6	7	6	0	1
7534	RV_pair2534	FakeDesc2534	FakeAnc2534	SIMULPF00001	617	596	668	545	51	72
7535	RV_pair2535	FakeDesc2535	FakeAnc2535	SIMULPF00001	353	338	377	314	24	39
7536	RV_pair2536	FakeDesc2536	FakeAnc2536	SIMULPF00001	57	60	67	50	10	7
7537	RV_pair2537	FakeDesc2537	FakeAnc2537	SIMULPF00001	429	426	456	399	27	30
7538	RV_pair2538	FakeDesc2538	FakeAnc2538	SIMULPF00001	193	200	215	178	22	15
7539	RV_pair2539	FakeDesc2539	FakeAnc2539	SIMULPF00001	158	159	170	147	12	11
7540	RV_pair2540	FakeDesc2540	FakeAnc2540	SIMULPF00001	512	498	551	459	39	53
7541	RV_pair2541	FakeDesc2541	FakeAnc2541	SIMULPF00001	71	69	76	64	5	7
7542	RV_pair2542	FakeDesc2542	FakeAnc2542	SIMULPF00001	199	189	212	176	13	23
7543	RV_pair2543	FakeDesc2543	FakeAnc2543	SIMULPF00001	94	97	107	84	13	10
7544	RV_pair2544	FakeDesc2544	FakeAnc2544	SIMULPF00001	692	676	748	620	56	72
7545	RV_pair2545	FakeDesc2545	FakeAnc2545	SIMULPF00001	54	58	59	53	5	1
7546	RV_pair2546	FakeDesc2546	FakeAnc2546	SIMULPF00001	389	386	426	349	37	40
7547	RV_pair2547	FakeDesc2547	FakeAnc2547	SIMULPF00001	542	539	590	491	48	51
7548	RV_pair2548	FakeDesc2548	FakeAnc2548	SIMULPF00001	726	724	787	663	61	63
7549	RV_pair2549	FakeDesc2549	FakeAnc2549	SIMULPF00001	208	200	219	189	11	19
7550	RV_pair2550	FakeDesc2550	FakeAnc2550	SIMULPF00001	251	254	278	227	27	24
7551	RV_pair2551	FakeDesc2551	FakeAnc2551	SIMULPF00001	230	228	247	211	17	19
7552	RV_pair2552	FakeDesc2552	FakeAnc2552	SIMULPF00001	151	151	165	137	14	14
7553	RV_pair2553	FakeDesc2553	FakeAnc2553	SIMULPF00001	251	249	271	229	20	22
7554	RV_pair2554	FakeDesc2554	FakeAnc2554	SIMULPF00001	7	7	7	7	0	0
7555	RV_pair2555	FakeDesc2555	FakeAnc2555	SIMULPF00001	251	254	278	227	27	24
7556	RV_pair2556	FakeDesc2556	FakeAnc2556	SIMULPF00001	390	380	423	347	33	43
7557	RV_pair2557	FakeDesc2557	FakeAnc2557	SIMULPF00001	699	682	754	627	55	72
7558	RV_pair2558	FakeDesc2558	FakeAnc2558	SIMULPF00001	638	637	693	582	55	56
7559	RV_pair2559	FakeDesc2559	FakeAnc2559	SIMULPF00001	378	398	439	337	61	41
7560	RV_pair2560	FakeDesc2560	FakeAnc2560	SIMULPF00001	127	136	144	119	17	8
7561	RV_pair2561	FakeDesc2561	FakeAnc2561	SIMULPF00001	222	222	247	197	25	25
7562	RV_pair2562	FakeDesc2562	FakeAnc2562	SIMULPF00001	339	343	372	310	33	29
7563	RV_pair2563	FakeDesc2563	FakeAnc2563	SIMULPF00001	570	567	613	524	43	46
7564	RV_pair2564	FakeDesc2564	FakeAnc2564	SIMULPF00001	704	707	780	631	76	73
7565	RV_pair2565	FakeDesc2565	FakeAnc2565	SIMULPF00001	168	164	183	149	15	19
7566	RV_pair2566	FakeDesc2566	FakeAnc2566	SIMULPF00001	619	641	684	576	65	43
7567	RV_pair2567	FakeDesc2567	FakeAnc2567	SIMULPF00001	55	54	58	51	3	4
7568	RV_pair2568	FakeDesc2568	FakeAnc2568	SIMULPF00001	460	448	499	409	39	51
7569	RV_pair2569	FakeDesc2569	FakeAnc2569	SIMULPF00001	168	177	180	165	12	3
7570	RV_pair2570	FakeDesc2570	FakeAnc2570	SIMULPF00001	54	54	58	50	4	4
7571	RV_pair2571	FakeDesc2571	FakeAnc2571	SIMULPF00001	72	69	78	63	6	9
7572	RV_pair2572	FakeDesc2572	FakeAnc2572	SIMULPF00001	75	77	81	71	6	4
7573	RV_pair2573	FakeDesc2573	FakeAnc2573	SIMULPF00001	246	254	272	228	26	18
7574	RV_pair2574	FakeDesc2574	FakeAnc2574	SIMULPF00001	88	85	92	81	4	7
7575	RV_pair2575	FakeDesc2575	FakeAnc2575	SIMULPF00001	162	162	181	143	19	19
7576	RV_pair2576	FakeDesc2576	FakeAnc2576	SIMULPF00001	199	196	219	176	20	23
7577	RV_pair2577	FakeDesc2577	FakeAnc2577	SIMULPF00001	163	165	178	150	15	13
7578	RV_pair2578	FakeDesc2578	FakeAnc2578	SIMULPF00001	150	142	159	133	9	17
7579	RV_pair2579	FakeDesc2579	FakeAnc2579	SIMULPF00001	380	384	415	349	35	31
7580	RV_pair2580	FakeDesc2580	FakeAnc2580	SIMULPF00001	259	239	272	226	13	33
7581	RV_pair2581	FakeDesc2581	FakeAnc2581	SIMULPF00001	145	149	163	131	18	14
7582	RV_pair2582	FakeDesc2582	FakeAnc2582	SIMULPF00001	236	248	273	211	37	25
7583	RV_pair2583	FakeDesc2583	FakeAnc2583	SIMULPF00001	905	894	984	815	79	90
7584	RV_pair2584	FakeDesc2584	FakeAnc2584	SIMULPF00001	191	183	198	176	7	15
7585	RV_pair2585	FakeDesc2585	FakeAnc2585	SIMULPF00001	176	181	192	165	16	11
7586	RV_pair2586	FakeDesc2586	FakeAnc2586	SIMULPF00001	527	514	575	466	48	61
7587	RV_pair2587	FakeDesc2587	FakeAnc2587	SIMULPF00001	275	277	301	251	26	24
7588	RV_pair2588	FakeDesc2588	FakeAnc2588	SIMULPF00001	61	53	64	50	3	11
7589	RV_pair2589	FakeDesc2589	FakeAnc2589	SIMULPF00001	208	207	226	189	18	19
7590	RV_pair2590	FakeDesc2590	FakeAnc2590	SIMULPF00001	47	46	49	44	2	3
7591	RV_pair2591	FakeDesc2591	FakeAnc2591	SIMULPF00001	291	287	318	260	27	31
7592	RV_pair2592	FakeDesc2592	FakeAnc2592	SIMULPF00001	914	917	991	840	77	74
7593	RV_pair2593	FakeDesc2593	FakeAnc2593	SIMULPF00001	15	15	16	14	1	1
7594	RV_pair2594	FakeDesc2594	FakeAnc2594	SIMULPF00001	95	96	103	88	8	7
7595	RV_pair2595	FakeDesc2595	FakeAnc2595	SIMULPF00001	67	65	71	61	4	6
7596	RV_pair2596	FakeDesc2596	FakeAnc2596	SIMULPF00001	251	230	269	212	18	39
7597	RV_pair2597	FakeDesc2597	FakeAnc2597	SIMULPF00001	15	15	15	15	0	0
7598	RV_pair2598	FakeDesc2598	FakeAnc2598	SIMULPF00001	587	578	639	526	52	61
7599	RV_pair2599	FakeDesc2599	FakeAnc2599	SIMULPF00001	19	19	21	17	2	2
7600	RV_pair2600	FakeDesc2600	FakeAnc2600	SIMULPF00001	143	155	162	136	19	7
7601	RV_pair2601	FakeDesc2601	FakeAnc2601	SIMULPF00001	247	263	289	221	42	26
7602	RV_pair2602	FakeDesc2602	FakeAnc2602	SIMULPF00001	101	96	105	92	4	9
7603	RV_pair2603	FakeDesc2603	FakeAnc2603	SIMULPF00001	480	500	550	430	70	50
7604	RV_pair2604	FakeDesc2604	FakeAnc2604	SIMULPF00001	335	333	362	306	27	29
7605	RV_pair2605	FakeDesc2605	FakeAnc2605	SIMULPF00001	134	131	146	119	12	15
7606	RV_pair2606	FakeDesc2606	FakeAnc2606	SIMULPF00001	379	391	417	353	38	26
7607	RV_pair2607	FakeDesc2607	FakeAnc2607	SIMULPF00001	28	30	31	27	3	1
7608	RV_pair2608	FakeDesc2608	FakeAnc2608	SIMULPF00001	59	66	70	55	11	4
7609	RV_pair2609	FakeDesc2609	FakeAnc2609	SIMULPF00001	30	29	31	28	1	2
7610	RV_pair2610	FakeDesc2610	FakeAnc2610	SIMULPF00001	912	877	973	816	61	96
7611	RV_pair2611	FakeDesc2611	FakeAnc2611	SIMULPF00001	87	87	95	79	8	8
7612	RV_pair2612	FakeDesc2612	FakeAnc2612	SIMULPF00001	272	284	304	252	32	20
7613	RV_pair2613	FakeDesc2613	FakeAnc2613	SIMULPF00001	95	92	105	82	10	13
7614	RV_pair2614	FakeDesc2614	FakeAnc2614	SIMULPF00001	447	455	483	419	36	28
7615	RV_pair2615	FakeDesc2615	FakeAnc2615	SIMULPF00001	670	663	742	591	72	79
7616	RV_pair2616	FakeDesc2616	FakeAnc2616	SIMULPF00001	26	27	29	24	3	2
7617	RV_pair2617	FakeDesc2617	FakeAnc2617	SIMULPF00001	136	134	144	126	8	10
7618	RV_pair2618	FakeDesc2618	FakeAnc2618	SIMULPF00001	145	144	155	134	10	11
7619	RV_pair2619	FakeDesc2619	FakeAnc2619	SIMULPF00001	382	402	428	356	46	26
7620	RV_pair2620	FakeDesc2620	FakeAnc2620	SIMULPF00001	467	468	513	422	46	45
7621	RV_pair2621	FakeDesc2621	FakeAnc2621	SIMULPF00001	411	405	454	362	43	49
7622	RV_pair2622	FakeDesc2622	FakeAnc2622	SIMULPF00001	170	167	183	154	13	16
7623	RV_pair2623	FakeDesc2623	FakeAnc2623	SIMULPF00001	42	43	48	37	6	5
7624	RV_pair2624	FakeDesc2624	FakeAnc2624	SIMULPF00001	13	14	14	13	1	0
7625	RV_pair2625	FakeDesc2625	FakeAnc2625	SIMULPF00001	186	181	196	171	10	15
7626	RV_pair2626	FakeDesc2626	FakeAnc2626	SIMULPF00001	192	195	213	174	21	18
7627	RV_pair2627	FakeDesc2627	FakeAnc2627	SIMULPF00001	56	54	59	51	3	5
7628	RV_pair2628	FakeDesc2628	FakeAnc2628	SIMULPF00001	34	33	36	31	2	3
7629	RV_pair2629	FakeDesc2629	FakeAnc2629	SIMULPF00001	96	95	103	88	7	8
7630	RV_pair2630	FakeDesc2630	FakeAnc2630	SIMULPF00001	291	296	322	265	31	26
7631	RV_pair2631	FakeDesc2631	FakeAnc2631	SIMULPF00001	191	184	204	171	13	20
7632	RV_pair2632	FakeDesc2632	FakeAnc2632	SIMULPF00001	427	417	465	379	38	48
7633	RV_pair2633	FakeDesc2633	FakeAnc2633	SIMULPF00001	87	87	95	79	8	8
7634	RV_pair2634	FakeDesc2634	FakeAnc2634	SIMULPF00001	105	113	121	97	16	8
7635	RV_pair2635	FakeDesc2635	FakeAnc2635	SIMULPF00001	66	68	70	64	4	2
7636	RV_pair2636	FakeDesc2636	FakeAnc2636	SIMULPF00001	322	325	358	289	36	33
7637	RV_pair2637	FakeDesc2637	FakeAnc2637	SIMULPF00001	116	116	126	106	10	10
7638	RV_pair2638	FakeDesc2638	FakeAnc2638	SIMULPF00001	273	275	295	253	22	20
7639	RV_pair2639	FakeDesc2639	FakeAnc2639	SIMULPF00001	225	238	250	213	25	12
7640	RV_pair2640	FakeDesc2640	FakeAnc2640	SIMULPF00001	211	211	228	194	17	17
7641	RV_pair2641	FakeDesc2641	FakeAnc2641	SIMULPF00001	17	20	21	16	4	1
7642	RV_pair2642	FakeDesc2642	FakeAnc2642	SIMULPF00001	117	119	133	103	16	14
7643	RV_pair2643	FakeDesc2643	FakeAnc2643	SIMULPF00001	794	790	882	702	88	92
7644	RV_pair2644	FakeDesc2644	FakeAnc2644	SIMULPF00001	189	181	201	169	12	20
7645	RV_pair2645	FakeDesc2645	FakeAnc2645	SIMULPF00001	73	74	79	68	6	5
7646	RV_pair2646	FakeDesc2646	FakeAnc2646	SIMULPF00001	48	49	50	47	2	1
7647	RV_pair2647	FakeDesc2647	FakeAnc2647	SIMULPF00001	32	29	34	27	2	5
7648	RV_pair2648	FakeDesc2648	FakeAnc2648	SIMULPF00001	48	43	50	41	2	7
7649	RV_pair2649	FakeDesc2649	FakeAnc2649	SIMULPF00001	822	817	897	742	75	80
7650	RV_pair2650	FakeDesc2650	FakeAnc2650	SIMULPF00001	354	346	383	317	29	37
7651	RV_pair2651	FakeDesc2651	FakeAnc2651	SIMULPF00001	56	61	64	53	8	3
7652	RV_pair2652	FakeDesc2652	FakeAnc2652	SIMULPF00001	57	55	62	50	5	7
7653	RV_pair2653	FakeDesc2653	FakeAnc2653	SIMULPF00001	121	115	127	109	6	12
7654	RV_pair2654	FakeDesc2654	FakeAnc2654	SIMULPF00001	202	220	237	185	35	17
7655	RV_pair2655	FakeDesc2655	FakeAnc2655	SIMULPF00001	140	135	150	125	10	15
7656	RV_pair2656	FakeDesc2656	FakeAnc2656	SIMULPF00001	27	27	29	25	2	2
7657	RV_pair2657	FakeDesc2657	FakeAnc2657	SIMULPF00001	159	157	172	144	13	15
7658	RV_pair2658	FakeDesc2658	FakeAnc2658	SIMULPF00001	275	270	297	248	22	27
7659	RV_pair2659	FakeDesc2659	FakeAnc2659	SIMULPF00001	294	296	321	269	27	25
7660	RV_pair2660	FakeDesc2660	FakeAnc2660	SIMULPF00001	111	108	121	98	10	13
7661	RV_pair2661	FakeDesc2661	FakeAnc2661	SIMULPF00001	10	10	12	8	2	2
7662	RV_pair2662	FakeDesc2662	FakeAnc2662	SIMULPF00001	166	176	183	159	17	7
7663	RV_pair2663	FakeDesc2663	FakeAnc2663	SIMULPF00001	69	66	77	58	8	11
7664	RV_pair2664	FakeDesc2664	FakeAnc2664	SIMULPF00001	78	83	89	72	11	6
7665	RV_pair2665	FakeDesc2665	FakeAnc2665	SIMULPF00001	345	344	376	313	31	32
7666	RV_pair2666	FakeDesc2666	FakeAnc2666	SIMULPF00001	42	41	48	35	6	7
7667	RV_pair2667	FakeDesc2667	FakeAnc2667	SIMULPF00001	70	67	74	63	4	7
7668	RV_pair2668	FakeDesc2668	FakeAnc2668	SIMULPF00001	322	321	346	297	24	25
7669	RV_pair2669	FakeDesc2669	FakeAnc2669	SIMULPF00001	294	283	310	267	16	27
7670	RV_pair2670	FakeDesc2670	FakeAnc2670	SIMULPF00001	165	164	174	155	9	10
7671	RV_pair2671	FakeDesc2671	FakeAnc2671	SIMULPF00001	813	820	890	743	77	70
7672	RV_pair2672	FakeDesc2672	FakeAnc2672	SIMULPF00001	290	302	323	269	33	21
7673	RV_pair2673	FakeDesc2673	FakeAnc2673	SIMULPF00001	45	46	48	43	3	2
7674	RV_pair2674	FakeDesc2674	FakeAnc2674	SIMULPF00001	48	49	56	41	8	7
7675	RV_pair2675	FakeDesc2675	FakeAnc2675	SIMULPF00001	254	260	284	230	30	24
7676	RV_pair2676	FakeDesc2676	FakeAnc2676	SIMULPF00001	100	99	110	89	10	11
7677	RV_pair2677	FakeDesc2677	FakeAnc2677	SIMULPF00001	51	50	51	50	0	1
7678	RV_pair2678	FakeDesc2678	FakeAnc2678	SIMULPF00001	394	399	436	357	42	37
7679	RV_pair2679	FakeDesc2679	FakeAnc2679	SIMULPF00001	590	600	661	529	71	61
7680	RV_pair2680	FakeDesc2680	FakeAnc2680	SIMULPF00001	154	154	169	139	15	15
7681	RV_pair2681	FakeDesc2681	FakeAnc2681	SIMULPF00001	716	706	778	644	62	72
7682	RV_pair2682	FakeDesc2682	FakeAnc2682	SIMULPF00001	132	124	142	114	10	18
7683	RV_pair2683	FakeDesc2683	FakeAnc2683	SIMULPF00001	115	123	131	107	16	8
7684	RV_pair2684	FakeDesc2684	FakeAnc2684	SIMULPF00001	465	450	502	413	37	52
7685	RV_pair2685	FakeDesc2685	FakeAnc2685	SIMULPF00001	52	51	57	46	5	6
7686	RV_pair2686	FakeDesc2686	FakeAnc2686	SIMULPF00001	115	106	121	100	6	15
7687	RV_pair2687	FakeDesc2687	FakeAnc2687	SIMULPF00001	256	266	280	242	24	14
7688	RV_pair2688	FakeDesc2688	FakeAnc2688	SIMULPF00001	279	283	304	258	25	21
7689	RV_pair2689	FakeDesc2689	FakeAnc2689	SIMULPF00001	329	333	357	305	28	24
7690	RV_pair2690	FakeDesc2690	FakeAnc2690	SIMULPF00001	31	25	36	20	5	11
7691	RV_pair2691	FakeDesc2691	FakeAnc2691	SIMULPF00001	176	173	195	154	19	22
7692	RV_pair2692	FakeDesc2692	FakeAnc2692	SIMULPF00001	163	151	178	136	15	27
7693	RV_pair2693	FakeDesc2693	FakeAnc2693	SIMULPF00001	104	108	116	96	12	8
7694	RV_pair2694	FakeDesc2694	FakeAnc2694	SIMULPF00001	61	61	67	55	6	6
7695	RV_pair2695	FakeDesc2695	FakeAnc2695	SIMULPF00001	230	244	261	213	31	17
7696	RV_pair2696	FakeDesc2696	FakeAnc2696	SIMULPF00001	152	145	171	126	19	26
7697	RV_pair2697	FakeDesc2697	FakeAnc2697	SIMULPF00001	185	178	201	162	16	23
7698	RV_pair2698	FakeDesc2698	FakeAnc2698	SIMULPF00001	44	43	48	39	4	5
7699	RV_pair2699	FakeDesc2699	FakeAnc2699	SIMULPF00001	104	106	111	99	7	5
7700	RV_pair2700	FakeDesc2700	FakeAnc2700	SIMULPF00001	30	29	35	24	5	6
7701	RV_pair2701	FakeDesc2701	FakeAnc2701	SIMULPF00001	416	445	471	390	55	26
7702	RV_pair2702	FakeDesc2702	FakeAnc2702	SIMULPF00001	114	119	128	105	14	9
7703	RV_pair2703	FakeDesc2703	FakeAnc2703	SIMULPF00001	52	59	61	50	9	2
7704	RV_pair2704	FakeDesc2704	FakeAnc2704	SIMULPF00001	601	601	663	539	62	62
7705	RV_pair2705	FakeDesc2705	FakeAnc2705	SIMULPF00001	190	193	209	174	19	16
7706	RV_pair2706	FakeDesc2706	FakeAnc2706	SIMULPF00001	114	116	126	104	12	10
7707	RV_pair2707	FakeDesc2707	FakeAnc2707	SIMULPF00001	192	208	222	178	30	14
7708	RV_pair2708	FakeDesc2708	FakeAnc2708	SIMULPF00001	192	183	201	174	9	18
7709	RV_pair2709	FakeDesc2709	FakeAnc2709	SIMULPF00001	184	193	201	176	17	8
7710	RV_pair2710	FakeDesc2710	FakeAnc2710	SIMULPF00001	45	46	51	40	6	5
7711	RV_pair2711	FakeDesc2711	FakeAnc2711	SIMULPF00001	267	275	292	250	25	17
7712	RV_pair2712	FakeDesc2712	FakeAnc2712	SIMULPF00001	260	258	284	234	24	26
7713	RV_pair2713	FakeDesc2713	FakeAnc2713	SIMULPF00001	38	44	44	38	6	0
7714	RV_pair2714	FakeDesc2714	FakeAnc2714	SIMULPF00001	252	269	291	230	39	22
7715	RV_pair2715	FakeDesc2715	FakeAnc2715	SIMULPF00001	251	250	275	226	24	25
7716	RV_pair2716	FakeDesc2716	FakeAnc2716	SIMULPF00001	33	32	35	30	2	3
7717	RV_pair2717	FakeDesc2717	FakeAnc2717	SIMULPF00001	123	135	139	119	16	4
7718	RV_pair2718	FakeDesc2718	FakeAnc2718	SIMULPF00001	172	165	183	154	11	18
7719	RV_pair2719	FakeDesc2719	FakeAnc2719	SIMULPF00001	18	12	19	11	1	7
7720	RV_pair2720	FakeDesc2720	FakeAnc2720	SIMULPF00001	383	384	423	344	40	39
7721	RV_pair2721	FakeDesc2721	FakeAnc2721	SIMULPF00001	638	610	698	550	60	88
7722	RV_pair2722	FakeDesc2722	FakeAnc2722	SIMULPF00001	127	128	138	117	11	10
7723	RV_pair2723	FakeDesc2723	FakeAnc2723	SIMULPF00001	104	109	120	93	16	11
7724	RV_pair2724	FakeDesc2724	FakeAnc2724	SIMULPF00001	138	139	148	129	10	9
7725	RV_pair2725	FakeDesc2725	FakeAnc2725	SIMULPF00001	125	118	132	111	7	14
7726	RV_pair2726	FakeDesc2726	FakeAnc2726	SIMULPF00001	225	219	245	199	20	26
7727	RV_pair2727	FakeDesc2727	FakeAnc2727	SIMULPF00001	270	253	288	235	18	35
7728	RV_pair2728	FakeDesc2728	FakeAnc2728	SIMULPF00001	224	220	243	201	19	23
7729	RV_pair2729	FakeDesc2729	FakeAnc2729	SIMULPF00001	87	80	89	78	2	9
7730	RV_pair2730	FakeDesc2730	FakeAnc2730	SIMULPF00001	228	221	244	205	16	23
7731	RV_pair2731	FakeDesc2731	FakeAnc2731	SIMULPF00001	430	443	473	400	43	30
7732	RV_pair2732	FakeDesc2732	FakeAnc2732	SIMULPF00001	486	491	527	450	41	36
7733	RV_pair2733	FakeDesc2733	FakeAnc2733	SIMULPF00001	29	26	33	22	4	7
7734	RV_pair2734	FakeDesc2734	FakeAnc2734	SIMULPF00001	42	39	45	36	3	6
7735	RV_pair2735	FakeDesc2735	FakeAnc2735	SIMULPF00001	416	420	458	378	42	38
7736	RV_pair2736	FakeDesc2736	FakeAnc2736	SIMULPF00001	307	302	330	279	23	28
7737	RV_pair2737	FakeDesc2737	FakeAnc2737	SIMULPF00001	296	296	317	275	21	21
7738	RV_pair2738	FakeDesc2738	FakeAnc2738	SIMULPF00001	529	525	582	472	53	57
7739	RV_pair2739	FakeDesc2739	FakeAnc2739	SIMULPF00001	159	166	181	144	22	15
7740	RV_pair2740	FakeDesc2740	FakeAnc2740	SIMULPF00001	422	440	466	396	44	26
7741	RV_pair2741	FakeDesc2741	FakeAnc2741	SIMULPF00001	37	35	40	32	3	5
7742	RV_pair2742	FakeDesc2742	FakeAnc2742	SIMULPF00001	247	251	268	230	21	17
7743	RV_pair2743	FakeDesc2743	FakeAnc2743	SIMULPF00001	519	525	564	480	45	39
7744	RV_pair2744	FakeDesc2744	FakeAnc2744	SIMULPF00001	6	6	6	6	0	0
7745	RV_pair2745	FakeDesc2745	FakeAnc2745	SIMULPF00001	92	93	99	86	7	6
7746	RV_pair2746	FakeDesc2746	FakeAnc2746	SIMULPF00001	226	222	243	205	17	21
7747	RV_pair2747	FakeDesc2747	FakeAnc2747	SIMULPF00001	140	144	155	129	15	11
7748	RV_pair2748	FakeDesc2748	FakeAnc2748	SIMULPF00001	11	11	11	11	0	0
7749	RV_pair2749	FakeDesc2749	FakeAnc2749	SIMULPF00001	533	526	576	483	43	50
7750	RV_pair2750	FakeDesc2750	FakeAnc2750	SIMULPF00001	248	258	281	225	33	23
7751	RV_pair2751	FakeDesc2751	FakeAnc2751	SIMULPF00001	296	303	336	263	40	33
7752	RV_pair2752	FakeDesc2752	FakeAnc2752	SIMULPF00001	383	380	418	345	35	38
7753	RV_pair2753	FakeDesc2753	FakeAnc2753	SIMULPF00001	362	364	401	325	39	37
7754	RV_pair2754	FakeDesc2754	FakeAnc2754	SIMULPF00001	56	57	63	50	7	6
7755	RV_pair2755	FakeDesc2755	FakeAnc2755	SIMULPF00001	222	228	245	205	23	17
7756	RV_pair2756	FakeDesc2756	FakeAnc2756	SIMULPF00001	83	87	94	76	11	7
7757	RV_pair2757	FakeDesc2757	FakeAnc2757	SIMULPF00001	364	373	404	333	40	31
7758	RV_pair2758	FakeDesc2758	FakeAnc2758	SIMULPF00001	57	61	65	53	8	4
7759	RV_pair2759	FakeDesc2759	FakeAnc2759	SIMULPF00001	28	29	32	25	4	3
7760	RV_pair2760	FakeDesc2760	FakeAnc2760	SIMULPF00001	912	907	999	820	87	92
7761	RV_pair2761	FakeDesc2761	FakeAnc2761	SIMULPF00001	119	114	123	110	4	9
7762	RV_pair2762	FakeDesc2762	FakeAnc2762	SIMULPF00001	31	29	32	28	1	3
7763	RV_pair2763	FakeDesc2763	FakeAnc2763	SIMULPF00001	225	244	255	214	30	11
7764	RV_pair2764	FakeDesc2764	FakeAnc2764	SIMULPF00001	502	504	542	464	40	38
7765	RV_pair2765	FakeDesc2765	FakeAnc2765	SIMULPF00001	192	192	210	174	18	18
7766	RV_pair2766	FakeDesc2766	FakeAnc2766	SIMULPF00001	116	107	128	95	12	21
7767	RV_pair2767	FakeDesc2767	FakeAnc2767	SIMULPF00001	68	71	73	66	5	2
7768	RV_pair2768	FakeDesc2768	FakeAnc2768	SIMULPF00001	75	79	82	72	7	3
7769	RV_pair2769	FakeDesc2769	FakeAnc2769	SIMULPF00001	10	12	13	9	3	1
7770	RV_pair2770	FakeDesc2770	FakeAnc2770	SIMULPF00001	658	642	712	588	54	70
7771	RV_pair2771	FakeDesc2771	FakeAnc2771	SIMULPF00001	207	206	222	191	15	16
7772	RV_pair2772	FakeDesc2772	FakeAnc2772	SIMULPF00001	288	292	319	261	31	27
7773	RV_pair2773	FakeDesc2773	FakeAnc2773	SIMULPF00001	39	37	40	36	1	3
7774	RV_pair2774	FakeDesc2774	FakeAnc2774	SIMULPF00001	150	154	167	137	17	13
7775	RV_pair2775	FakeDesc2775	FakeAnc2775	SIMULPF00001	22	21	22	21	0	1
7776	RV_pair2776	FakeDesc2776	FakeAnc2776	SIMULPF00001	234	233	253	214	19	20
7777	RV_pair2777	FakeDesc2777	FakeAnc2777	SIMULPF00001	44	46	50	40	6	4
7778	RV_pair2778	FakeDesc2778	FakeAnc2778	SIMULPF00001	156	156	170	142	14	14
7779	RV_pair2779	FakeDesc2779	FakeAnc2779	SIMULPF00001	338	338	370	306	32	32
7780	RV_pair2780	FakeDesc2780	FakeAnc2780	SIMULPF00001	640	634	681	593	41	47
7781	RV_pair2781	FakeDesc2781	FakeAnc2781	SIMULPF00001	84	78	88	74	4	10
7782	RV_pair2782	FakeDesc2782	FakeAnc2782	SIMULPF00001	89	81	96	74	7	15
7783	RV_pair2783	FakeDesc2783	FakeAnc2783	SIMULPF00001	126	120	134	112	8	14
7784	RV_pair2784	FakeDesc2784	FakeAnc2784	SIMULPF00001	36	36	38	34	2	2
7785	RV_pair2785	FakeDesc2785	FakeAnc2785	SIMULPF00001	190	198	209	179	19	11
7786	RV_pair2786	FakeDesc2786	FakeAnc2786	SIMULPF00001	500	511	567	444	67	56
7787	RV_pair2787	FakeDesc2787	FakeAnc2787	SIMULPF00001	308	301	337	272	29	36
7788	RV_pair2788	FakeDesc2788	FakeAnc2788	SIMULPF00001	363	376	409	330	46	33
7789	RV_pair2789	FakeDesc2789	FakeAnc2789	SIMULPF00001	659	638	720	577	61	82
7790	RV_pair2790	FakeDesc2790	FakeAnc2790	SIMULPF00001	96	94	99	91	3	5
7791	RV_pair2791	FakeDesc2791	FakeAnc2791	SIMULPF00001	272	265	296	241	24	31
7792	RV_pair2792	FakeDesc2792	FakeAnc2792	SIMULPF00001	2	2	2	2	0	0
7793	RV_pair2793	FakeDesc2793	FakeAnc2793	SIMULPF00001	54	56	61	49	7	5
7794	RV_pair2794	FakeDesc2794	FakeAnc2794	SIMULPF00001	15	16	17	14	2	1
7795	RV_pair2795	FakeDesc2795	FakeAnc2795	SIMULPF00001	138	142	152	128	14	10
7796	RV_pair2796	FakeDesc2796	FakeAnc2796	SIMULPF00001	45	50	52	43	7	2
7797	RV_pair2797	FakeDesc2797	FakeAnc2797	SIMULPF00001	119	123	135	107	16	12
7798	RV_pair2798	FakeDesc2798	FakeAnc2798	SIMULPF00001	361	344	393	312	32	49
7799	RV_pair2799	FakeDesc2799	FakeAnc2799	SIMULPF00001	332	339	366	305	34	27
7800	RV_pair2800	FakeDesc2800	FakeAnc2800	SIMULPF00001	19	22	22	19	3	0
7801	RV_pair2801	FakeDesc2801	FakeAnc2801	SIMULPF00001	9	10	10	9	1	0
7802	RV_pair2802	FakeDesc2802	FakeAnc2802	SIMULPF00001	543	536	592	487	49	56
7803	RV_pair2803	FakeDesc2803	FakeAnc2803	SIMULPF00001	292	284	318	258	26	34
7804	RV_pair2804	FakeDesc2804	FakeAnc2804	SIMULPF00001	130	135	146	119	16	11
7805	RV_pair2805	FakeDesc2805	FakeAnc2805	SIMULPF00001	33	31	35	29	2	4
7806	RV_pair2806	FakeDesc2806	FakeAnc2806	SIMULPF00001	80	81	87	74	7	6
7807	RV_pair2807	FakeDesc2807	FakeAnc2807	SIMULPF00001	101	113	117	97	16	4
7808	RV_pair2808	FakeDesc2808	FakeAnc2808	SIMULPF00001	349	354	389	314	40	35
7809	RV_pair2809	FakeDesc2809	FakeAnc2809	SIMULPF00001	341	358	387	312	46	29
7810	RV_pair2810	FakeDesc2810	FakeAnc2810	SIMULPF00001	357	358	389	326	32	31
7811	RV_pair2811	FakeDesc2811	FakeAnc2811	SIMULPF00001	63	68	70	61	7	2
7812	RV_pair2812	FakeDesc2812	FakeAnc2812	SIMULPF00001	148	145	159	134	11	14
7813	RV_pair2813	FakeDesc2813	FakeAnc2813	SIMULPF00001	8	10	10	8	2	0
7814	RV_pair2814	FakeDesc2814	FakeAnc2814	SIMULPF00001	232	233	254	211	22	21
7815	RV_pair2815	FakeDesc2815	FakeAnc2815	SIMULPF00001	794	797	876	715	82	79
7816	RV_pair2816	FakeDesc2816	FakeAnc2816	SIMULPF00001	147	151	164	134	17	13
7817	RV_pair2817	FakeDesc2817	FakeAnc2817	SIMULPF00001	350	355	383	322	33	28
7818	RV_pair2818	FakeDesc2818	FakeAnc2818	SIMULPF00001	25	25	28	22	3	3
7819	RV_pair2819	FakeDesc2819	FakeAnc2819	SIMULPF00001	340	339	367	312	27	28
7820	RV_pair2820	FakeDesc2820	FakeAnc2820	SIMULPF00001	392	400	435	357	43	35
7821	RV_pair2821	FakeDesc2821	FakeAnc2821	SIMULPF00001	162	163	176	149	14	13
7822	RV_pair2822	FakeDesc2822	FakeAnc2822	SIMULPF00001	156	152	169	139	13	17
7823	RV_pair2823	FakeDesc2823	FakeAnc2823	SIMULPF00001	34	32	35	31	1	3
7824	RV_pair2824	FakeDesc2824	FakeAnc2824	SIMULPF00001	24	23	24	23	0	1
7825	RV_pair2825	FakeDesc2825	FakeAnc2825	SIMULPF00001	347	364	390	321	43	26
7826	RV_pair2826	FakeDesc2826	FakeAnc2826	SIMULPF00001	192	198	212	178	20	14
7827	RV_pair2827	FakeDesc2827	FakeAnc2827	SIMULPF00001	95	98	105	88	10	7
7828	RV_pair2828	FakeDesc2828	FakeAnc2828	SIMULPF00001	1	1	1	1	0	0
7829	RV_pair2829	FakeDesc2829	FakeAnc2829	SIMULPF00001	98	97	106	89	8	9
7830	RV_pair2830	FakeDesc2830	FakeAnc2830	SIMULPF00001	363	374	400	337	37	26
7831	RV_pair2831	FakeDesc2831	FakeAnc2831	SIMULPF00001	185	190	211	164	26	21
7832	RV_pair2832	FakeDesc2832	FakeAnc2832	SIMULPF00001	231	233	256	208	25	23
7833	RV_pair2833	FakeDesc2833	FakeAnc2833	SIMULPF00001	486	494	540	440	54	46
7834	RV_pair2834	FakeDesc2834	FakeAnc2834	SIMULPF00001	842	841	923	760	81	82
7835	RV_pair2835	FakeDesc2835	FakeAnc2835	SIMULPF00001	13	12	13	12	0	1
7836	RV_pair2836	FakeDesc2836	FakeAnc2836	SIMULPF00001	4	5	5	4	1	0
7837	RV_pair2837	FakeDesc2837	FakeAnc2837	SIMULPF00001	46	44	47	43	1	3
7838	RV_pair2838	FakeDesc2838	FakeAnc2838	SIMULPF00001	417	409	449	377	32	40
7839	RV_pair2839	FakeDesc2839	FakeAnc2839	SIMULPF00001	97	96	102	91	5	6
7840	RV_pair2840	FakeDesc2840	FakeAnc2840	SIMULPF00001	230	215	253	192	23	38
7841	RV_pair2841	FakeDesc2841	FakeAnc2841	SIMULPF00001	33	41	43	31	10	2
7842	RV_pair2842	FakeDesc2842	FakeAnc2842	SIMULPF00001	50	48	55	43	5	7
7843	RV_pair2843	FakeDesc2843	FakeAnc2843	SIMULPF00001	84	88	89	83	5	1
7844	RV_pair2844	FakeDesc2844	FakeAnc2844	SIMULPF00001	4	4	4	4	0	0
7845	RV_pair2845	FakeDesc2845	FakeAnc2845	SIMULPF00001	428	427	473	382	45	46
7846	RV_pair2846	FakeDesc2846	FakeAnc2846	SIMULPF00001	185	185	208	162	23	23
7847	RV_pair2847	FakeDesc2847	FakeAnc2847	SIMULPF00001	24	23	24	23	0	1
7848	RV_pair2848	FakeDesc2848	FakeAnc2848	SIMULPF00001	156	159	169	146	13	10
7849	RV_pair2849	FakeDesc2849	FakeAnc2849	SIMULPF00001	523	516	558	481	35	42
7850	RV_pair2850	FakeDesc2850	FakeAnc2850	SIMULPF00001	39	34	39	34	0	5
7851	RV_pair2851	FakeDesc2851	FakeAnc2851	SIMULPF00001	144	149	159	134	15	10
7852	RV_pair2852	FakeDesc2852	FakeAnc2852	SIMULPF00001	603	598	661	540	58	63
7853	RV_pair2853	FakeDesc2853	FakeAnc2853	SIMULPF00001	163	174	182	155	19	8
7854	RV_pair2854	FakeDesc2854	FakeAnc2854	SIMULPF00001	18	22	24	16	6	2
7855	RV_pair2855	FakeDesc2855	FakeAnc2855	SIMULPF00001	240	244	261	223	21	17
7856	RV_pair2856	FakeDesc2856	FakeAnc2856	SIMULPF00001	56	57	58	55	2	1
7857	RV_pair2857	FakeDesc2857	FakeAnc2857	SIMULPF00001	618	640	677	581	59	37
7858	RV_pair2858	FakeDesc2858	FakeAnc2858	SIMULPF00001	434	414	471	377	37	57
7859	RV_pair2859	FakeDesc2859	FakeAnc2859	SIMULPF00001	9	6	9	6	0	3
7860	RV_pair2860	FakeDesc2860	FakeAnc2860	SIMULPF00001	19	23	28	14	9	5
7861	RV_pair2861	FakeDesc2861	FakeAnc2861	SIMULPF00001	87	81	90	78	3	9
7862	RV_pair2862	FakeDesc2862	FakeAnc2862	SIMULPF00001	22	20	23	19	1	3
7863	RV_pair2863	FakeDesc2863	FakeAnc2863	SIMULPF00001	117	112	121	108	4	9
7864	RV_pair2864	FakeDesc2864	FakeAnc2864	SIMULPF00001	71	76	79	68	8	3
7865	RV_pair2865	FakeDesc2865	FakeAnc2865	SIMULPF00001	137	142	156	123	19	14
7866	RV_pair2866	FakeDesc2866	FakeAnc2866	SIMULPF00001	12	13	13	12	1	0
7867	RV_pair2867	FakeDesc2867	FakeAnc2867	SIMULPF00001	184	186	200	170	16	14
7868	RV_pair2868	FakeDesc2868	FakeAnc2868	SIMULPF00001	423	410	468	365	45	58
7869	RV_pair2869	FakeDesc2869	FakeAnc2869	SIMULPF00001	225	231	249	207	24	18
7870	RV_pair2870	FakeDesc2870	FakeAnc2870	SIMULPF00001	307	300	330	277	23	30
7871	RV_pair2871	FakeDesc2871	FakeAnc2871	SIMULPF00001	79	67	81	65	2	14
7872	RV_pair2872	FakeDesc2872	FakeAnc2872	SIMULPF00001	85	84	97	72	12	13
7873	RV_pair2873	FakeDesc2873	FakeAnc2873	SIMULPF00001	24	20	24	20	0	4
7874	RV_pair2874	FakeDesc2874	FakeAnc2874	SIMULPF00001	333	349	369	313	36	20
7875	RV_pair2875	FakeDesc2875	FakeAnc2875	SIMULPF00001	495	496	549	442	54	53
7876	RV_pair2876	FakeDesc2876	FakeAnc2876	SIMULPF00001	37	44	51	30	14	7
7877	RV_pair2877	FakeDesc2877	FakeAnc2877	SIMULPF00001	140	138	155	123	15	17
7878	RV_pair2878	FakeDesc2878	FakeAnc2878	SIMULPF00001	36	35	38	33	2	3
7879	RV_pair2879	FakeDesc2879	FakeAnc2879	SIMULPF00001	4	4	4	4	0	0
7880	RV_pair2880	FakeDesc2880	FakeAnc2880	SIMULPF00001	94	83	99	78	5	16
7881	RV_pair2881	FakeDesc2881	FakeAnc2881	SIMULPF00001	259	260	280	239	21	20
7882	RV_pair2882	FakeDesc2882	FakeAnc2882	SIMULPF00001	159	156	166	149	7	10
7883	RV_pair2883	FakeDesc2883	FakeAnc2883	SIMULPF00001	6	6	6	6	0	0
7884	RV_pair2884	FakeDesc2884	FakeAnc2884	SIMULPF00001	607	613	667	553	60	54
7885	RV_pair2885	FakeDesc2885	FakeAnc2885	SIMULPF00001	146	144	158	132	12	14
7886	RV_pair2886	FakeDesc2886	FakeAnc2886	SIMULPF00001	122	127	138	111	16	11
7887	RV_pair2887	FakeDesc2887	FakeAnc2887	SIMULPF00001	27	27	30	24	3	3
7888	RV_pair2888	FakeDesc2888	FakeAnc2888	SIMULPF00001	149	157	165	141	16	8
7889	RV_pair2889	FakeDesc2889	FakeAnc2889	SIMULPF00001	236	241	268	209	32	27
7890	RV_pair2890	FakeDesc2890	FakeAnc2890	SIMULPF00001	191	196	217	170	26	21
7891	RV_pair2891	FakeDesc2891	FakeAnc2891	SIMULPF00001	3	3	4	2	1	1
7892	RV_pair2892	FakeDesc2892	FakeAnc2892	SIMULPF00001	85	87	96	76	11	9
7893	RV_pair2893	FakeDesc2893	FakeAnc2893	SIMULPF00001	295	302	327	270	32	25
7894	RV_pair2894	FakeDesc2894	FakeAnc2894	SIMULPF00001	129	125	143	111	14	18
7895	RV_pair2895	FakeDesc2895	FakeAnc2895	SIMULPF00001	8	10	10	8	2	0
7896	RV_pair2896	FakeDesc2896	FakeAnc2896	SIMULPF00001	139	141	153	127	14	12
7897	RV_pair2897	FakeDesc2897	FakeAnc2897	SIMULPF00001	135	125	144	116	9	19
7898	RV_pair2898	FakeDesc2898	FakeAnc2898	SIMULPF00001	248	241	265	224	17	24
7899	RV_pair2899	FakeDesc2899	FakeAnc2899	SIMULPF00001	72	78	79	71	7	1
7900	RV_pair2900	FakeDesc2900	FakeAnc2900	SIMULPF00001	228	237	253	212	25	16
7901	RV_pair2901	FakeDesc2901	FakeAnc2901	SIMULPF00001	822	811	897	736	75	86
7902	RV_pair2902	FakeDesc2902	FakeAnc2902	SIMULPF00001	331	343	372	302	41	29
7903	RV_pair2903	FakeDesc2903	FakeAnc2903	SIMULPF00001	462	444	492	414	30	48
7904	RV_pair2904	FakeDesc2904	FakeAnc2904	SIMULPF00001	20	20	21	19	1	1
7905	RV_pair2905	FakeDesc2905	FakeAnc2905	SIMULPF00001	353	337	384	306	31	47
7906	RV_pair2906	FakeDesc2906	FakeAnc2906	SIMULPF00001	99	102	115	86	16	13
7907	RV_pair2907	FakeDesc2907	FakeAnc2907	SIMULPF00001	139	142	148	133	9	6
7908	RV_pair2908	FakeDesc2908	FakeAnc2908	SIMULPF00001	2	2	2	2	0	0
7909	RV_pair2909	FakeDesc2909	FakeAnc2909	SIMULPF00001	523	543	587	479	64	44
7910	RV_pair2910	FakeDesc2910	FakeAnc2910	SIMULPF00001	173	190	200	163	27	10
7911	RV_pair2911	FakeDesc2911	FakeAnc2911	SIMULPF00001	562	564	622	504	60	58
7912	RV_pair2912	FakeDesc2912	FakeAnc2912	SIMULPF00001	237	240	266	211	29	26
7913	RV_pair2913	FakeDesc2913	FakeAnc2913	SIMULPF00001	26	25	27	24	1	2
7914	RV_pair2914	FakeDesc2914	FakeAnc2914	SIMULPF00001	40	43	46	37	6	3
7915	RV_pair2915	FakeDesc2915	FakeAnc2915	SIMULPF00001	417	419	463	373	46	44
7916	RV_pair2916	FakeDesc2916	FakeAnc2916	SIMULPF00001	32	33	36	29	4	3
7917	RV_pair2917	FakeDesc2917	FakeAnc2917	SIMULPF00001	10	10	10	10	0	0
7918	RV_pair2918	FakeDesc2918	FakeAnc2918	SIMULPF00001	44	45	48	41	4	3
7919	RV_pair2919	FakeDesc2919	FakeAnc2919	SIMULPF00001	188	187	210	165	22	23
7920	RV_pair2920	FakeDesc2920	FakeAnc2920	SIMULPF00001	267	268	288	247	21	20
7921	RV_pair2921	FakeDesc2921	FakeAnc2921	SIMULPF00001	317	287	331	273	14	44
7922	RV_pair2922	FakeDesc2922	FakeAnc2922	SIMULPF00001	53	53	58	48	5	5
7923	RV_pair2923	FakeDesc2923	FakeAnc2923	SIMULPF00001	35	32	37	30	2	5
7924	RV_pair2924	FakeDesc2924	FakeAnc2924	SIMULPF00001	307	292	324	275	17	32
7925	RV_pair2925	FakeDesc2925	FakeAnc2925	SIMULPF00001	422	428	463	387	41	35
7926	RV_pair2926	FakeDesc2926	FakeAnc2926	SIMULPF00001	79	77	84	72	5	7
7927	RV_pair2927	FakeDesc2927	FakeAnc2927	SIMULPF00001	18	14	18	14	0	4
7928	RV_pair2928	FakeDesc2928	FakeAnc2928	SIMULPF00001	706	698	767	637	61	69
7929	RV_pair2929	FakeDesc2929	FakeAnc2929	SIMULPF00001	409	413	451	371	42	38
7930	RV_pair2930	FakeDesc2930	FakeAnc2930	SIMULPF00001	242	246	275	213	33	29
7931	RV_pair2931	FakeDesc2931	FakeAnc2931	SIMULPF00001	265	267	286	246	21	19
7932	RV_pair2932	FakeDesc2932	FakeAnc2932	SIMULPF00001	9	11	11	9	2	0
7933	RV_pair2933	FakeDesc2933	FakeAnc2933	SIMULPF00001	287	278	301	264	14	23
7934	RV_pair2934	FakeDesc2934	FakeAnc2934	SIMULPF00001	158	162	173	147	15	11
7935	RV_pair2935	FakeDesc2935	FakeAnc2935	SIMULPF00001	47	50	53	44	6	3
7936	RV_pair2936	FakeDesc2936	FakeAnc2936	SIMULPF00001	87	83	92	78	5	9
7937	RV_pair2937	FakeDesc2937	FakeAnc2937	SIMULPF00001	86	96	101	81	15	5
7938	RV_pair2938	FakeDesc2938	FakeAnc2938	SIMULPF00001	72	69	72	69	0	3
7939	RV_pair2939	FakeDesc2939	FakeAnc2939	SIMULPF00001	111	118	122	107	11	4
7940	RV_pair2940	FakeDesc2940	FakeAnc2940	SIMULPF00001	417	416	450	383	33	34
7941	RV_pair2941	FakeDesc2941	FakeAnc2941	SIMULPF00001	86	91	97	80	11	6
7942	RV_pair2942	FakeDesc2942	FakeAnc2942	SIMULPF00001	801	812	882	731	81	70
7943	RV_pair2943	FakeDesc2943	FakeAnc2943	SIMULPF00001	784	771	844	711	60	73
7944	RV_pair2944	FakeDesc2944	FakeAnc2944	SIMULPF00001	344	335	374	305	30	39
7945	RV_pair2945	FakeDesc2945	FakeAnc2945	SIMULPF00001	319	307	339	287	20	32
7946	RV_pair2946	FakeDesc2946	FakeAnc2946	SIMULPF00001	503	501	554	450	51	53
7947	RV_pair2947	FakeDesc2947	FakeAnc2947	SIMULPF00001	127	126	135	118	8	9
7948	RV_pair2948	FakeDesc2948	FakeAnc2948	SIMULPF00001	12	13	13	12	1	0
7949	RV_pair2949	FakeDesc2949	FakeAnc2949	SIMULPF00001	373	381	412	342	39	31
7950	RV_pair2950	FakeDesc2950	FakeAnc2950	SIMULPF00001	67	68	74	61	7	6
7951	RV_pair2951	FakeDesc2951	FakeAnc2951	SIMULPF00001	31	29	34	26	3	5
7952	RV_pair2952	FakeDesc2952	FakeAnc2952	SIMULPF00001	397	406	436	367	39	30
7953	RV_pair2953	FakeDesc2953	FakeAnc2953	SIMULPF00001	214	215	233	196	19	18
7954	RV_pair2954	FakeDesc2954	FakeAnc2954	SIMULPF00001	226	231	249	208	23	18
7955	RV_pair2955	FakeDesc2955	FakeAnc2955	SIMULPF00001	313	313	339	287	26	26
7956	RV_pair2956	FakeDesc2956	FakeAnc2956	SIMULPF00001	96	96	105	87	9	9
7957	RV_pair2957	FakeDesc2957	FakeAnc2957	SIMULPF00001	251	247	271	227	20	24
7958	RV_pair2958	FakeDesc2958	FakeAnc2958	SIMULPF00001	234	221	244	211	10	23
7959	RV_pair2959	FakeDesc2959	FakeAnc2959	SIMULPF00001	470	486	516	440	46	30
7960	RV_pair2960	FakeDesc2960	FakeAnc2960	SIMULPF00001	217	216	233	200	16	17
7961	RV_pair2961	FakeDesc2961	FakeAnc2961	SIMULPF00001	195	200	223	172	28	23
7962	RV_pair2962	FakeDesc2962	FakeAnc2962	SIMULPF00001	341	360	385	316	44	25
7963	RV_pair2963	FakeDesc2963	FakeAnc2963	SIMULPF00001	6	7	8	5	2	1
7964	RV_pair2964	FakeDesc2964	FakeAnc2964	SIMULPF00001	13	12	13	12	0	1
7965	RV_pair2965	FakeDesc2965	FakeAnc2965	SIMULPF00001	66	70	76	60	10	6
7966	RV_pair2966	FakeDesc2966	FakeAnc2966	SIMULPF00001	639	621	686	574	47	65
7967	RV_pair2967	FakeDesc2967	FakeAnc2967	SIMULPF00001	145	132	153	124	8	21
7968	RV_pair2968	FakeDesc2968	FakeAnc2968	SIMULPF00001	494	496	547	443	53	51
7969	RV_pair2969	FakeDesc2969	FakeAnc2969	SIMULPF00001	173	163	183	153	10	20
7970	RV_pair2970	FakeDesc2970	FakeAnc2970	SIMULPF00001	10	10	10	10	0	0
7971	RV_pair2971	FakeDesc2971	FakeAnc2971	SIMULPF00001	542	540	593	489	51	53
7972	RV_pair2972	FakeDesc2972	FakeAnc2972	SIMULPF00001	49	53	55	47	6	2
7973	RV_pair2973	FakeDesc2973	FakeAnc2973	SIMULPF00001	73	80	84	69	11	4
7974	RV_pair2974	FakeDesc2974	FakeAnc2974	SIMULPF00001	141	147	158	130	17	11
7975	RV_pair2975	FakeDesc2975	FakeAnc2975	SIMULPF00001	51	52	58	45	7	6
7976	RV_pair2976	FakeDesc2976	FakeAnc2976	SIMULPF00001	70	70	72	68	2	2
7977	RV_pair2977	FakeDesc2977	FakeAnc2977	SIMULPF00001	198	188	213	173	15	25
7978	RV_pair2978	FakeDesc2978	FakeAnc2978	SIMULPF00001	140	131	144	127	4	13
7979	RV_pair2979	FakeDesc2979	FakeAnc2979	SIMULPF00001	85	84	91	78	6	7
7980	RV_pair2980	FakeDesc2980	FakeAnc2980	SIMULPF00001	284	257	294	247	10	37
7981	RV_pair2981	FakeDesc2981	FakeAnc2981	SIMULPF00001	460	452	501	411	41	49
7982	RV_pair2982	FakeDesc2982	FakeAnc2982	SIMULPF00001	11	8	11	8	0	3
7983	RV_pair2983	FakeDesc2983	FakeAnc2983	SIMULPF00001	186	184	202	168	16	18
7984	RV_pair2984	FakeDesc2984	FakeAnc2984	SIMULPF00001	287	283	314	256	27	31
7985	RV_pair2985	FakeDesc2985	FakeAnc2985	SIMULPF00001	112	108	124	96	12	16
7986	RV_pair2986	FakeDesc2986	FakeAnc2986	SIMULPF00001	81	82	88	75	7	6
7987	RV_pair2987	FakeDesc2987	FakeAnc2987	SIMULPF00001	25	27	27	25	2	0
7988	RV_pair2988	FakeDesc2988	FakeAnc2988	SIMULPF00001	1	1	1	1	0	0
7989	RV_pair2989	FakeDesc2989	FakeAnc2989	SIMULPF00001	47	43	47	43	0	4
7990	RV_pair2990	FakeDesc2990	FakeAnc2990	SIMULPF00001	141	151	161	131	20	10
7991	RV_pair2991	FakeDesc2991	FakeAnc2991	SIMULPF00001	271	264	287	248	16	23
7992	RV_pair2992	FakeDesc2992	FakeAnc2992	SIMULPF00001	12	13	16	9	4	3
7993	RV_pair2993	FakeDesc2993	FakeAnc2993	SIMULPF00001	109	118	123	104	14	5
7994	RV_pair2994	FakeDesc2994	FakeAnc2994	SIMULPF00001	549	547	602	494	53	55
7995	RV_pair2995	FakeDesc2995	FakeAnc2995	SIMULPF00001	291	291	312	270	21	21
7996	RV_pair2996	FakeDesc2996	FakeAnc2996	SIMULPF00001	273	282	302	253	29	20
7997	RV_pair2997	FakeDesc2997	FakeAnc2997	SIMULPF00001	241	235	263	213	22	28
7998	RV_pair2998	FakeDesc2998	FakeAnc2998	SIMULPF00001	569	576	627	518	58	51
7999	RV_pair2999	FakeDesc2999	FakeAnc2999	SIMULPF00001	467	468	521	414	54	53
8000	RV_pair3000	FakeDesc3000	FakeAnc3000	SIMULPF00001	281	254	295	240	14	41
8001	RV_pair3001	FakeDesc3001	FakeAnc3001	SIMULPF00001	346	358	385	319	39	27
8002	RV_pair3002	FakeDesc3002	FakeAnc3002	SIMULPF00001	138	136	151	123	13	15
8003	RV_pair3003	FakeDesc3003	FakeAnc3003	SIMULPF00001	742	740	811	671	69	71
8004	RV_pair3004	FakeDesc3004	FakeAnc3004	SIMULPF00001	276	276	298	254	22	22
8005	RV_pair3005	FakeDesc3005	FakeAnc3005	SIMULPF00001	74	67	81	60	7	14
8006	RV_pair3006	FakeDesc3006	FakeAnc3006	SIMULPF00001	317	304	341	280	24	37
8007	RV_pair3007	FakeDesc3007	FakeAnc3007	SIMULPF00001	44	43	47	40	3	4
8008	RV_pair3008	FakeDesc3008	FakeAnc3008	SIMULPF00001	427	422	468	381	41	46
8009	RV_pair3009	FakeDesc3009	FakeAnc3009	SIMULPF00001	224	220	243	201	19	23
8010	RV_pair3010	FakeDesc3010	FakeAnc3010	SIMULPF00001	240	240	265	215	25	25
8011	RV_pair3011	FakeDesc3011	FakeAnc3011	SIMULPF00001	295	310	327	278	32	17
8012	RV_pair3012	FakeDesc3012	FakeAnc3012	SIMULPF00001	201	188	209	180	8	21
8013	RV_pair3013	FakeDesc3013	FakeAnc3013	SIMULPF00001	103	107	121	89	18	14
8014	RV_pair3014	FakeDesc3014	FakeAnc3014	SIMULPF00001	301	303	336	268	35	33
8015	RV_pair3015	FakeDesc3015	FakeAnc3015	SIMULPF00001	31	34	34	31	3	0
8016	RV_pair3016	FakeDesc3016	FakeAnc3016	SIMULPF00001	141	128	144	125	3	16
8017	RV_pair3017	FakeDesc3017	FakeAnc3017	SIMULPF00001	493	486	535	444	42	49
8018	RV_pair3018	FakeDesc3018	FakeAnc3018	SIMULPF00001	381	370	406	345	25	36
8019	RV_pair3019	FakeDesc3019	FakeAnc3019	SIMULPF00001	330	320	362	288	32	42
8020	RV_pair3020	FakeDesc3020	FakeAnc3020	SIMULPF00001	36	32	37	31	1	5
8021	RV_pair3021	FakeDesc3021	FakeAnc3021	SIMULPF00001	285	284	308	261	23	24
8022	RV_pair3022	FakeDesc3022	FakeAnc3022	SIMULPF00001	168	177	191	154	23	14
8023	RV_pair3023	FakeDesc3023	FakeAnc3023	SIMULPF00001	171	181	201	151	30	20
8024	RV_pair3024	FakeDesc3024	FakeAnc3024	SIMULPF00001	433	428	475	386	42	47
8025	RV_pair3025	FakeDesc3025	FakeAnc3025	SIMULPF00001	423	441	475	389	52	34
8026	RV_pair3026	FakeDesc3026	FakeAnc3026	SIMULPF00001	252	245	273	224	21	28
8027	RV_pair3027	FakeDesc3027	FakeAnc3027	SIMULPF00001	24	21	24	21	0	3
8028	RV_pair3028	FakeDesc3028	FakeAnc3028	SIMULPF00001	264	266	288	242	24	22
8029	RV_pair3029	FakeDesc3029	FakeAnc3029	SIMULPF00001	91	82	95	78	4	13
8030	RV_pair3030	FakeDesc3030	FakeAnc3030	SIMULPF00001	29	26	30	25	1	4
8031	RV_pair3031	FakeDesc3031	FakeAnc3031	SIMULPF00001	385	394	422	357	37	28
8032	RV_pair3032	FakeDesc3032	FakeAnc3032	SIMULPF00001	247	239	271	215	24	32
8033	RV_pair3033	FakeDesc3033	FakeAnc3033	SIMULPF00001	86	81	89	78	3	8
8034	RV_pair3034	FakeDesc3034	FakeAnc3034	SIMULPF00001	172	172	196	148	24	24
8035	RV_pair3035	FakeDesc3035	FakeAnc3035	SIMULPF00001	9	10	10	9	1	0
8036	RV_pair3036	FakeDesc3036	FakeAnc3036	SIMULPF00001	328	314	367	275	39	53
8037	RV_pair3037	FakeDesc3037	FakeAnc3037	SIMULPF00001	642	630	699	573	57	69
8038	RV_pair3038	FakeDesc3038	FakeAnc3038	SIMULPF00001	35	36	40	31	5	4
8039	RV_pair3039	FakeDesc3039	FakeAnc3039	SIMULPF00001	566	565	622	509	56	57
8040	RV_pair3040	FakeDesc3040	FakeAnc3040	SIMULPF00001	10	10	11	9	1	1
8041	RV_pair3041	FakeDesc3041	FakeAnc3041	SIMULPF00001	75	76	81	70	6	5
8042	RV_pair3042	FakeDesc3042	FakeAnc3042	SIMULPF00001	11	9	11	9	0	2
8043	RV_pair3043	FakeDesc3043	FakeAnc3043	SIMULPF00001	46	46	50	42	4	4
8044	RV_pair3044	FakeDesc3044	FakeAnc3044	SIMULPF00001	3	3	3	3	0	0
8045	RV_pair3045	FakeDesc3045	FakeAnc3045	SIMULPF00001	244	249	271	222	27	22
8046	RV_pair3046	FakeDesc3046	FakeAnc3046	SIMULPF00001	111	119	124	106	13	5
8047	RV_pair3047	FakeDesc3047	FakeAnc3047	SIMULPF00001	552	567	604	515	52	37
8048	RV_pair3048	FakeDesc3048	FakeAnc3048	SIMULPF00001	95	101	110	86	15	9
8049	RV_pair3049	FakeDesc3049	FakeAnc3049	SIMULPF00001	140	147	157	130	17	10
8050	RV_pair3050	FakeDesc3050	FakeAnc3050	SIMULPF00001	353	352	380	325	27	28
8051	RV_pair3051	FakeDesc3051	FakeAnc3051	SIMULPF00001	393	386	425	354	32	39
8052	RV_pair3052	FakeDesc3052	FakeAnc3052	SIMULPF00001	76	69	83	62	7	14
8053	RV_pair3053	FakeDesc3053	FakeAnc3053	SIMULPF00001	21	24	25	20	4	1
8054	RV_pair3054	FakeDesc3054	FakeAnc3054	SIMULPF00001	62	56	66	52	4	10
8055	RV_pair3055	FakeDesc3055	FakeAnc3055	SIMULPF00001	103	101	115	89	12	14
8056	RV_pair3056	FakeDesc3056	FakeAnc3056	SIMULPF00001	89	93	102	80	13	9
8057	RV_pair3057	FakeDesc3057	FakeAnc3057	SIMULPF00001	415	406	458	363	43	52
8058	RV_pair3058	FakeDesc3058	FakeAnc3058	SIMULPF00001	109	105	113	101	4	8
8059	RV_pair3059	FakeDesc3059	FakeAnc3059	SIMULPF00001	276	249	295	230	19	46
8060	RV_pair3060	FakeDesc3060	FakeAnc3060	SIMULPF00001	220	229	248	201	28	19
8061	RV_pair3061	FakeDesc3061	FakeAnc3061	SIMULPF00001	53	54	57	50	4	3
8062	RV_pair3062	FakeDesc3062	FakeAnc3062	SIMULPF00001	630	633	704	559	74	71
8063	RV_pair3063	FakeDesc3063	FakeAnc3063	SIMULPF00001	176	184	198	162	22	14
8064	RV_pair3064	FakeDesc3064	FakeAnc3064	SIMULPF00001	95	94	104	85	9	10
8065	RV_pair3065	FakeDesc3065	FakeAnc3065	SIMULPF00001	322	317	356	283	34	39
8066	RV_pair3066	FakeDesc3066	FakeAnc3066	SIMULPF00001	617	609	672	554	55	63
8067	RV_pair3067	FakeDesc3067	FakeAnc3067	SIMULPF00001	2	1	2	1	0	1
8068	RV_pair3068	FakeDesc3068	FakeAnc3068	SIMULPF00001	187	187	205	169	18	18
8069	RV_pair3069	FakeDesc3069	FakeAnc3069	SIMULPF00001	153	146	162	137	9	16
8070	RV_pair3070	FakeDesc3070	FakeAnc3070	SIMULPF00001	6	5	6	5	0	1
8071	RV_pair3071	FakeDesc3071	FakeAnc3071	SIMULPF00001	17	17	18	16	1	1
8072	RV_pair3072	FakeDesc3072	FakeAnc3072	SIMULPF00001	36	39	39	36	3	0
8073	RV_pair3073	FakeDesc3073	FakeAnc3073	SIMULPF00001	538	558	605	491	67	47
8074	RV_pair3074	FakeDesc3074	FakeAnc3074	SIMULPF00001	428	411	458	381	30	47
8075	RV_pair3075	FakeDesc3075	FakeAnc3075	SIMULPF00001	335	334	369	300	34	35
8076	RV_pair3076	FakeDesc3076	FakeAnc3076	SIMULPF00001	533	537	582	488	49	45
8077	RV_pair3077	FakeDesc3077	FakeAnc3077	SIMULPF00001	16	21	21	16	5	0
8078	RV_pair3078	FakeDesc3078	FakeAnc3078	SIMULPF00001	52	49	55	46	3	6
8079	RV_pair3079	FakeDesc3079	FakeAnc3079	SIMULPF00001	199	216	232	183	33	16
8080	RV_pair3080	FakeDesc3080	FakeAnc3080	SIMULPF00001	894	915	988	821	94	73
8081	RV_pair3081	FakeDesc3081	FakeAnc3081	SIMULPF00001	148	151	165	134	17	14
8082	RV_pair3082	FakeDesc3082	FakeAnc3082	SIMULPF00001	203	192	217	178	14	25
8083	RV_pair3083	FakeDesc3083	FakeAnc3083	SIMULPF00001	793	815	886	722	93	71
8084	RV_pair3084	FakeDesc3084	FakeAnc3084	SIMULPF00001	68	70	76	62	8	6
8085	RV_pair3085	FakeDesc3085	FakeAnc3085	SIMULPF00001	403	411	455	359	52	44
8086	RV_pair3086	FakeDesc3086	FakeAnc3086	SIMULPF00001	54	53	57	50	3	4
8087	RV_pair3087	FakeDesc3087	FakeAnc3087	SIMULPF00001	7	7	7	7	0	0
8088	RV_pair3088	FakeDesc3088	FakeAnc3088	SIMULPF00001	194	191	215	170	21	24
8089	RV_pair3089	FakeDesc3089	FakeAnc3089	SIMULPF00001	73	75	77	71	4	2
8090	RV_pair3090	FakeDesc3090	FakeAnc3090	SIMULPF00001	21	21	23	19	2	2
8091	RV_pair3091	FakeDesc3091	FakeAnc3091	SIMULPF00001	5	5	5	5	0	0
8092	RV_pair3092	FakeDesc3092	FakeAnc3092	SIMULPF00001	248	236	266	218	18	30
8093	RV_pair3093	FakeDesc3093	FakeAnc3093	SIMULPF00001	80	82	83	79	3	1
8094	RV_pair3094	FakeDesc3094	FakeAnc3094	SIMULPF00001	33	38	39	32	6	1
8095	RV_pair3095	FakeDesc3095	FakeAnc3095	SIMULPF00001	219	233	252	200	33	19
8096	RV_pair3096	FakeDesc3096	FakeAnc3096	SIMULPF00001	142	146	154	134	12	8
8097	RV_pair3097	FakeDesc3097	FakeAnc3097	SIMULPF00001	85	89	93	81	8	4
8098	RV_pair3098	FakeDesc3098	FakeAnc3098	SIMULPF00001	248	236	264	220	16	28
8099	RV_pair3099	FakeDesc3099	FakeAnc3099	SIMULPF00001	23	26	26	23	3	0
8100	RV_pair3100	FakeDesc3100	FakeAnc3100	SIMULPF00001	33	31	39	25	6	8
8101	RV_pair3101	FakeDesc3101	FakeAnc3101	SIMULPF00001	837	820	908	749	71	88
8102	RV_pair3102	FakeDesc3102	FakeAnc3102	SIMULPF00001	117	113	128	102	11	15
8103	RV_pair3103	FakeDesc3103	FakeAnc3103	SIMULPF00001	315	338	357	296	42	19
8104	RV_pair3104	FakeDesc3104	FakeAnc3104	SIMULPF00001	18	19	20	17	2	1
8105	RV_pair3105	FakeDesc3105	FakeAnc3105	SIMULPF00001	305	320	338	287	33	18
8106	RV_pair3106	FakeDesc3106	FakeAnc3106	SIMULPF00001	414	398	439	373	25	41
8107	RV_pair3107	FakeDesc3107	FakeAnc3107	SIMULPF00001	486	491	524	453	38	33
8108	RV_pair3108	FakeDesc3108	FakeAnc3108	SIMULPF00001	29	26	30	25	1	4
8109	RV_pair3109	FakeDesc3109	FakeAnc3109	SIMULPF00001	60	52	65	47	5	13
8110	RV_pair3110	FakeDesc3110	FakeAnc3110	SIMULPF00001	494	499	542	451	48	43
8111	RV_pair3111	FakeDesc3111	FakeAnc3111	SIMULPF00001	631	630	693	568	62	63
8112	RV_pair3112	FakeDesc3112	FakeAnc3112	SIMULPF00001	15	12	16	11	1	4
8113	RV_pair3113	FakeDesc3113	FakeAnc3113	SIMULPF00001	99	104	110	93	11	6
8114	RV_pair3114	FakeDesc3114	FakeAnc3114	SIMULPF00001	463	450	499	414	36	49
8115	RV_pair3115	FakeDesc3115	FakeAnc3115	SIMULPF00001	98	96	107	87	9	11
8116	RV_pair3116	FakeDesc3116	FakeAnc3116	SIMULPF00001	26	24	26	24	0	2
8117	RV_pair3117	FakeDesc3117	FakeAnc3117	SIMULPF00001	93	99	104	88	11	5
8118	RV_pair3118	FakeDesc3118	FakeAnc3118	SIMULPF00001	493	502	540	455	47	38
8119	RV_pair3119	FakeDesc3119	FakeAnc3119	SIMULPF00001	120	119	131	108	11	12
8120	RV_pair3120	FakeDesc3120	FakeAnc3120	SIMULPF00001	164	158	170	152	6	12
8121	RV_pair3121	FakeDesc3121	FakeAnc3121	SIMULPF00001	476	443	503	416	27	60
8122	RV_pair3122	FakeDesc3122	FakeAnc3122	SIMULPF00001	56	54	61	49	5	7
8123	RV_pair3123	FakeDesc3123	FakeAnc3123	SIMULPF00001	121	131	139	113	18	8
8124	RV_pair3124	FakeDesc3124	FakeAnc3124	SIMULPF00001	131	125	141	115	10	16
8125	RV_pair3125	FakeDesc3125	FakeAnc3125	SIMULPF00001	641	616	696	561	55	80
8126	RV_pair3126	FakeDesc3126	FakeAnc3126	SIMULPF00001	314	308	346	276	32	38
8127	RV_pair3127	FakeDesc3127	FakeAnc3127	SIMULPF00001	25	28	29	24	4	1
8128	RV_pair3128	FakeDesc3128	FakeAnc3128	SIMULPF00001	72	71	81	62	9	10
8129	RV_pair3129	FakeDesc3129	FakeAnc3129	SIMULPF00001	238	238	254	222	16	16
8130	RV_pair3130	FakeDesc3130	FakeAnc3130	SIMULPF00001	160	172	183	149	23	11
8131	RV_pair3131	FakeDesc3131	FakeAnc3131	SIMULPF00001	168	170	182	156	14	12
8132	RV_pair3132	FakeDesc3132	FakeAnc3132	SIMULPF00001	87	96	103	80	16	7
8133	RV_pair3133	FakeDesc3133	FakeAnc3133	SIMULPF00001	57	54	61	50	4	7
8134	RV_pair3134	FakeDesc3134	FakeAnc3134	SIMULPF00001	88	84	92	80	4	8
8135	RV_pair3135	FakeDesc3135	FakeAnc3135	SIMULPF00001	191	186	206	171	15	20
8136	RV_pair3136	FakeDesc3136	FakeAnc3136	SIMULPF00001	202	217	236	183	34	19
8137	RV_pair3137	FakeDesc3137	FakeAnc3137	SIMULPF00001	199	194	217	176	18	23
8138	RV_pair3138	FakeDesc3138	FakeAnc3138	SIMULPF00001	74	74	80	68	6	6
8139	RV_pair3139	FakeDesc3139	FakeAnc3139	SIMULPF00001	217	221	241	197	24	20
8140	RV_pair3140	FakeDesc3140	FakeAnc3140	SIMULPF00001	471	475	516	430	45	41
8141	RV_pair3141	FakeDesc3141	FakeAnc3141	SIMULPF00001	43	43	46	40	3	3
8142	RV_pair3142	FakeDesc3142	FakeAnc3142	SIMULPF00001	173	176	191	158	18	15
8143	RV_pair3143	FakeDesc3143	FakeAnc3143	SIMULPF00001	152	153	167	138	15	14
8144	RV_pair3144	FakeDesc3144	FakeAnc3144	SIMULPF00001	351	351	390	312	39	39
8145	RV_pair3145	FakeDesc3145	FakeAnc3145	SIMULPF00001	331	320	353	298	22	33
8146	RV_pair3146	FakeDesc3146	FakeAnc3146	SIMULPF00001	65	65	70	60	5	5
8147	RV_pair3147	FakeDesc3147	FakeAnc3147	SIMULPF00001	267	261	286	242	19	25
8148	RV_pair3148	FakeDesc3148	FakeAnc3148	SIMULPF00001	305	296	330	271	25	34
8149	RV_pair3149	FakeDesc3149	FakeAnc3149	SIMULPF00001	163	165	179	149	16	14
8150	RV_pair3150	FakeDesc3150	FakeAnc3150	SIMULPF00001	10	10	10	10	0	0
8151	RV_pair3151	FakeDesc3151	FakeAnc3151	SIMULPF00001	261	256	283	234	22	27
8152	RV_pair3152	FakeDesc3152	FakeAnc3152	SIMULPF00001	249	254	279	224	30	25
8153	RV_pair3153	FakeDesc3153	FakeAnc3153	SIMULPF00001	813	822	897	738	84	75
8154	RV_pair3154	FakeDesc3154	FakeAnc3154	SIMULPF00001	27	28	30	25	3	2
8155	RV_pair3155	FakeDesc3155	FakeAnc3155	SIMULPF00001	208	201	221	188	13	20
8156	RV_pair3156	FakeDesc3156	FakeAnc3156	SIMULPF00001	106	113	121	98	15	8
8157	RV_pair3157	FakeDesc3157	FakeAnc3157	SIMULPF00001	337	315	358	294	21	43
8158	RV_pair3158	FakeDesc3158	FakeAnc3158	SIMULPF00001	99	91	103	87	4	12
8159	RV_pair3159	FakeDesc3159	FakeAnc3159	SIMULPF00001	104	98	114	88	10	16
8160	RV_pair3160	FakeDesc3160	FakeAnc3160	SIMULPF00001	32	30	32	30	0	2
8161	RV_pair3161	FakeDesc3161	FakeAnc3161	SIMULPF00001	34	33	39	28	5	6
8162	RV_pair3162	FakeDesc3162	FakeAnc3162	SIMULPF00001	180	170	191	159	11	21
8163	RV_pair3163	FakeDesc3163	FakeAnc3163	SIMULPF00001	97	104	112	89	15	8
8164	RV_pair3164	FakeDesc3164	FakeAnc3164	SIMULPF00001	68	65	75	58	7	10
8165	RV_pair3165	FakeDesc3165	FakeAnc3165	SIMULPF00001	43	44	48	39	5	4
8166	RV_pair3166	FakeDesc3166	FakeAnc3166	SIMULPF00001	301	303	336	268	35	33
8167	RV_pair3167	FakeDesc3167	FakeAnc3167	SIMULPF00001	150	152	160	142	10	8
8168	RV_pair3168	FakeDesc3168	FakeAnc3168	SIMULPF00001	528	520	570	478	42	50
8169	RV_pair3169	FakeDesc3169	FakeAnc3169	SIMULPF00001	318	333	359	292	41	26
8170	RV_pair3170	FakeDesc3170	FakeAnc3170	SIMULPF00001	127	116	129	114	2	13
8171	RV_pair3171	FakeDesc3171	FakeAnc3171	SIMULPF00001	290	293	311	272	21	18
8172	RV_pair3172	FakeDesc3172	FakeAnc3172	SIMULPF00001	322	328	352	298	30	24
8173	RV_pair3173	FakeDesc3173	FakeAnc3173	SIMULPF00001	357	348	385	320	28	37
8174	RV_pair3174	FakeDesc3174	FakeAnc3174	SIMULPF00001	485	453	520	418	35	67
8175	RV_pair3175	FakeDesc3175	FakeAnc3175	SIMULPF00001	265	264	284	245	19	20
8176	RV_pair3176	FakeDesc3176	FakeAnc3176	SIMULPF00001	182	177	196	163	14	19
8177	RV_pair3177	FakeDesc3177	FakeAnc3177	SIMULPF00001	115	118	124	109	9	6
8178	RV_pair3178	FakeDesc3178	FakeAnc3178	SIMULPF00001	237	237	257	217	20	20
8179	RV_pair3179	FakeDesc3179	FakeAnc3179	SIMULPF00001	229	230	251	208	22	21
8180	RV_pair3180	FakeDesc3180	FakeAnc3180	SIMULPF00001	747	751	817	681	70	66
8181	RV_pair3181	FakeDesc3181	FakeAnc3181	SIMULPF00001	88	96	99	85	11	3
8182	RV_pair3182	FakeDesc3182	FakeAnc3182	SIMULPF00001	510	511	548	473	38	37
8183	RV_pair3183	FakeDesc3183	FakeAnc3183	SIMULPF00001	276	288	310	254	34	22
8184	RV_pair3184	FakeDesc3184	FakeAnc3184	SIMULPF00001	101	90	106	85	5	16
8185	RV_pair3185	FakeDesc3185	FakeAnc3185	SIMULPF00001	7	7	7	7	0	0
8186	RV_pair3186	FakeDesc3186	FakeAnc3186	SIMULPF00001	676	667	732	611	56	65
8187	RV_pair3187	FakeDesc3187	FakeAnc3187	SIMULPF00001	83	80	89	74	6	9
8188	RV_pair3188	FakeDesc3188	FakeAnc3188	SIMULPF00001	315	321	344	292	29	23
8189	RV_pair3189	FakeDesc3189	FakeAnc3189	SIMULPF00001	17	21	22	16	5	1
8190	RV_pair3190	FakeDesc3190	FakeAnc3190	SIMULPF00001	151	157	172	136	21	15
8191	RV_pair3191	FakeDesc3191	FakeAnc3191	SIMULPF00001	338	350	382	306	44	32
8192	RV_pair3192	FakeDesc3192	FakeAnc3192	SIMULPF00001	429	443	482	390	53	39
8193	RV_pair3193	FakeDesc3193	FakeAnc3193	SIMULPF00001	382	386	424	344	42	38
8194	RV_pair3194	FakeDesc3194	FakeAnc3194	SIMULPF00001	52	49	55	46	3	6
8195	RV_pair3195	FakeDesc3195	FakeAnc3195	SIMULPF00001	198	193	221	170	23	28
8196	RV_pair3196	FakeDesc3196	FakeAnc3196	SIMULPF00001	470	481	516	435	46	35
8197	RV_pair3197	FakeDesc3197	FakeAnc3197	SIMULPF00001	55	57	58	54	3	1
8198	RV_pair3198	FakeDesc3198	FakeAnc3198	SIMULPF00001	265	264	292	237	27	28
8199	RV_pair3199	FakeDesc3199	FakeAnc3199	SIMULPF00001	151	141	165	127	14	24
8200	RV_pair3200	FakeDesc3200	FakeAnc3200	SIMULPF00001	108	101	118	91	10	17
8201	RV_pair3201	FakeDesc3201	FakeAnc3201	SIMULPF00001	76	78	90	64	14	12
8202	RV_pair3202	FakeDesc3202	FakeAnc3202	SIMULPF00001	291	292	316	267	25	24
8203	RV_pair3203	FakeDesc3203	FakeAnc3203	SIMULPF00001	69	64	69	64	0	5
8204	RV_pair3204	FakeDesc3204	FakeAnc3204	SIMULPF00001	71	70	75	66	4	5
8205	RV_pair3205	FakeDesc3205	FakeAnc3205	SIMULPF00001	59	56	65	50	6	9
8206	RV_pair3206	FakeDesc3206	FakeAnc3206	SIMULPF00001	54	57	61	50	7	4
8207	RV_pair3207	FakeDesc3207	FakeAnc3207	SIMULPF00001	301	321	345	277	44	24
8208	RV_pair3208	FakeDesc3208	FakeAnc3208	SIMULPF00001	475	477	520	432	45	43
8209	RV_pair3209	FakeDesc3209	FakeAnc3209	SIMULPF00001	86	89	98	77	12	9
8210	RV_pair3210	FakeDesc3210	FakeAnc3210	SIMULPF00001	96	84	97	83	1	13
8211	RV_pair3211	FakeDesc3211	FakeAnc3211	SIMULPF00001	203	207	222	188	19	15
8212	RV_pair3212	FakeDesc3212	FakeAnc3212	SIMULPF00001	242	242	267	217	25	25
8213	RV_pair3213	FakeDesc3213	FakeAnc3213	SIMULPF00001	478	486	524	440	46	38
8214	RV_pair3214	FakeDesc3214	FakeAnc3214	SIMULPF00001	316	309	348	277	32	39
8215	RV_pair3215	FakeDesc3215	FakeAnc3215	SIMULPF00001	64	70	73	61	9	3
8216	RV_pair3216	FakeDesc3216	FakeAnc3216	SIMULPF00001	33	33	37	29	4	4
8217	RV_pair3217	FakeDesc3217	FakeAnc3217	SIMULPF00001	119	117	127	109	8	10
8218	RV_pair3218	FakeDesc3218	FakeAnc3218	SIMULPF00001	98	94	105	87	7	11
8219	RV_pair3219	FakeDesc3219	FakeAnc3219	SIMULPF00001	242	254	268	228	26	14
8220	RV_pair3220	FakeDesc3220	FakeAnc3220	SIMULPF00001	80	77	88	69	8	11
8221	RV_pair3221	FakeDesc3221	FakeAnc3221	SIMULPF00001	57	50	57	50	0	7
8222	RV_pair3222	FakeDesc3222	FakeAnc3222	SIMULPF00001	412	417	460	369	48	43
8223	RV_pair3223	FakeDesc3223	FakeAnc3223	SIMULPF00001	293	287	313	267	20	26
8224	RV_pair3224	FakeDesc3224	FakeAnc3224	SIMULPF00001	630	630	691	569	61	61
8225	RV_pair3225	FakeDesc3225	FakeAnc3225	SIMULPF00001	133	132	144	121	11	12
8226	RV_pair3226	FakeDesc3226	FakeAnc3226	SIMULPF00001	276	299	319	256	43	20
8227	RV_pair3227	FakeDesc3227	FakeAnc3227	SIMULPF00001	32	31	32	31	0	1
8228	RV_pair3228	FakeDesc3228	FakeAnc3228	SIMULPF00001	651	645	711	585	60	66
8229	RV_pair3229	FakeDesc3229	FakeAnc3229	SIMULPF00001	202	200	221	181	19	21
8230	RV_pair3230	FakeDesc3230	FakeAnc3230	SIMULPF00001	86	83	92	77	6	9
8231	RV_pair3231	FakeDesc3231	FakeAnc3231	SIMULPF00001	145	141	157	129	12	16
8232	RV_pair3232	FakeDesc3232	FakeAnc3232	SIMULPF00001	107	115	124	98	17	9
8233	RV_pair3233	FakeDesc3233	FakeAnc3233	SIMULPF00001	32	34	35	31	3	1
8234	RV_pair3234	FakeDesc3234	FakeAnc3234	SIMULPF00001	242	232	260	214	18	28
8235	RV_pair3235	FakeDesc3235	FakeAnc3235	SIMULPF00001	91	90	102	79	11	12
8236	RV_pair3236	FakeDesc3236	FakeAnc3236	SIMULPF00001	55	54	58	51	3	4
8237	RV_pair3237	FakeDesc3237	FakeAnc3237	SIMULPF00001	198	201	215	184	17	14
8238	RV_pair3238	FakeDesc3238	FakeAnc3238	SIMULPF00001	271	270	289	252	18	19
8239	RV_pair3239	FakeDesc3239	FakeAnc3239	SIMULPF00001	62	62	70	54	8	8
8240	RV_pair3240	FakeDesc3240	FakeAnc3240	SIMULPF00001	304	295	327	272	23	32
8241	RV_pair3241	FakeDesc3241	FakeAnc3241	SIMULPF00001	287	292	313	266	26	21
8242	RV_pair3242	FakeDesc3242	FakeAnc3242	SIMULPF00001	53	52	58	47	5	6
8243	RV_pair3243	FakeDesc3243	FakeAnc3243	SIMULPF00001	365	375	401	339	36	26
8244	RV_pair3244	FakeDesc3244	FakeAnc3244	SIMULPF00001	128	127	136	119	8	9
8245	RV_pair3245	FakeDesc3245	FakeAnc3245	SIMULPF00001	403	419	438	384	35	19
8246	RV_pair3246	FakeDesc3246	FakeAnc3246	SIMULPF00001	315	317	351	281	36	34
8247	RV_pair3247	FakeDesc3247	FakeAnc3247	SIMULPF00001	1	2	2	1	1	0
8248	RV_pair3248	FakeDesc3248	FakeAnc3248	SIMULPF00001	133	132	144	121	11	12
8249	RV_pair3249	FakeDesc3249	FakeAnc3249	SIMULPF00001	368	363	400	331	32	37
8250	RV_pair3250	FakeDesc3250	FakeAnc3250	SIMULPF00001	381	360	405	336	24	45
8251	RV_pair3251	FakeDesc3251	FakeAnc3251	SIMULPF00001	95	96	107	84	12	11
8252	RV_pair3252	FakeDesc3252	FakeAnc3252	SIMULPF00001	62	70	71	61	9	1
8253	RV_pair3253	FakeDesc3253	FakeAnc3253	SIMULPF00001	153	156	172	137	19	16
8254	RV_pair3254	FakeDesc3254	FakeAnc3254	SIMULPF00001	71	69	74	66	3	5
8255	RV_pair3255	FakeDesc3255	FakeAnc3255	SIMULPF00001	55	60	66	49	11	6
8256	RV_pair3256	FakeDesc3256	FakeAnc3256	SIMULPF00001	623	647	700	570	77	53
8257	RV_pair3257	FakeDesc3257	FakeAnc3257	SIMULPF00001	197	199	213	183	16	14
8258	RV_pair3258	FakeDesc3258	FakeAnc3258	SIMULPF00001	184	188	198	174	14	10
8259	RV_pair3259	FakeDesc3259	FakeAnc3259	SIMULPF00001	113	101	116	98	3	15
8260	RV_pair3260	FakeDesc3260	FakeAnc3260	SIMULPF00001	148	148	162	134	14	14
8261	RV_pair3261	FakeDesc3261	FakeAnc3261	SIMULPF00001	225	222	243	204	18	21
8262	RV_pair3262	FakeDesc3262	FakeAnc3262	SIMULPF00001	267	265	289	243	22	24
8263	RV_pair3263	FakeDesc3263	FakeAnc3263	SIMULPF00001	302	313	342	273	40	29
8264	RV_pair3264	FakeDesc3264	FakeAnc3264	SIMULPF00001	522	505	560	467	38	55
8265	RV_pair3265	FakeDesc3265	FakeAnc3265	SIMULPF00001	262	277	293	246	31	16
8266	RV_pair3266	FakeDesc3266	FakeAnc3266	SIMULPF00001	108	109	118	99	10	9
8267	RV_pair3267	FakeDesc3267	FakeAnc3267	SIMULPF00001	213	207	231	189	18	24
8268	RV_pair3268	FakeDesc3268	FakeAnc3268	SIMULPF00001	36	35	39	32	3	4
8269	RV_pair3269	FakeDesc3269	FakeAnc3269	SIMULPF00001	32	33	34	31	2	1
8270	RV_pair3270	FakeDesc3270	FakeAnc3270	SIMULPF00001	681	642	728	595	47	86
8271	RV_pair3271	FakeDesc3271	FakeAnc3271	SIMULPF00001	285	277	311	251	26	34
8272	RV_pair3272	FakeDesc3272	FakeAnc3272	SIMULPF00001	20	18	20	18	0	2
8273	RV_pair3273	FakeDesc3273	FakeAnc3273	SIMULPF00001	373	376	414	335	41	38
8274	RV_pair3274	FakeDesc3274	FakeAnc3274	SIMULPF00001	256	244	275	225	19	31
8275	RV_pair3275	FakeDesc3275	FakeAnc3275	SIMULPF00001	352	345	381	316	29	36
8276	RV_pair3276	FakeDesc3276	FakeAnc3276	SIMULPF00001	149	160	169	140	20	9
8277	RV_pair3277	FakeDesc3277	FakeAnc3277	SIMULPF00001	421	411	447	385	26	36
8278	RV_pair3278	FakeDesc3278	FakeAnc3278	SIMULPF00001	161	156	172	145	11	16
8279	RV_pair3279	FakeDesc3279	FakeAnc3279	SIMULPF00001	211	214	232	193	21	18
8280	RV_pair3280	FakeDesc3280	FakeAnc3280	SIMULPF00001	83	76	87	72	4	11
8281	RV_pair3281	FakeDesc3281	FakeAnc3281	SIMULPF00001	323	347	363	307	40	16
8282	RV_pair3282	FakeDesc3282	FakeAnc3282	SIMULPF00001	207	207	225	189	18	18
8283	RV_pair3283	FakeDesc3283	FakeAnc3283	SIMULPF00001	409	406	446	369	37	40
8284	RV_pair3284	FakeDesc3284	FakeAnc3284	SIMULPF00001	134	139	144	129	10	5
8285	RV_pair3285	FakeDesc3285	FakeAnc3285	SIMULPF00001	33	29	35	27	2	6
8286	RV_pair3286	FakeDesc3286	FakeAnc3286	SIMULPF00001	122	128	138	112	16	10
8287	RV_pair3287	FakeDesc3287	FakeAnc3287	SIMULPF00001	99	96	107	88	8	11
8288	RV_pair3288	FakeDesc3288	FakeAnc3288	SIMULPF00001	62	66	69	59	7	3
8289	RV_pair3289	FakeDesc3289	FakeAnc3289	SIMULPF00001	578	568	623	523	45	55
8290	RV_pair3290	FakeDesc3290	FakeAnc3290	SIMULPF00001	669	691	760	600	91	69
8291	RV_pair3291	FakeDesc3291	FakeAnc3291	SIMULPF00001	68	61	69	60	1	8
8292	RV_pair3292	FakeDesc3292	FakeAnc3292	SIMULPF00001	61	60	63	58	2	3
8293	RV_pair3293	FakeDesc3293	FakeAnc3293	SIMULPF00001	760	763	835	688	75	72
8294	RV_pair3294	FakeDesc3294	FakeAnc3294	SIMULPF00001	339	337	372	304	33	35
8295	RV_pair3295	FakeDesc3295	FakeAnc3295	SIMULPF00001	283	274	303	254	20	29
8296	RV_pair3296	FakeDesc3296	FakeAnc3296	SIMULPF00001	304	296	334	266	30	38
8297	RV_pair3297	FakeDesc3297	FakeAnc3297	SIMULPF00001	265	267	286	246	21	19
8298	RV_pair3298	FakeDesc3298	FakeAnc3298	SIMULPF00001	156	156	171	141	15	15
8299	RV_pair3299	FakeDesc3299	FakeAnc3299	SIMULPF00001	158	164	177	145	19	13
8300	RV_pair3300	FakeDesc3300	FakeAnc3300	SIMULPF00001	121	121	137	105	16	16
8301	RV_pair3301	FakeDesc3301	FakeAnc3301	SIMULPF00001	679	687	756	610	77	69
8302	RV_pair3302	FakeDesc3302	FakeAnc3302	SIMULPF00001	544	552	604	492	60	52
8303	RV_pair3303	FakeDesc3303	FakeAnc3303	SIMULPF00001	35	31	36	30	1	5
8304	RV_pair3304	FakeDesc3304	FakeAnc3304	SIMULPF00001	156	162	175	143	19	13
8305	RV_pair3305	FakeDesc3305	FakeAnc3305	SIMULPF00001	510	498	551	457	41	53
8306	RV_pair3306	FakeDesc3306	FakeAnc3306	SIMULPF00001	534	535	582	487	48	47
8307	RV_pair3307	FakeDesc3307	FakeAnc3307	SIMULPF00001	407	405	444	368	37	39
8308	RV_pair3308	FakeDesc3308	FakeAnc3308	SIMULPF00001	60	56	64	52	4	8
8309	RV_pair3309	FakeDesc3309	FakeAnc3309	SIMULPF00001	367	369	411	325	44	42
8310	RV_pair3310	FakeDesc3310	FakeAnc3310	SIMULPF00001	350	361	388	323	38	27
8311	RV_pair3311	FakeDesc3311	FakeAnc3311	SIMULPF00001	224	233	255	202	31	22
8312	RV_pair3312	FakeDesc3312	FakeAnc3312	SIMULPF00001	238	237	252	223	14	15
8313	RV_pair3313	FakeDesc3313	FakeAnc3313	SIMULPF00001	12	11	13	10	1	2
8314	RV_pair3314	FakeDesc3314	FakeAnc3314	SIMULPF00001	149	157	166	140	17	9
8315	RV_pair3315	FakeDesc3315	FakeAnc3315	SIMULPF00001	140	142	154	128	14	12
8316	RV_pair3316	FakeDesc3316	FakeAnc3316	SIMULPF00001	157	155	170	142	13	15
8317	RV_pair3317	FakeDesc3317	FakeAnc3317	SIMULPF00001	93	91	101	83	8	10
8318	RV_pair3318	FakeDesc3318	FakeAnc3318	SIMULPF00001	289	294	316	267	27	22
8319	RV_pair3319	FakeDesc3319	FakeAnc3319	SIMULPF00001	283	283	309	257	26	26
8320	RV_pair3320	FakeDesc3320	FakeAnc3320	SIMULPF00001	465	477	514	428	49	37
8321	RV_pair3321	FakeDesc3321	FakeAnc3321	SIMULPF00001	494	480	531	443	37	51
8322	RV_pair3322	FakeDesc3322	FakeAnc3322	SIMULPF00001	438	435	491	382	53	56
8323	RV_pair3323	FakeDesc3323	FakeAnc3323	SIMULPF00001	151	154	162	143	11	8
8324	RV_pair3324	FakeDesc3324	FakeAnc3324	SIMULPF00001	125	115	135	105	10	20
8325	RV_pair3325	FakeDesc3325	FakeAnc3325	SIMULPF00001	165	166	181	150	16	15
8326	RV_pair3326	FakeDesc3326	FakeAnc3326	SIMULPF00001	834	852	914	772	80	62
8327	RV_pair3327	FakeDesc3327	FakeAnc3327	SIMULPF00001	484	493	527	450	43	34
8328	RV_pair3328	FakeDesc3328	FakeAnc3328	SIMULPF00001	42	41	43	40	1	2
8329	RV_pair3329	FakeDesc3329	FakeAnc3329	SIMULPF00001	62	66	69	59	7	3
8330	RV_pair3330	FakeDesc3330	FakeAnc3330	SIMULPF00001	511	485	545	451	34	60
8331	RV_pair3331	FakeDesc3331	FakeAnc3331	SIMULPF00001	135	136	153	118	18	17
8332	RV_pair3332	FakeDesc3332	FakeAnc3332	SIMULPF00001	123	120	132	111	9	12
8333	RV_pair3333	FakeDesc3333	FakeAnc3333	SIMULPF00001	142	141	153	130	11	12
8334	RV_pair3334	FakeDesc3334	FakeAnc3334	SIMULPF00001	36	36	38	34	2	2
8335	RV_pair3335	FakeDesc3335	FakeAnc3335	SIMULPF00001	155	157	173	139	18	16
8336	RV_pair3336	FakeDesc3336	FakeAnc3336	SIMULPF00001	100	108	116	92	16	8
8337	RV_pair3337	FakeDesc3337	FakeAnc3337	SIMULPF00001	114	112	126	100	12	14
8338	RV_pair3338	FakeDesc3338	FakeAnc3338	SIMULPF00001	64	59	71	52	7	12
8339	RV_pair3339	FakeDesc3339	FakeAnc3339	SIMULPF00001	527	534	583	478	56	49
8340	RV_pair3340	FakeDesc3340	FakeAnc3340	SIMULPF00001	46	40	48	38	2	8
8341	RV_pair3341	FakeDesc3341	FakeAnc3341	SIMULPF00001	221	219	239	201	18	20
8342	RV_pair3342	FakeDesc3342	FakeAnc3342	SIMULPF00001	604	605	659	550	55	54
8343	RV_pair3343	FakeDesc3343	FakeAnc3343	SIMULPF00001	358	366	394	330	36	28
8344	RV_pair3344	FakeDesc3344	FakeAnc3344	SIMULPF00001	115	110	119	106	4	9
8345	RV_pair3345	FakeDesc3345	FakeAnc3345	SIMULPF00001	41	44	46	39	5	2
8346	RV_pair3346	FakeDesc3346	FakeAnc3346	SIMULPF00001	121	109	126	104	5	17
8347	RV_pair3347	FakeDesc3347	FakeAnc3347	SIMULPF00001	543	533	593	483	50	60
8348	RV_pair3348	FakeDesc3348	FakeAnc3348	SIMULPF00001	21	24	27	18	6	3
8349	RV_pair3349	FakeDesc3349	FakeAnc3349	SIMULPF00001	156	144	164	136	8	20
8350	RV_pair3350	FakeDesc3350	FakeAnc3350	SIMULPF00001	424	434	467	391	43	33
8351	RV_pair3351	FakeDesc3351	FakeAnc3351	SIMULPF00001	263	253	281	235	18	28
8352	RV_pair3352	FakeDesc3352	FakeAnc3352	SIMULPF00001	581	567	630	518	49	63
8353	RV_pair3353	FakeDesc3353	FakeAnc3353	SIMULPF00001	47	40	50	37	3	10
8354	RV_pair3354	FakeDesc3354	FakeAnc3354	SIMULPF00001	57	58	65	50	8	7
8355	RV_pair3355	FakeDesc3355	FakeAnc3355	SIMULPF00001	304	301	329	276	25	28
8356	RV_pair3356	FakeDesc3356	FakeAnc3356	SIMULPF00001	93	85	98	80	5	13
8357	RV_pair3357	FakeDesc3357	FakeAnc3357	SIMULPF00001	243	241	270	214	27	29
8358	RV_pair3358	FakeDesc3358	FakeAnc3358	SIMULPF00001	310	309	343	276	33	34
8359	RV_pair3359	FakeDesc3359	FakeAnc3359	SIMULPF00001	92	98	105	85	13	7
8360	RV_pair3360	FakeDesc3360	FakeAnc3360	SIMULPF00001	270	264	296	238	26	32
8361	RV_pair3361	FakeDesc3361	FakeAnc3361	SIMULPF00001	17	18	18	17	1	0
8362	RV_pair3362	FakeDesc3362	FakeAnc3362	SIMULPF00001	428	422	459	391	31	37
8363	RV_pair3363	FakeDesc3363	FakeAnc3363	SIMULPF00001	243	241	265	219	22	24
8364	RV_pair3364	FakeDesc3364	FakeAnc3364	SIMULPF00001	440	433	477	396	37	44
8365	RV_pair3365	FakeDesc3365	FakeAnc3365	SIMULPF00001	98	93	102	89	4	9
8366	RV_pair3366	FakeDesc3366	FakeAnc3366	SIMULPF00001	840	832	911	761	71	79
8367	RV_pair3367	FakeDesc3367	FakeAnc3367	SIMULPF00001	192	197	210	179	18	13
8368	RV_pair3368	FakeDesc3368	FakeAnc3368	SIMULPF00001	22	28	29	21	7	1
8369	RV_pair3369	FakeDesc3369	FakeAnc3369	SIMULPF00001	248	267	285	230	37	18
8370	RV_pair3370	FakeDesc3370	FakeAnc3370	SIMULPF00001	259	278	296	241	37	18
8371	RV_pair3371	FakeDesc3371	FakeAnc3371	SIMULPF00001	14	11	14	11	0	3
8372	RV_pair3372	FakeDesc3372	FakeAnc3372	SIMULPF00001	34	38	38	34	4	0
8373	RV_pair3373	FakeDesc3373	FakeAnc3373	SIMULPF00001	74	80	82	72	8	2
8374	RV_pair3374	FakeDesc3374	FakeAnc3374	SIMULPF00001	51	51	57	45	6	6
8375	RV_pair3375	FakeDesc3375	FakeAnc3375	SIMULPF00001	695	709	780	624	85	71
8376	RV_pair3376	FakeDesc3376	FakeAnc3376	SIMULPF00001	157	149	166	140	9	17
8377	RV_pair3377	FakeDesc3377	FakeAnc3377	SIMULPF00001	92	91	98	85	6	7
8378	RV_pair3378	FakeDesc3378	FakeAnc3378	SIMULPF00001	189	209	225	173	36	16
8379	RV_pair3379	FakeDesc3379	FakeAnc3379	SIMULPF00001	537	529	582	484	45	53
8380	RV_pair3380	FakeDesc3380	FakeAnc3380	SIMULPF00001	290	286	315	261	25	29
8381	RV_pair3381	FakeDesc3381	FakeAnc3381	SIMULPF00001	31	26	33	24	2	7
8382	RV_pair3382	FakeDesc3382	FakeAnc3382	SIMULPF00001	16	17	18	15	2	1
8383	RV_pair3383	FakeDesc3383	FakeAnc3383	SIMULPF00001	412	419	465	366	53	46
8384	RV_pair3384	FakeDesc3384	FakeAnc3384	SIMULPF00001	41	41	47	35	6	6
8385	RV_pair3385	FakeDesc3385	FakeAnc3385	SIMULPF00001	518	513	562	469	44	49
8386	RV_pair3386	FakeDesc3386	FakeAnc3386	SIMULPF00001	260	261	285	236	25	24
8387	RV_pair3387	FakeDesc3387	FakeAnc3387	SIMULPF00001	348	352	381	319	33	29
8388	RV_pair3388	FakeDesc3388	FakeAnc3388	SIMULPF00001	158	159	175	142	17	16
8389	RV_pair3389	FakeDesc3389	FakeAnc3389	SIMULPF00001	39	37	43	33	4	6
8390	RV_pair3390	FakeDesc3390	FakeAnc3390	SIMULPF00001	145	150	163	132	18	13
8391	RV_pair3391	FakeDesc3391	FakeAnc3391	SIMULPF00001	428	442	476	394	48	34
8392	RV_pair3392	FakeDesc3392	FakeAnc3392	SIMULPF00001	227	219	246	200	19	27
8393	RV_pair3393	FakeDesc3393	FakeAnc3393	SIMULPF00001	165	163	177	151	12	14
8394	RV_pair3394	FakeDesc3394	FakeAnc3394	SIMULPF00001	142	134	157	119	15	23
8395	RV_pair3395	FakeDesc3395	FakeAnc3395	SIMULPF00001	232	240	261	211	29	21
8396	RV_pair3396	FakeDesc3396	FakeAnc3396	SIMULPF00001	332	320	354	298	22	34
8397	RV_pair3397	FakeDesc3397	FakeAnc3397	SIMULPF00001	101	96	113	84	12	17
8398	RV_pair3398	FakeDesc3398	FakeAnc3398	SIMULPF00001	888	896	972	812	84	76
8399	RV_pair3399	FakeDesc3399	FakeAnc3399	SIMULPF00001	276	280	299	257	23	19
8400	RV_pair3400	FakeDesc3400	FakeAnc3400	SIMULPF00001	49	52	54	47	5	2
8401	RV_pair3401	FakeDesc3401	FakeAnc3401	SIMULPF00001	10	11	11	10	1	0
8402	RV_pair3402	FakeDesc3402	FakeAnc3402	SIMULPF00001	322	322	349	295	27	27
8403	RV_pair3403	FakeDesc3403	FakeAnc3403	SIMULPF00001	6	8	8	6	2	0
8404	RV_pair3404	FakeDesc3404	FakeAnc3404	SIMULPF00001	239	252	274	217	35	22
8405	RV_pair3405	FakeDesc3405	FakeAnc3405	SIMULPF00001	204	212	225	191	21	13
8406	RV_pair3406	FakeDesc3406	FakeAnc3406	SIMULPF00001	90	96	97	89	7	1
8407	RV_pair3407	FakeDesc3407	FakeAnc3407	SIMULPF00001	376	375	407	344	31	32
8408	RV_pair3408	FakeDesc3408	FakeAnc3408	SIMULPF00001	461	449	496	414	35	47
8409	RV_pair3409	FakeDesc3409	FakeAnc3409	SIMULPF00001	776	773	833	716	57	60
8410	RV_pair3410	FakeDesc3410	FakeAnc3410	SIMULPF00001	78	78	83	73	5	5
8411	RV_pair3411	FakeDesc3411	FakeAnc3411	SIMULPF00001	113	122	125	110	12	3
8412	RV_pair3412	FakeDesc3412	FakeAnc3412	SIMULPF00001	195	196	215	176	20	19
8413	RV_pair3413	FakeDesc3413	FakeAnc3413	SIMULPF00001	449	438	471	416	22	33
8414	RV_pair3414	FakeDesc3414	FakeAnc3414	SIMULPF00001	44	43	46	41	2	3
8415	RV_pair3415	FakeDesc3415	FakeAnc3415	SIMULPF00001	82	85	93	74	11	8
8416	RV_pair3416	FakeDesc3416	FakeAnc3416	SIMULPF00001	156	144	165	135	9	21
8417	RV_pair3417	FakeDesc3417	FakeAnc3417	SIMULPF00001	198	202	221	179	23	19
8418	RV_pair3418	FakeDesc3418	FakeAnc3418	SIMULPF00001	505	501	542	464	37	41
8419	RV_pair3419	FakeDesc3419	FakeAnc3419	SIMULPF00001	68	58	71	55	3	13
8420	RV_pair3420	FakeDesc3420	FakeAnc3420	SIMULPF00001	70	71	75	66	5	4
8421	RV_pair3421	FakeDesc3421	FakeAnc3421	SIMULPF00001	515	501	553	463	38	52
8422	RV_pair3422	FakeDesc3422	FakeAnc3422	SIMULPF00001	91	95	100	86	9	5
8423	RV_pair3423	FakeDesc3423	FakeAnc3423	SIMULPF00001	473	476	507	442	34	31
8424	RV_pair3424	FakeDesc3424	FakeAnc3424	SIMULPF00001	89	86	92	83	3	6
8425	RV_pair3425	FakeDesc3425	FakeAnc3425	SIMULPF00001	5	5	6	4	1	1
8426	RV_pair3426	FakeDesc3426	FakeAnc3426	SIMULPF00001	99	101	105	95	6	4
8427	RV_pair3427	FakeDesc3427	FakeAnc3427	SIMULPF00001	227	221	248	200	21	27
8428	RV_pair3428	FakeDesc3428	FakeAnc3428	SIMULPF00001	36	38	40	34	4	2
8429	RV_pair3429	FakeDesc3429	FakeAnc3429	SIMULPF00001	4	5	5	4	1	0
8430	RV_pair3430	FakeDesc3430	FakeAnc3430	SIMULPF00001	115	110	124	101	9	14
8431	RV_pair3431	FakeDesc3431	FakeAnc3431	SIMULPF00001	31	35	36	30	5	1
8432	RV_pair3432	FakeDesc3432	FakeAnc3432	SIMULPF00001	188	194	215	167	27	21
8433	RV_pair3433	FakeDesc3433	FakeAnc3433	SIMULPF00001	214	212	234	192	20	22
8434	RV_pair3434	FakeDesc3434	FakeAnc3434	SIMULPF00001	153	160	166	147	13	6
8435	RV_pair3435	FakeDesc3435	FakeAnc3435	SIMULPF00001	150	146	160	136	10	14
8436	RV_pair3436	FakeDesc3436	FakeAnc3436	SIMULPF00001	266	271	288	249	22	17
8437	RV_pair3437	FakeDesc3437	FakeAnc3437	SIMULPF00001	96	95	103	88	7	8
8438	RV_pair3438	FakeDesc3438	FakeAnc3438	SIMULPF00001	33	36	36	33	3	0
8439	RV_pair3439	FakeDesc3439	FakeAnc3439	SIMULPF00001	599	597	661	535	62	64
8440	RV_pair3440	FakeDesc3440	FakeAnc3440	SIMULPF00001	19	16	19	16	0	3
8441	RV_pair3441	FakeDesc3441	FakeAnc3441	SIMULPF00001	130	136	142	124	12	6
8442	RV_pair3442	FakeDesc3442	FakeAnc3442	SIMULPF00001	156	170	183	143	27	13
8443	RV_pair3443	FakeDesc3443	FakeAnc3443	SIMULPF00001	300	294	325	269	25	31
8444	RV_pair3444	FakeDesc3444	FakeAnc3444	SIMULPF00001	201	206	221	186	20	15
8445	RV_pair3445	FakeDesc3445	FakeAnc3445	SIMULPF00001	347	359	383	323	36	24
8446	RV_pair3446	FakeDesc3446	FakeAnc3446	SIMULPF00001	48	46	50	44	2	4
8447	RV_pair3447	FakeDesc3447	FakeAnc3447	SIMULPF00001	666	677	741	602	75	64
8448	RV_pair3448	FakeDesc3448	FakeAnc3448	SIMULPF00001	331	335	372	294	41	37
8449	RV_pair3449	FakeDesc3449	FakeAnc3449	SIMULPF00001	69	73	77	65	8	4
8450	RV_pair3450	FakeDesc3450	FakeAnc3450	SIMULPF00001	479	486	532	433	53	46
8451	RV_pair3451	FakeDesc3451	FakeAnc3451	SIMULPF00001	259	260	292	227	33	32
8452	RV_pair3452	FakeDesc3452	FakeAnc3452	SIMULPF00001	170	158	177	151	7	19
8453	RV_pair3453	FakeDesc3453	FakeAnc3453	SIMULPF00001	12	12	12	12	0	0
8454	RV_pair3454	FakeDesc3454	FakeAnc3454	SIMULPF00001	121	125	138	108	17	13
8455	RV_pair3455	FakeDesc3455	FakeAnc3455	SIMULPF00001	241	252	284	209	43	32
8456	RV_pair3456	FakeDesc3456	FakeAnc3456	SIMULPF00001	23	23	24	22	1	1
8457	RV_pair3457	FakeDesc3457	FakeAnc3457	SIMULPF00001	93	87	102	78	9	15
8458	RV_pair3458	FakeDesc3458	FakeAnc3458	SIMULPF00001	617	614	674	557	57	60
8459	RV_pair3459	FakeDesc3459	FakeAnc3459	SIMULPF00001	108	110	116	102	8	6
8460	RV_pair3460	FakeDesc3460	FakeAnc3460	SIMULPF00001	425	420	459	386	34	39
8461	RV_pair3461	FakeDesc3461	FakeAnc3461	SIMULPF00001	119	121	132	108	13	11
8462	RV_pair3462	FakeDesc3462	FakeAnc3462	SIMULPF00001	204	193	222	175	18	29
8463	RV_pair3463	FakeDesc3463	FakeAnc3463	SIMULPF00001	38	39	40	37	2	1
8464	RV_pair3464	FakeDesc3464	FakeAnc3464	SIMULPF00001	590	586	644	532	54	58
8465	RV_pair3465	FakeDesc3465	FakeAnc3465	SIMULPF00001	210	217	233	194	23	16
8466	RV_pair3466	FakeDesc3466	FakeAnc3466	SIMULPF00001	186	186	198	174	12	12
8467	RV_pair3467	FakeDesc3467	FakeAnc3467	SIMULPF00001	314	305	335	284	21	30
8468	RV_pair3468	FakeDesc3468	FakeAnc3468	SIMULPF00001	263	254	286	231	23	32
8469	RV_pair3469	FakeDesc3469	FakeAnc3469	SIMULPF00001	165	154	176	143	11	22
8470	RV_pair3470	FakeDesc3470	FakeAnc3470	SIMULPF00001	95	87	99	83	4	12
8471	RV_pair3471	FakeDesc3471	FakeAnc3471	SIMULPF00001	445	457	497	405	52	40
8472	RV_pair3472	FakeDesc3472	FakeAnc3472	SIMULPF00001	49	51	57	43	8	6
8473	RV_pair3473	FakeDesc3473	FakeAnc3473	SIMULPF00001	158	169	178	149	20	9
8474	RV_pair3474	FakeDesc3474	FakeAnc3474	SIMULPF00001	654	653	713	594	59	60
8475	RV_pair3475	FakeDesc3475	FakeAnc3475	SIMULPF00001	138	141	148	131	10	7
8476	RV_pair3476	FakeDesc3476	FakeAnc3476	SIMULPF00001	77	73	81	69	4	8
8477	RV_pair3477	FakeDesc3477	FakeAnc3477	SIMULPF00001	816	815	888	743	72	73
8478	RV_pair3478	FakeDesc3478	FakeAnc3478	SIMULPF00001	355	350	386	319	31	36
8479	RV_pair3479	FakeDesc3479	FakeAnc3479	SIMULPF00001	83	82	95	70	12	13
8480	RV_pair3480	FakeDesc3480	FakeAnc3480	SIMULPF00001	214	214	237	191	23	23
8481	RV_pair3481	FakeDesc3481	FakeAnc3481	SIMULPF00001	78	78	83	73	5	5
8482	RV_pair3482	FakeDesc3482	FakeAnc3482	SIMULPF00001	216	232	246	202	30	14
8483	RV_pair3483	FakeDesc3483	FakeAnc3483	SIMULPF00001	46	45	46	45	0	1
8484	RV_pair3484	FakeDesc3484	FakeAnc3484	SIMULPF00001	434	434	464	404	30	30
8485	RV_pair3485	FakeDesc3485	FakeAnc3485	SIMULPF00001	57	58	65	50	8	7
8486	RV_pair3486	FakeDesc3486	FakeAnc3486	SIMULPF00001	480	473	514	439	34	41
8487	RV_pair3487	FakeDesc3487	FakeAnc3487	SIMULPF00001	204	213	227	190	23	14
8488	RV_pair3488	FakeDesc3488	FakeAnc3488	SIMULPF00001	29	31	31	29	2	0
8489	RV_pair3489	FakeDesc3489	FakeAnc3489	SIMULPF00001	224	228	251	201	27	23
8490	RV_pair3490	FakeDesc3490	FakeAnc3490	SIMULPF00001	205	206	228	183	23	22
8491	RV_pair3491	FakeDesc3491	FakeAnc3491	SIMULPF00001	32	29	34	27	2	5
8492	RV_pair3492	FakeDesc3492	FakeAnc3492	SIMULPF00001	779	791	863	707	84	72
8493	RV_pair3493	FakeDesc3493	FakeAnc3493	SIMULPF00001	71	80	81	70	10	1
8494	RV_pair3494	FakeDesc3494	FakeAnc3494	SIMULPF00001	31	29	31	29	0	2
8495	RV_pair3495	FakeDesc3495	FakeAnc3495	SIMULPF00001	24	25	30	19	6	5
8496	RV_pair3496	FakeDesc3496	FakeAnc3496	SIMULPF00001	75	76	85	66	10	9
8497	RV_pair3497	FakeDesc3497	FakeAnc3497	SIMULPF00001	648	633	697	584	49	64
8498	RV_pair3498	FakeDesc3498	FakeAnc3498	SIMULPF00001	112	113	126	99	14	13
8499	RV_pair3499	FakeDesc3499	FakeAnc3499	SIMULPF00001	164	173	181	156	17	8
8500	RV_pair3500	FakeDesc3500	FakeAnc3500	SIMULPF00001	164	173	187	150	23	14
8501	RV_pair3501	FakeDesc3501	FakeAnc3501	SIMULPF00001	32	32	35	29	3	3
8502	RV_pair3502	FakeDesc3502	FakeAnc3502	SIMULPF00001	5	5	5	5	0	0
8503	RV_pair3503	FakeDesc3503	FakeAnc3503	SIMULPF00001	137	133	147	123	10	14
8504	RV_pair3504	FakeDesc3504	FakeAnc3504	SIMULPF00001	75	77	82	70	7	5
8505	RV_pair3505	FakeDesc3505	FakeAnc3505	SIMULPF00001	409	408	448	369	39	40
8506	RV_pair3506	FakeDesc3506	FakeAnc3506	SIMULPF00001	140	145	151	134	11	6
8507	RV_pair3507	FakeDesc3507	FakeAnc3507	SIMULPF00001	290	285	307	268	17	22
8508	RV_pair3508	FakeDesc3508	FakeAnc3508	SIMULPF00001	176	181	196	161	20	15
8509	RV_pair3509	FakeDesc3509	FakeAnc3509	SIMULPF00001	208	212	230	190	22	18
8510	RV_pair3510	FakeDesc3510	FakeAnc3510	SIMULPF00001	517	517	553	481	36	36
8511	RV_pair3511	FakeDesc3511	FakeAnc3511	SIMULPF00001	475	460	521	414	46	61
8512	RV_pair3512	FakeDesc3512	FakeAnc3512	SIMULPF00001	24	22	24	22	0	2
8513	RV_pair3513	FakeDesc3513	FakeAnc3513	SIMULPF00001	381	358	402	337	21	44
8514	RV_pair3514	FakeDesc3514	FakeAnc3514	SIMULPF00001	227	233	255	205	28	22
8515	RV_pair3515	FakeDesc3515	FakeAnc3515	SIMULPF00001	65	65	74	56	9	9
8516	RV_pair3516	FakeDesc3516	FakeAnc3516	SIMULPF00001	7	7	7	7	0	0
8517	RV_pair3517	FakeDesc3517	FakeAnc3517	SIMULPF00001	57	55	60	52	3	5
8518	RV_pair3518	FakeDesc3518	FakeAnc3518	SIMULPF00001	64	70	71	63	7	1
8519	RV_pair3519	FakeDesc3519	FakeAnc3519	SIMULPF00001	891	884	975	800	84	91
8520	RV_pair3520	FakeDesc3520	FakeAnc3520	SIMULPF00001	151	156	171	136	20	15
8521	RV_pair3521	FakeDesc3521	FakeAnc3521	SIMULPF00001	107	123	131	99	24	8
8522	RV_pair3522	FakeDesc3522	FakeAnc3522	SIMULPF00001	8	8	10	6	2	2
8523	RV_pair3523	FakeDesc3523	FakeAnc3523	SIMULPF00001	449	444	484	409	35	40
8524	RV_pair3524	FakeDesc3524	FakeAnc3524	SIMULPF00001	138	135	149	124	11	14
8525	RV_pair3525	FakeDesc3525	FakeAnc3525	SIMULPF00001	27	25	28	24	1	3
8526	RV_pair3526	FakeDesc3526	FakeAnc3526	SIMULPF00001	109	111	121	99	12	10
8527	RV_pair3527	FakeDesc3527	FakeAnc3527	SIMULPF00001	187	170	196	161	9	26
8528	RV_pair3528	FakeDesc3528	FakeAnc3528	SIMULPF00001	67	63	70	60	3	7
8529	RV_pair3529	FakeDesc3529	FakeAnc3529	SIMULPF00001	260	264	285	239	25	21
8530	RV_pair3530	FakeDesc3530	FakeAnc3530	SIMULPF00001	683	701	746	638	63	45
8531	RV_pair3531	FakeDesc3531	FakeAnc3531	SIMULPF00001	133	138	149	122	16	11
8532	RV_pair3532	FakeDesc3532	FakeAnc3532	SIMULPF00001	1	1	1	1	0	0
8533	RV_pair3533	FakeDesc3533	FakeAnc3533	SIMULPF00001	43	42	44	41	1	2
8534	RV_pair3534	FakeDesc3534	FakeAnc3534	SIMULPF00001	219	225	243	201	24	18
8535	RV_pair3535	FakeDesc3535	FakeAnc3535	SIMULPF00001	248	239	265	222	17	26
8536	RV_pair3536	FakeDesc3536	FakeAnc3536	SIMULPF00001	435	444	484	395	49	40
8537	RV_pair3537	FakeDesc3537	FakeAnc3537	SIMULPF00001	780	802	873	709	93	71
8538	RV_pair3538	FakeDesc3538	FakeAnc3538	SIMULPF00001	149	160	169	140	20	9
8539	RV_pair3539	FakeDesc3539	FakeAnc3539	SIMULPF00001	164	166	179	151	15	13
8540	RV_pair3540	FakeDesc3540	FakeAnc3540	SIMULPF00001	10	9	11	8	1	2
8541	RV_pair3541	FakeDesc3541	FakeAnc3541	SIMULPF00001	650	654	720	584	70	66
8542	RV_pair3542	FakeDesc3542	FakeAnc3542	SIMULPF00001	550	559	605	504	55	46
8543	RV_pair3543	FakeDesc3543	FakeAnc3543	SIMULPF00001	43	45	48	40	5	3
8544	RV_pair3544	FakeDesc3544	FakeAnc3544	SIMULPF00001	34	35	40	29	6	5
8545	RV_pair3545	FakeDesc3545	FakeAnc3545	SIMULPF00001	162	162	171	153	9	9
8546	RV_pair3546	FakeDesc3546	FakeAnc3546	SIMULPF00001	145	152	164	133	19	12
8547	RV_pair3547	FakeDesc3547	FakeAnc3547	SIMULPF00001	682	694	760	616	78	66
8548	RV_pair3548	FakeDesc3548	FakeAnc3548	SIMULPF00001	351	363	402	312	51	39
8549	RV_pair3549	FakeDesc3549	FakeAnc3549	SIMULPF00001	27	24	27	24	0	3
8550	RV_pair3550	FakeDesc3550	FakeAnc3550	SIMULPF00001	633	623	702	554	69	79
8551	RV_pair3551	FakeDesc3551	FakeAnc3551	SIMULPF00001	279	293	311	261	32	18
8552	RV_pair3552	FakeDesc3552	FakeAnc3552	SIMULPF00001	213	211	224	200	11	13
8553	RV_pair3553	FakeDesc3553	FakeAnc3553	SIMULPF00001	534	538	590	482	56	52
8554	RV_pair3554	FakeDesc3554	FakeAnc3554	SIMULPF00001	162	151	172	141	10	21
8555	RV_pair3555	FakeDesc3555	FakeAnc3555	SIMULPF00001	78	81	90	69	12	9
8556	RV_pair3556	FakeDesc3556	FakeAnc3556	SIMULPF00001	30	31	33	28	3	2
8557	RV_pair3557	FakeDesc3557	FakeAnc3557	SIMULPF00001	232	229	250	211	18	21
8558	RV_pair3558	FakeDesc3558	FakeAnc3558	SIMULPF00001	135	126	146	115	11	20
8559	RV_pair3559	FakeDesc3559	FakeAnc3559	SIMULPF00001	106	100	110	96	4	10
8560	RV_pair3560	FakeDesc3560	FakeAnc3560	SIMULPF00001	242	254	273	223	31	19
8561	RV_pair3561	FakeDesc3561	FakeAnc3561	SIMULPF00001	422	406	455	373	33	49
8562	RV_pair3562	FakeDesc3562	FakeAnc3562	SIMULPF00001	42	47	47	42	5	0
8563	RV_pair3563	FakeDesc3563	FakeAnc3563	SIMULPF00001	144	129	155	118	11	26
8564	RV_pair3564	FakeDesc3564	FakeAnc3564	SIMULPF00001	23	29	29	23	6	0
8565	RV_pair3565	FakeDesc3565	FakeAnc3565	SIMULPF00001	81	72	85	68	4	13
8566	RV_pair3566	FakeDesc3566	FakeAnc3566	SIMULPF00001	124	127	137	114	13	10
8567	RV_pair3567	FakeDesc3567	FakeAnc3567	SIMULPF00001	398	392	430	360	32	38
8568	RV_pair3568	FakeDesc3568	FakeAnc3568	SIMULPF00001	452	437	482	407	30	45
8569	RV_pair3569	FakeDesc3569	FakeAnc3569	SIMULPF00001	807	796	875	728	68	79
8570	RV_pair3570	FakeDesc3570	FakeAnc3570	SIMULPF00001	12	12	13	11	1	1
8571	RV_pair3571	FakeDesc3571	FakeAnc3571	SIMULPF00001	518	527	570	475	52	43
8572	RV_pair3572	FakeDesc3572	FakeAnc3572	SIMULPF00001	362	341	382	321	20	41
8573	RV_pair3573	FakeDesc3573	FakeAnc3573	SIMULPF00001	94	95	104	85	10	9
8574	RV_pair3574	FakeDesc3574	FakeAnc3574	SIMULPF00001	204	204	221	187	17	17
8575	RV_pair3575	FakeDesc3575	FakeAnc3575	SIMULPF00001	116	119	133	102	17	14
8576	RV_pair3576	FakeDesc3576	FakeAnc3576	SIMULPF00001	27	24	28	23	1	4
8577	RV_pair3577	FakeDesc3577	FakeAnc3577	SIMULPF00001	94	93	103	84	9	10
8578	RV_pair3578	FakeDesc3578	FakeAnc3578	SIMULPF00001	49	43	53	39	4	10
8579	RV_pair3579	FakeDesc3579	FakeAnc3579	SIMULPF00001	187	187	203	171	16	16
8580	RV_pair3580	FakeDesc3580	FakeAnc3580	SIMULPF00001	99	102	108	93	9	6
8581	RV_pair3581	FakeDesc3581	FakeAnc3581	SIMULPF00001	284	290	315	259	31	25
8582	RV_pair3582	FakeDesc3582	FakeAnc3582	SIMULPF00001	20	17	20	17	0	3
8583	RV_pair3583	FakeDesc3583	FakeAnc3583	SIMULPF00001	60	63	65	58	5	2
8584	RV_pair3584	FakeDesc3584	FakeAnc3584	SIMULPF00001	56	61	65	52	9	4
8585	RV_pair3585	FakeDesc3585	FakeAnc3585	SIMULPF00001	136	135	149	122	13	14
8586	RV_pair3586	FakeDesc3586	FakeAnc3586	SIMULPF00001	560	562	614	508	54	52
8587	RV_pair3587	FakeDesc3587	FakeAnc3587	SIMULPF00001	52	47	54	45	2	7
8588	RV_pair3588	FakeDesc3588	FakeAnc3588	SIMULPF00001	103	104	110	97	7	6
8589	RV_pair3589	FakeDesc3589	FakeAnc3589	SIMULPF00001	201	206	226	181	25	20
8590	RV_pair3590	FakeDesc3590	FakeAnc3590	SIMULPF00001	91	90	101	80	10	11
8591	RV_pair3591	FakeDesc3591	FakeAnc3591	SIMULPF00001	294	292	317	269	23	25
8592	RV_pair3592	FakeDesc3592	FakeAnc3592	SIMULPF00001	358	357	391	324	33	34
8593	RV_pair3593	FakeDesc3593	FakeAnc3593	SIMULPF00001	97	96	111	82	14	15
8594	RV_pair3594	FakeDesc3594	FakeAnc3594	SIMULPF00001	675	692	753	614	78	61
8595	RV_pair3595	FakeDesc3595	FakeAnc3595	SIMULPF00001	39	38	40	37	1	2
8596	RV_pair3596	FakeDesc3596	FakeAnc3596	SIMULPF00001	39	42	43	38	4	1
8597	RV_pair3597	FakeDesc3597	FakeAnc3597	SIMULPF00001	375	373	412	336	37	39
8598	RV_pair3598	FakeDesc3598	FakeAnc3598	SIMULPF00001	138	133	148	123	10	15
8599	RV_pair3599	FakeDesc3599	FakeAnc3599	SIMULPF00001	115	108	123	100	8	15
8600	RV_pair3600	FakeDesc3600	FakeAnc3600	SIMULPF00001	316	319	349	286	33	30
8601	RV_pair3601	FakeDesc3601	FakeAnc3601	SIMULPF00001	586	587	638	535	52	51
8602	RV_pair3602	FakeDesc3602	FakeAnc3602	SIMULPF00001	588	591	653	526	65	62
8603	RV_pair3603	FakeDesc3603	FakeAnc3603	SIMULPF00001	30	27	30	27	0	3
8604	RV_pair3604	FakeDesc3604	FakeAnc3604	SIMULPF00001	90	88	94	84	4	6
8605	RV_pair3605	FakeDesc3605	FakeAnc3605	SIMULPF00001	382	388	423	347	41	35
8606	RV_pair3606	FakeDesc3606	FakeAnc3606	SIMULPF00001	29	26	31	24	2	5
8607	RV_pair3607	FakeDesc3607	FakeAnc3607	SIMULPF00001	23	22	24	21	1	2
8608	RV_pair3608	FakeDesc3608	FakeAnc3608	SIMULPF00001	414	390	447	357	33	57
8609	RV_pair3609	FakeDesc3609	FakeAnc3609	SIMULPF00001	22	23	24	21	2	1
8610	RV_pair3610	FakeDesc3610	FakeAnc3610	SIMULPF00001	161	165	182	144	21	17
8611	RV_pair3611	FakeDesc3611	FakeAnc3611	SIMULPF00001	407	397	433	371	26	36
8612	RV_pair3612	FakeDesc3612	FakeAnc3612	SIMULPF00001	88	85	92	81	4	7
8613	RV_pair3613	FakeDesc3613	FakeAnc3613	SIMULPF00001	483	462	523	422	40	61
8614	RV_pair3614	FakeDesc3614	FakeAnc3614	SIMULPF00001	81	85	93	73	12	8
8615	RV_pair3615	FakeDesc3615	FakeAnc3615	SIMULPF00001	17	20	20	17	3	0
8616	RV_pair3616	FakeDesc3616	FakeAnc3616	SIMULPF00001	30	28	32	26	2	4
8617	RV_pair3617	FakeDesc3617	FakeAnc3617	SIMULPF00001	159	157	170	146	11	13
8618	RV_pair3618	FakeDesc3618	FakeAnc3618	SIMULPF00001	28	30	32	26	4	2
8619	RV_pair3619	FakeDesc3619	FakeAnc3619	SIMULPF00001	58	59	63	54	5	4
8620	RV_pair3620	FakeDesc3620	FakeAnc3620	SIMULPF00001	13	14	15	12	2	1
8621	RV_pair3621	FakeDesc3621	FakeAnc3621	SIMULPF00001	231	238	260	209	29	22
8622	RV_pair3622	FakeDesc3622	FakeAnc3622	SIMULPF00001	429	421	465	385	36	44
8623	RV_pair3623	FakeDesc3623	FakeAnc3623	SIMULPF00001	340	328	367	301	27	39
8624	RV_pair3624	FakeDesc3624	FakeAnc3624	SIMULPF00001	137	133	151	119	14	18
8625	RV_pair3625	FakeDesc3625	FakeAnc3625	SIMULPF00001	453	460	502	411	49	42
8626	RV_pair3626	FakeDesc3626	FakeAnc3626	SIMULPF00001	59	57	65	51	6	8
8627	RV_pair3627	FakeDesc3627	FakeAnc3627	SIMULPF00001	85	79	89	75	4	10
8628	RV_pair3628	FakeDesc3628	FakeAnc3628	SIMULPF00001	205	219	226	198	21	7
8629	RV_pair3629	FakeDesc3629	FakeAnc3629	SIMULPF00001	262	262	287	237	25	25
8630	RV_pair3630	FakeDesc3630	FakeAnc3630	SIMULPF00001	846	871	945	772	99	74
8631	RV_pair3631	FakeDesc3631	FakeAnc3631	SIMULPF00001	473	472	514	431	41	42
8632	RV_pair3632	FakeDesc3632	FakeAnc3632	SIMULPF00001	345	326	371	300	26	45
8633	RV_pair3633	FakeDesc3633	FakeAnc3633	SIMULPF00001	216	207	228	195	12	21
8634	RV_pair3634	FakeDesc3634	FakeAnc3634	SIMULPF00001	383	397	422	358	39	25
8635	RV_pair3635	FakeDesc3635	FakeAnc3635	SIMULPF00001	347	377	408	316	61	31
8636	RV_pair3636	FakeDesc3636	FakeAnc3636	SIMULPF00001	648	645	708	585	60	63
8637	RV_pair3637	FakeDesc3637	FakeAnc3637	SIMULPF00001	548	527	597	478	49	70
8638	RV_pair3638	FakeDesc3638	FakeAnc3638	SIMULPF00001	348	346	385	309	37	39
8639	RV_pair3639	FakeDesc3639	FakeAnc3639	SIMULPF00001	281	291	311	261	30	20
8640	RV_pair3640	FakeDesc3640	FakeAnc3640	SIMULPF00001	169	177	187	159	18	10
8641	RV_pair3641	FakeDesc3641	FakeAnc3641	SIMULPF00001	51	55	57	49	6	2
8642	RV_pair3642	FakeDesc3642	FakeAnc3642	SIMULPF00001	254	259	286	227	32	27
8643	RV_pair3643	FakeDesc3643	FakeAnc3643	SIMULPF00001	35	37	39	33	4	2
8644	RV_pair3644	FakeDesc3644	FakeAnc3644	SIMULPF00001	749	732	823	658	74	91
8645	RV_pair3645	FakeDesc3645	FakeAnc3645	SIMULPF00001	170	179	196	153	26	17
8646	RV_pair3646	FakeDesc3646	FakeAnc3646	SIMULPF00001	278	275	302	251	24	27
8647	RV_pair3647	FakeDesc3647	FakeAnc3647	SIMULPF00001	138	131	150	119	12	19
8648	RV_pair3648	FakeDesc3648	FakeAnc3648	SIMULPF00001	82	80	87	75	5	7
8649	RV_pair3649	FakeDesc3649	FakeAnc3649	SIMULPF00001	468	496	528	436	60	32
8650	RV_pair3650	FakeDesc3650	FakeAnc3650	SIMULPF00001	231	235	253	213	22	18
8651	RV_pair3651	FakeDesc3651	FakeAnc3651	SIMULPF00001	207	205	228	184	21	23
8652	RV_pair3652	FakeDesc3652	FakeAnc3652	SIMULPF00001	64	64	71	57	7	7
8653	RV_pair3653	FakeDesc3653	FakeAnc3653	SIMULPF00001	211	199	225	185	14	26
8654	RV_pair3654	FakeDesc3654	FakeAnc3654	SIMULPF00001	35	31	37	29	2	6
8655	RV_pair3655	FakeDesc3655	FakeAnc3655	SIMULPF00001	44	43	47	40	3	4
8656	RV_pair3656	FakeDesc3656	FakeAnc3656	SIMULPF00001	344	346	378	312	34	32
8657	RV_pair3657	FakeDesc3657	FakeAnc3657	SIMULPF00001	424	439	479	384	55	40
8658	RV_pair3658	FakeDesc3658	FakeAnc3658	SIMULPF00001	442	428	475	395	33	47
8659	RV_pair3659	FakeDesc3659	FakeAnc3659	SIMULPF00001	426	409	456	379	30	47
8660	RV_pair3660	FakeDesc3660	FakeAnc3660	SIMULPF00001	228	225	243	210	15	18
8661	RV_pair3661	FakeDesc3661	FakeAnc3661	SIMULPF00001	281	288	318	251	37	30
8662	RV_pair3662	FakeDesc3662	FakeAnc3662	SIMULPF00001	84	86	93	77	9	7
8663	RV_pair3663	FakeDesc3663	FakeAnc3663	SIMULPF00001	4	4	4	4	0	0
8664	RV_pair3664	FakeDesc3664	FakeAnc3664	SIMULPF00001	356	342	388	310	32	46
8665	RV_pair3665	FakeDesc3665	FakeAnc3665	SIMULPF00001	61	62	70	53	9	8
8666	RV_pair3666	FakeDesc3666	FakeAnc3666	SIMULPF00001	37	37	41	33	4	4
8667	RV_pair3667	FakeDesc3667	FakeAnc3667	SIMULPF00001	137	141	148	130	11	7
8668	RV_pair3668	FakeDesc3668	FakeAnc3668	SIMULPF00001	19	17	20	16	1	3
8669	RV_pair3669	FakeDesc3669	FakeAnc3669	SIMULPF00001	190	193	205	178	15	12
8670	RV_pair3670	FakeDesc3670	FakeAnc3670	SIMULPF00001	133	137	150	120	17	13
8671	RV_pair3671	FakeDesc3671	FakeAnc3671	SIMULPF00001	64	64	69	59	5	5
8672	RV_pair3672	FakeDesc3672	FakeAnc3672	SIMULPF00001	24	25	26	23	2	1
8673	RV_pair3673	FakeDesc3673	FakeAnc3673	SIMULPF00001	121	119	137	103	16	18
8674	RV_pair3674	FakeDesc3674	FakeAnc3674	SIMULPF00001	373	357	413	317	40	56
8675	RV_pair3675	FakeDesc3675	FakeAnc3675	SIMULPF00001	36	40	41	35	5	1
8676	RV_pair3676	FakeDesc3676	FakeAnc3676	SIMULPF00001	8	8	8	8	0	0
8677	RV_pair3677	FakeDesc3677	FakeAnc3677	SIMULPF00001	92	85	94	83	2	9
8678	RV_pair3678	FakeDesc3678	FakeAnc3678	SIMULPF00001	169	175	186	158	17	11
8679	RV_pair3679	FakeDesc3679	FakeAnc3679	SIMULPF00001	97	89	103	83	6	14
8680	RV_pair3680	FakeDesc3680	FakeAnc3680	SIMULPF00001	34	35	40	29	6	5
8681	RV_pair3681	FakeDesc3681	FakeAnc3681	SIMULPF00001	236	252	269	219	33	17
8682	RV_pair3682	FakeDesc3682	FakeAnc3682	SIMULPF00001	93	94	100	87	7	6
8683	RV_pair3683	FakeDesc3683	FakeAnc3683	SIMULPF00001	183	187	203	167	20	16
8684	RV_pair3684	FakeDesc3684	FakeAnc3684	SIMULPF00001	426	440	483	383	57	43
8685	RV_pair3685	FakeDesc3685	FakeAnc3685	SIMULPF00001	74	79	84	69	10	5
8686	RV_pair3686	FakeDesc3686	FakeAnc3686	SIMULPF00001	6	5	6	5	0	1
8687	RV_pair3687	FakeDesc3687	FakeAnc3687	SIMULPF00001	688	711	773	626	85	62
8688	RV_pair3688	FakeDesc3688	FakeAnc3688	SIMULPF00001	411	406	441	376	30	35
8689	RV_pair3689	FakeDesc3689	FakeAnc3689	SIMULPF00001	156	161	176	141	20	15
8690	RV_pair3690	FakeDesc3690	FakeAnc3690	SIMULPF00001	829	851	929	751	100	78
8691	RV_pair3691	FakeDesc3691	FakeAnc3691	SIMULPF00001	83	83	87	79	4	4
8692	RV_pair3692	FakeDesc3692	FakeAnc3692	SIMULPF00001	80	87	92	75	12	5
8693	RV_pair3693	FakeDesc3693	FakeAnc3693	SIMULPF00001	196	205	220	181	24	15
8694	RV_pair3694	FakeDesc3694	FakeAnc3694	SIMULPF00001	35	33	38	30	3	5
8695	RV_pair3695	FakeDesc3695	FakeAnc3695	SIMULPF00001	97	97	106	88	9	9
8696	RV_pair3696	FakeDesc3696	FakeAnc3696	SIMULPF00001	68	57	72	53	4	15
8697	RV_pair3697	FakeDesc3697	FakeAnc3697	SIMULPF00001	331	339	368	302	37	29
8698	RV_pair3698	FakeDesc3698	FakeAnc3698	SIMULPF00001	218	218	242	194	24	24
8699	RV_pair3699	FakeDesc3699	FakeAnc3699	SIMULPF00001	58	63	64	57	6	1
8700	RV_pair3700	FakeDesc3700	FakeAnc3700	SIMULPF00001	301	298	331	268	30	33
8701	RV_pair3701	FakeDesc3701	FakeAnc3701	SIMULPF00001	7	4	7	4	0	3
8702	RV_pair3702	FakeDesc3702	FakeAnc3702	SIMULPF00001	200	202	217	185	17	15
8703	RV_pair3703	FakeDesc3703	FakeAnc3703	SIMULPF00001	682	706	772	616	90	66
8704	RV_pair3704	FakeDesc3704	FakeAnc3704	SIMULPF00001	16	13	16	13	0	3
8705	RV_pair3705	FakeDesc3705	FakeAnc3705	SIMULPF00001	167	172	181	158	14	9
8706	RV_pair3706	FakeDesc3706	FakeAnc3706	SIMULPF00001	32	28	33	27	1	5
8707	RV_pair3707	FakeDesc3707	FakeAnc3707	SIMULPF00001	32	32	33	31	1	1
8708	RV_pair3708	FakeDesc3708	FakeAnc3708	SIMULPF00001	65	68	70	63	5	2
8709	RV_pair3709	FakeDesc3709	FakeAnc3709	SIMULPF00001	319	326	354	291	35	28
8710	RV_pair3710	FakeDesc3710	FakeAnc3710	SIMULPF00001	197	198	215	180	18	17
8711	RV_pair3711	FakeDesc3711	FakeAnc3711	SIMULPF00001	99	86	105	80	6	19
8712	RV_pair3712	FakeDesc3712	FakeAnc3712	SIMULPF00001	347	350	382	315	35	32
8713	RV_pair3713	FakeDesc3713	FakeAnc3713	SIMULPF00001	774	786	840	720	66	54
8714	RV_pair3714	FakeDesc3714	FakeAnc3714	SIMULPF00001	310	326	347	289	37	21
8715	RV_pair3715	FakeDesc3715	FakeAnc3715	SIMULPF00001	487	494	534	447	47	40
8716	RV_pair3716	FakeDesc3716	FakeAnc3716	SIMULPF00001	162	155	171	146	9	16
8717	RV_pair3717	FakeDesc3717	FakeAnc3717	SIMULPF00001	45	43	51	37	6	8
8718	RV_pair3718	FakeDesc3718	FakeAnc3718	SIMULPF00001	84	84	93	75	9	9
8719	RV_pair3719	FakeDesc3719	FakeAnc3719	SIMULPF00001	21	20	22	19	1	2
8720	RV_pair3720	FakeDesc3720	FakeAnc3720	SIMULPF00001	145	151	163	133	18	12
8721	RV_pair3721	FakeDesc3721	FakeAnc3721	SIMULPF00001	241	241	264	218	23	23
8722	RV_pair3722	FakeDesc3722	FakeAnc3722	SIMULPF00001	48	47	52	43	4	5
8723	RV_pair3723	FakeDesc3723	FakeAnc3723	SIMULPF00001	243	259	280	222	37	21
8724	RV_pair3724	FakeDesc3724	FakeAnc3724	SIMULPF00001	365	367	404	328	39	37
8725	RV_pair3725	FakeDesc3725	FakeAnc3725	SIMULPF00001	128	126	144	110	16	18
8726	RV_pair3726	FakeDesc3726	FakeAnc3726	SIMULPF00001	617	622	669	570	52	47
8727	RV_pair3727	FakeDesc3727	FakeAnc3727	SIMULPF00001	245	251	272	224	27	21
8728	RV_pair3728	FakeDesc3728	FakeAnc3728	SIMULPF00001	498	482	540	440	42	58
8729	RV_pair3729	FakeDesc3729	FakeAnc3729	SIMULPF00001	284	287	317	254	33	30
8730	RV_pair3730	FakeDesc3730	FakeAnc3730	SIMULPF00001	28	26	30	24	2	4
8731	RV_pair3731	FakeDesc3731	FakeAnc3731	SIMULPF00001	468	446	511	403	43	65
8732	RV_pair3732	FakeDesc3732	FakeAnc3732	SIMULPF00001	414	401	443	372	29	42
8733	RV_pair3733	FakeDesc3733	FakeAnc3733	SIMULPF00001	37	38	40	35	3	2
8734	RV_pair3734	FakeDesc3734	FakeAnc3734	SIMULPF00001	87	81	92	76	5	11
8735	RV_pair3735	FakeDesc3735	FakeAnc3735	SIMULPF00001	334	325	362	297	28	37
8736	RV_pair3736	FakeDesc3736	FakeAnc3736	SIMULPF00001	300	280	318	262	18	38
8737	RV_pair3737	FakeDesc3737	FakeAnc3737	SIMULPF00001	95	94	105	84	10	11
8738	RV_pair3738	FakeDesc3738	FakeAnc3738	SIMULPF00001	95	96	103	88	8	7
8739	RV_pair3739	FakeDesc3739	FakeAnc3739	SIMULPF00001	517	522	566	473	49	44
8740	RV_pair3740	FakeDesc3740	FakeAnc3740	SIMULPF00001	7	8	8	7	1	0
8741	RV_pair3741	FakeDesc3741	FakeAnc3741	SIMULPF00001	304	308	326	286	22	18
8742	RV_pair3742	FakeDesc3742	FakeAnc3742	SIMULPF00001	130	122	143	109	13	21
8743	RV_pair3743	FakeDesc3743	FakeAnc3743	SIMULPF00001	208	199	220	187	12	21
8744	RV_pair3744	FakeDesc3744	FakeAnc3744	SIMULPF00001	128	128	140	116	12	12
8745	RV_pair3745	FakeDesc3745	FakeAnc3745	SIMULPF00001	78	77	83	72	5	6
8746	RV_pair3746	FakeDesc3746	FakeAnc3746	SIMULPF00001	344	335	371	308	27	36
8747	RV_pair3747	FakeDesc3747	FakeAnc3747	SIMULPF00001	168	167	184	151	16	17
8748	RV_pair3748	FakeDesc3748	FakeAnc3748	SIMULPF00001	269	264	290	243	21	26
8749	RV_pair3749	FakeDesc3749	FakeAnc3749	SIMULPF00001	97	92	101	88	4	9
8750	RV_pair3750	FakeDesc3750	FakeAnc3750	SIMULPF00001	31	29	31	29	0	2
8751	RV_pair3751	FakeDesc3751	FakeAnc3751	SIMULPF00001	148	150	163	135	15	13
8752	RV_pair3752	FakeDesc3752	FakeAnc3752	SIMULPF00001	437	434	471	400	34	37
8753	RV_pair3753	FakeDesc3753	FakeAnc3753	SIMULPF00001	308	301	333	276	25	32
8754	RV_pair3754	FakeDesc3754	FakeAnc3754	SIMULPF00001	112	119	128	103	16	9
8755	RV_pair3755	FakeDesc3755	FakeAnc3755	SIMULPF00001	418	407	450	375	32	43
8756	RV_pair3756	FakeDesc3756	FakeAnc3756	SIMULPF00001	781	778	865	694	84	87
8757	RV_pair3757	FakeDesc3757	FakeAnc3757	SIMULPF00001	234	235	253	216	19	18
8758	RV_pair3758	FakeDesc3758	FakeAnc3758	SIMULPF00001	24	27	27	24	3	0
8759	RV_pair3759	FakeDesc3759	FakeAnc3759	SIMULPF00001	499	480	538	441	39	58
8760	RV_pair3760	FakeDesc3760	FakeAnc3760	SIMULPF00001	43	42	50	35	7	8
8761	RV_pair3761	FakeDesc3761	FakeAnc3761	SIMULPF00001	116	114	129	101	13	15
8762	RV_pair3762	FakeDesc3762	FakeAnc3762	SIMULPF00001	55	53	61	47	6	8
8763	RV_pair3763	FakeDesc3763	FakeAnc3763	SIMULPF00001	53	53	57	49	4	4
8764	RV_pair3764	FakeDesc3764	FakeAnc3764	SIMULPF00001	24	25	28	21	4	3
8765	RV_pair3765	FakeDesc3765	FakeAnc3765	SIMULPF00001	362	351	385	328	23	34
8766	RV_pair3766	FakeDesc3766	FakeAnc3766	SIMULPF00001	101	100	117	84	16	17
8767	RV_pair3767	FakeDesc3767	FakeAnc3767	SIMULPF00001	46	47	49	44	3	2
8768	RV_pair3768	FakeDesc3768	FakeAnc3768	SIMULPF00001	112	119	127	104	15	8
8769	RV_pair3769	FakeDesc3769	FakeAnc3769	SIMULPF00001	40	39	45	34	5	6
8770	RV_pair3770	FakeDesc3770	FakeAnc3770	SIMULPF00001	355	353	395	313	40	42
8771	RV_pair3771	FakeDesc3771	FakeAnc3771	SIMULPF00001	163	159	180	142	17	21
8772	RV_pair3772	FakeDesc3772	FakeAnc3772	SIMULPF00001	180	188	198	170	18	10
8773	RV_pair3773	FakeDesc3773	FakeAnc3773	SIMULPF00001	41	32	41	32	0	9
8774	RV_pair3774	FakeDesc3774	FakeAnc3774	SIMULPF00001	548	524	586	486	38	62
8775	RV_pair3775	FakeDesc3775	FakeAnc3775	SIMULPF00001	689	663	742	610	53	79
8776	RV_pair3776	FakeDesc3776	FakeAnc3776	SIMULPF00001	49	54	57	46	8	3
8777	RV_pair3777	FakeDesc3777	FakeAnc3777	SIMULPF00001	179	175	186	168	7	11
8778	RV_pair3778	FakeDesc3778	FakeAnc3778	SIMULPF00001	12	9	12	9	0	3
8779	RV_pair3779	FakeDesc3779	FakeAnc3779	SIMULPF00001	11	11	11	11	0	0
8780	RV_pair3780	FakeDesc3780	FakeAnc3780	SIMULPF00001	233	244	261	216	28	17
8781	RV_pair3781	FakeDesc3781	FakeAnc3781	SIMULPF00001	113	107	122	98	9	15
8782	RV_pair3782	FakeDesc3782	FakeAnc3782	SIMULPF00001	172	174	189	157	17	15
8783	RV_pair3783	FakeDesc3783	FakeAnc3783	SIMULPF00001	106	94	113	87	7	19
8784	RV_pair3784	FakeDesc3784	FakeAnc3784	SIMULPF00001	21	19	22	18	1	3
8785	RV_pair3785	FakeDesc3785	FakeAnc3785	SIMULPF00001	21	17	21	17	0	4
8786	RV_pair3786	FakeDesc3786	FakeAnc3786	SIMULPF00001	509	502	553	458	44	51
8787	RV_pair3787	FakeDesc3787	FakeAnc3787	SIMULPF00001	593	591	649	535	56	58
8788	RV_pair3788	FakeDesc3788	FakeAnc3788	SIMULPF00001	519	534	582	471	63	48
8789	RV_pair3789	FakeDesc3789	FakeAnc3789	SIMULPF00001	142	145	157	130	15	12
8790	RV_pair3790	FakeDesc3790	FakeAnc3790	SIMULPF00001	289	298	314	273	25	16
8791	RV_pair3791	FakeDesc3791	FakeAnc3791	SIMULPF00001	310	313	338	285	28	25
8792	RV_pair3792	FakeDesc3792	FakeAnc3792	SIMULPF00001	9	8	9	8	0	1
8793	RV_pair3793	FakeDesc3793	FakeAnc3793	SIMULPF00001	24	22	25	21	1	3
8794	RV_pair3794	FakeDesc3794	FakeAnc3794	SIMULPF00001	182	174	201	155	19	27
8795	RV_pair3795	FakeDesc3795	FakeAnc3795	SIMULPF00001	125	125	136	114	11	11
8796	RV_pair3796	FakeDesc3796	FakeAnc3796	SIMULPF00001	183	165	196	152	13	31
8797	RV_pair3797	FakeDesc3797	FakeAnc3797	SIMULPF00001	697	695	764	628	67	69
8798	RV_pair3798	FakeDesc3798	FakeAnc3798	SIMULPF00001	201	196	221	176	20	25
8799	RV_pair3799	FakeDesc3799	FakeAnc3799	SIMULPF00001	115	121	128	108	13	7
8800	RV_pair3800	FakeDesc3800	FakeAnc3800	SIMULPF00001	253	249	272	230	19	23
8801	RV_pair3801	FakeDesc3801	FakeAnc3801	SIMULPF00001	41	42	45	38	4	3
8802	RV_pair3802	FakeDesc3802	FakeAnc3802	SIMULPF00001	45	45	54	36	9	9
8803	RV_pair3803	FakeDesc3803	FakeAnc3803	SIMULPF00001	354	337	387	304	33	50
8804	RV_pair3804	FakeDesc3804	FakeAnc3804	SIMULPF00001	457	462	498	421	41	36
8805	RV_pair3805	FakeDesc3805	FakeAnc3805	SIMULPF00001	573	592	649	516	76	57
8806	RV_pair3806	FakeDesc3806	FakeAnc3806	SIMULPF00001	9	8	9	8	0	1
8807	RV_pair3807	FakeDesc3807	FakeAnc3807	SIMULPF00001	157	148	170	135	13	22
8808	RV_pair3808	FakeDesc3808	FakeAnc3808	SIMULPF00001	52	52	56	48	4	4
8809	RV_pair3809	FakeDesc3809	FakeAnc3809	SIMULPF00001	33	34	34	33	1	0
8810	RV_pair3810	FakeDesc3810	FakeAnc3810	SIMULPF00001	222	221	243	200	21	22
8811	RV_pair3811	FakeDesc3811	FakeAnc3811	SIMULPF00001	39	45	47	37	8	2
8812	RV_pair3812	FakeDesc3812	FakeAnc3812	SIMULPF00001	300	307	323	284	23	16
8813	RV_pair3813	FakeDesc3813	FakeAnc3813	SIMULPF00001	182	185	197	170	15	12
8814	RV_pair3814	FakeDesc3814	FakeAnc3814	SIMULPF00001	31	29	32	28	1	3
8815	RV_pair3815	FakeDesc3815	FakeAnc3815	SIMULPF00001	161	172	181	152	20	9
8816	RV_pair3816	FakeDesc3816	FakeAnc3816	SIMULPF00001	821	842	913	750	92	71
8817	RV_pair3817	FakeDesc3817	FakeAnc3817	SIMULPF00001	264	269	294	239	30	25
8818	RV_pair3818	FakeDesc3818	FakeAnc3818	SIMULPF00001	43	51	52	42	9	1
8819	RV_pair3819	FakeDesc3819	FakeAnc3819	SIMULPF00001	356	350	388	318	32	38
8820	RV_pair3820	FakeDesc3820	FakeAnc3820	SIMULPF00001	403	389	432	360	29	43
8821	RV_pair3821	FakeDesc3821	FakeAnc3821	SIMULPF00001	586	574	633	527	47	59
8822	RV_pair3822	FakeDesc3822	FakeAnc3822	SIMULPF00001	55	54	58	51	3	4
8823	RV_pair3823	FakeDesc3823	FakeAnc3823	SIMULPF00001	184	180	204	160	20	24
8824	RV_pair3824	FakeDesc3824	FakeAnc3824	SIMULPF00001	56	63	66	53	10	3
8825	RV_pair3825	FakeDesc3825	FakeAnc3825	SIMULPF00001	76	77	82	71	6	5
8826	RV_pair3826	FakeDesc3826	FakeAnc3826	SIMULPF00001	409	413	443	379	34	30
8827	RV_pair3827	FakeDesc3827	FakeAnc3827	SIMULPF00001	24	25	25	24	1	0
8828	RV_pair3828	FakeDesc3828	FakeAnc3828	SIMULPF00001	124	123	136	111	12	13
8829	RV_pair3829	FakeDesc3829	FakeAnc3829	SIMULPF00001	26	30	31	25	5	1
8830	RV_pair3830	FakeDesc3830	FakeAnc3830	SIMULPF00001	3	1	3	1	0	2
8831	RV_pair3831	FakeDesc3831	FakeAnc3831	SIMULPF00001	79	79	86	72	7	7
8832	RV_pair3832	FakeDesc3832	FakeAnc3832	SIMULPF00001	159	147	171	135	12	24
8833	RV_pair3833	FakeDesc3833	FakeAnc3833	SIMULPF00001	206	209	224	191	18	15
8834	RV_pair3834	FakeDesc3834	FakeAnc3834	SIMULPF00001	544	544	594	494	50	50
8835	RV_pair3835	FakeDesc3835	FakeAnc3835	SIMULPF00001	346	357	376	327	30	19
8836	RV_pair3836	FakeDesc3836	FakeAnc3836	SIMULPF00001	744	748	812	680	68	64
8837	RV_pair3837	FakeDesc3837	FakeAnc3837	SIMULPF00001	47	44	51	40	4	7
8838	RV_pair3838	FakeDesc3838	FakeAnc3838	SIMULPF00001	395	397	442	350	47	45
8839	RV_pair3839	FakeDesc3839	FakeAnc3839	SIMULPF00001	456	442	497	401	41	55
8840	RV_pair3840	FakeDesc3840	FakeAnc3840	SIMULPF00001	49	50	53	46	4	3
8841	RV_pair3841	FakeDesc3841	FakeAnc3841	SIMULPF00001	123	128	142	109	19	14
8842	RV_pair3842	FakeDesc3842	FakeAnc3842	SIMULPF00001	504	495	545	454	41	50
8843	RV_pair3843	FakeDesc3843	FakeAnc3843	SIMULPF00001	97	87	104	80	7	17
8844	RV_pair3844	FakeDesc3844	FakeAnc3844	SIMULPF00001	89	95	99	85	10	4
8845	RV_pair3845	FakeDesc3845	FakeAnc3845	SIMULPF00001	72	78	84	66	12	6
8846	RV_pair3846	FakeDesc3846	FakeAnc3846	SIMULPF00001	276	269	296	249	20	27
8847	RV_pair3847	FakeDesc3847	FakeAnc3847	SIMULPF00001	145	136	157	124	12	21
8848	RV_pair3848	FakeDesc3848	FakeAnc3848	SIMULPF00001	80	77	87	70	7	10
8849	RV_pair3849	FakeDesc3849	FakeAnc3849	SIMULPF00001	122	128	136	114	14	8
8850	RV_pair3850	FakeDesc3850	FakeAnc3850	SIMULPF00001	224	237	257	204	33	20
8851	RV_pair3851	FakeDesc3851	FakeAnc3851	SIMULPF00001	88	96	98	86	10	2
8852	RV_pair3852	FakeDesc3852	FakeAnc3852	SIMULPF00001	231	240	261	210	30	21
8853	RV_pair3853	FakeDesc3853	FakeAnc3853	SIMULPF00001	113	114	123	104	10	9
8854	RV_pair3854	FakeDesc3854	FakeAnc3854	SIMULPF00001	294	302	324	272	30	22
8855	RV_pair3855	FakeDesc3855	FakeAnc3855	SIMULPF00001	20	24	26	18	6	2
8856	RV_pair3856	FakeDesc3856	FakeAnc3856	SIMULPF00001	80	78	90	68	10	12
8857	RV_pair3857	FakeDesc3857	FakeAnc3857	SIMULPF00001	17	16	18	15	1	2
8858	RV_pair3858	FakeDesc3858	FakeAnc3858	SIMULPF00001	29	29	31	27	2	2
8859	RV_pair3859	FakeDesc3859	FakeAnc3859	SIMULPF00001	74	90	91	73	17	1
8860	RV_pair3860	FakeDesc3860	FakeAnc3860	SIMULPF00001	331	326	366	291	35	40
8861	RV_pair3861	FakeDesc3861	FakeAnc3861	SIMULPF00001	485	487	536	436	51	49
8862	RV_pair3862	FakeDesc3862	FakeAnc3862	SIMULPF00001	159	157	168	148	9	11
8863	RV_pair3863	FakeDesc3863	FakeAnc3863	SIMULPF00001	406	417	456	367	50	39
8864	RV_pair3864	FakeDesc3864	FakeAnc3864	SIMULPF00001	487	483	525	445	38	42
8865	RV_pair3865	FakeDesc3865	FakeAnc3865	SIMULPF00001	58	58	62	54	4	4
8866	RV_pair3866	FakeDesc3866	FakeAnc3866	SIMULPF00001	86	97	103	80	17	6
8867	RV_pair3867	FakeDesc3867	FakeAnc3867	SIMULPF00001	380	396	419	357	39	23
8868	RV_pair3868	FakeDesc3868	FakeAnc3868	SIMULPF00001	109	115	121	103	12	6
8869	RV_pair3869	FakeDesc3869	FakeAnc3869	SIMULPF00001	915	888	979	824	64	91
8870	RV_pair3870	FakeDesc3870	FakeAnc3870	SIMULPF00001	131	130	147	114	16	17
8871	RV_pair3871	FakeDesc3871	FakeAnc3871	SIMULPF00001	22	21	24	19	2	3
8872	RV_pair3872	FakeDesc3872	FakeAnc3872	SIMULPF00001	85	73	89	69	4	16
8873	RV_pair3873	FakeDesc3873	FakeAnc3873	SIMULPF00001	11	9	11	9	0	2
8874	RV_pair3874	FakeDesc3874	FakeAnc3874	SIMULPF00001	362	371	401	332	39	30
8875	RV_pair3875	FakeDesc3875	FakeAnc3875	SIMULPF00001	327	321	354	294	27	33
8876	RV_pair3876	FakeDesc3876	FakeAnc3876	SIMULPF00001	121	122	131	112	10	9
8877	RV_pair3877	FakeDesc3877	FakeAnc3877	SIMULPF00001	618	617	676	559	58	59
8878	RV_pair3878	FakeDesc3878	FakeAnc3878	SIMULPF00001	307	291	329	269	22	38
8879	RV_pair3879	FakeDesc3879	FakeAnc3879	SIMULPF00001	235	225	251	209	16	26
8880	RV_pair3880	FakeDesc3880	FakeAnc3880	SIMULPF00001	430	425	463	392	33	38
8881	RV_pair3881	FakeDesc3881	FakeAnc3881	SIMULPF00001	134	125	143	116	9	18
8882	RV_pair3882	FakeDesc3882	FakeAnc3882	SIMULPF00001	487	503	541	449	54	38
8883	RV_pair3883	FakeDesc3883	FakeAnc3883	SIMULPF00001	839	842	919	762	80	77
8884	RV_pair3884	FakeDesc3884	FakeAnc3884	SIMULPF00001	10	13	13	10	3	0
8885	RV_pair3885	FakeDesc3885	FakeAnc3885	SIMULPF00001	237	240	259	218	22	19
8886	RV_pair3886	FakeDesc3886	FakeAnc3886	SIMULPF00001	141	151	165	127	24	14
8887	RV_pair3887	FakeDesc3887	FakeAnc3887	SIMULPF00001	96	99	108	87	12	9
8888	RV_pair3888	FakeDesc3888	FakeAnc3888	SIMULPF00001	162	158	181	139	19	23
8889	RV_pair3889	FakeDesc3889	FakeAnc3889	SIMULPF00001	362	367	407	322	45	40
8890	RV_pair3890	FakeDesc3890	FakeAnc3890	SIMULPF00001	22	22	23	21	1	1
8891	RV_pair3891	FakeDesc3891	FakeAnc3891	SIMULPF00001	3	3	3	3	0	0
8892	RV_pair3892	FakeDesc3892	FakeAnc3892	SIMULPF00001	737	726	813	650	76	87
8893	RV_pair3893	FakeDesc3893	FakeAnc3893	SIMULPF00001	156	155	169	142	13	14
8894	RV_pair3894	FakeDesc3894	FakeAnc3894	SIMULPF00001	359	367	399	327	40	32
8895	RV_pair3895	FakeDesc3895	FakeAnc3895	SIMULPF00001	137	149	156	130	19	7
8896	RV_pair3896	FakeDesc3896	FakeAnc3896	SIMULPF00001	4	4	6	2	2	2
8897	RV_pair3897	FakeDesc3897	FakeAnc3897	SIMULPF00001	21	20	21	20	0	1
8898	RV_pair3898	FakeDesc3898	FakeAnc3898	SIMULPF00001	291	291	324	258	33	33
8899	RV_pair3899	FakeDesc3899	FakeAnc3899	SIMULPF00001	491	487	532	446	41	45
8900	RV_pair3900	FakeDesc3900	FakeAnc3900	SIMULPF00001	437	433	474	396	37	41
8901	RV_pair3901	FakeDesc3901	FakeAnc3901	SIMULPF00001	339	336	371	304	32	35
8902	RV_pair3902	FakeDesc3902	FakeAnc3902	SIMULPF00001	38	38	43	33	5	5
8903	RV_pair3903	FakeDesc3903	FakeAnc3903	SIMULPF00001	206	216	230	192	24	14
8904	RV_pair3904	FakeDesc3904	FakeAnc3904	SIMULPF00001	195	194	212	177	17	18
8905	RV_pair3905	FakeDesc3905	FakeAnc3905	SIMULPF00001	49	49	57	41	8	8
8906	RV_pair3906	FakeDesc3906	FakeAnc3906	SIMULPF00001	120	113	125	108	5	12
8907	RV_pair3907	FakeDesc3907	FakeAnc3907	SIMULPF00001	737	727	802	662	65	75
8908	RV_pair3908	FakeDesc3908	FakeAnc3908	SIMULPF00001	44	39	45	38	1	6
8909	RV_pair3909	FakeDesc3909	FakeAnc3909	SIMULPF00001	390	401	428	363	38	27
8910	RV_pair3910	FakeDesc3910	FakeAnc3910	SIMULPF00001	264	258	286	236	22	28
8911	RV_pair3911	FakeDesc3911	FakeAnc3911	SIMULPF00001	113	115	125	103	12	10
8912	RV_pair3912	FakeDesc3912	FakeAnc3912	SIMULPF00001	101	99	112	88	11	13
8913	RV_pair3913	FakeDesc3913	FakeAnc3913	SIMULPF00001	95	85	102	78	7	17
8914	RV_pair3914	FakeDesc3914	FakeAnc3914	SIMULPF00001	19	21	21	19	2	0
8915	RV_pair3915	FakeDesc3915	FakeAnc3915	SIMULPF00001	300	315	345	270	45	30
8916	RV_pair3916	FakeDesc3916	FakeAnc3916	SIMULPF00001	215	207	227	195	12	20
8917	RV_pair3917	FakeDesc3917	FakeAnc3917	SIMULPF00001	645	662	722	585	77	60
8918	RV_pair3918	FakeDesc3918	FakeAnc3918	SIMULPF00001	54	52	60	46	6	8
8919	RV_pair3919	FakeDesc3919	FakeAnc3919	SIMULPF00001	47	47	52	42	5	5
8920	RV_pair3920	FakeDesc3920	FakeAnc3920	SIMULPF00001	8	11	11	8	3	0
8921	RV_pair3921	FakeDesc3921	FakeAnc3921	SIMULPF00001	56	62	66	52	10	4
8922	RV_pair3922	FakeDesc3922	FakeAnc3922	SIMULPF00001	56	58	61	53	5	3
8923	RV_pair3923	FakeDesc3923	FakeAnc3923	SIMULPF00001	346	352	389	309	43	37
8924	RV_pair3924	FakeDesc3924	FakeAnc3924	SIMULPF00001	475	457	523	409	48	66
8925	RV_pair3925	FakeDesc3925	FakeAnc3925	SIMULPF00001	6	6	6	6	0	0
8926	RV_pair3926	FakeDesc3926	FakeAnc3926	SIMULPF00001	578	580	632	526	54	52
8927	RV_pair3927	FakeDesc3927	FakeAnc3927	SIMULPF00001	341	347	366	322	25	19
8928	RV_pair3928	FakeDesc3928	FakeAnc3928	SIMULPF00001	343	339	371	311	28	32
8929	RV_pair3929	FakeDesc3929	FakeAnc3929	SIMULPF00001	530	536	584	482	54	48
8930	RV_pair3930	FakeDesc3930	FakeAnc3930	SIMULPF00001	491	491	538	444	47	47
8931	RV_pair3931	FakeDesc3931	FakeAnc3931	SIMULPF00001	203	190	213	180	10	23
8932	RV_pair3932	FakeDesc3932	FakeAnc3932	SIMULPF00001	102	98	109	91	7	11
8933	RV_pair3933	FakeDesc3933	FakeAnc3933	SIMULPF00001	45	41	49	37	4	8
8934	RV_pair3934	FakeDesc3934	FakeAnc3934	SIMULPF00001	532	503	568	467	36	65
8935	RV_pair3935	FakeDesc3935	FakeAnc3935	SIMULPF00001	624	613	671	566	47	58
8936	RV_pair3936	FakeDesc3936	FakeAnc3936	SIMULPF00001	861	844	923	782	62	79
8937	RV_pair3937	FakeDesc3937	FakeAnc3937	SIMULPF00001	224	251	262	213	38	11
8938	RV_pair3938	FakeDesc3938	FakeAnc3938	SIMULPF00001	570	545	609	506	39	64
8939	RV_pair3939	FakeDesc3939	FakeAnc3939	SIMULPF00001	46	47	52	41	6	5
8940	RV_pair3940	FakeDesc3940	FakeAnc3940	SIMULPF00001	46	47	49	44	3	2
8941	RV_pair3941	FakeDesc3941	FakeAnc3941	SIMULPF00001	420	424	469	375	49	45
8942	RV_pair3942	FakeDesc3942	FakeAnc3942	SIMULPF00001	69	67	74	62	5	7
8943	RV_pair3943	FakeDesc3943	FakeAnc3943	SIMULPF00001	351	365	387	329	36	22
8944	RV_pair3944	FakeDesc3944	FakeAnc3944	SIMULPF00001	23	23	24	22	1	1
8945	RV_pair3945	FakeDesc3945	FakeAnc3945	SIMULPF00001	272	290	315	247	43	25
8946	RV_pair3946	FakeDesc3946	FakeAnc3946	SIMULPF00001	428	429	473	384	45	44
8947	RV_pair3947	FakeDesc3947	FakeAnc3947	SIMULPF00001	353	341	383	311	30	42
8948	RV_pair3948	FakeDesc3948	FakeAnc3948	SIMULPF00001	235	227	256	206	21	29
8949	RV_pair3949	FakeDesc3949	FakeAnc3949	SIMULPF00001	356	362	389	329	33	27
8950	RV_pair3950	FakeDesc3950	FakeAnc3950	SIMULPF00001	23	22	23	22	0	1
8951	RV_pair3951	FakeDesc3951	FakeAnc3951	SIMULPF00001	832	824	911	745	79	87
8952	RV_pair3952	FakeDesc3952	FakeAnc3952	SIMULPF00001	59	63	65	57	6	2
8953	RV_pair3953	FakeDesc3953	FakeAnc3953	SIMULPF00001	421	417	459	379	38	42
8954	RV_pair3954	FakeDesc3954	FakeAnc3954	SIMULPF00001	752	772	823	701	71	51
8955	RV_pair3955	FakeDesc3955	FakeAnc3955	SIMULPF00001	141	132	154	119	13	22
8956	RV_pair3956	FakeDesc3956	FakeAnc3956	SIMULPF00001	401	410	447	364	46	37
8957	RV_pair3957	FakeDesc3957	FakeAnc3957	SIMULPF00001	360	347	385	322	25	38
8958	RV_pair3958	FakeDesc3958	FakeAnc3958	SIMULPF00001	23	23	25	21	2	2
8959	RV_pair3959	FakeDesc3959	FakeAnc3959	SIMULPF00001	277	277	308	246	31	31
8960	RV_pair3960	FakeDesc3960	FakeAnc3960	SIMULPF00001	282	290	317	255	35	27
8961	RV_pair3961	FakeDesc3961	FakeAnc3961	SIMULPF00001	206	196	222	180	16	26
8962	RV_pair3962	FakeDesc3962	FakeAnc3962	SIMULPF00001	78	77	83	72	5	6
8963	RV_pair3963	FakeDesc3963	FakeAnc3963	SIMULPF00001	18	21	21	18	3	0
8964	RV_pair3964	FakeDesc3964	FakeAnc3964	SIMULPF00001	8	7	9	6	1	2
8965	RV_pair3965	FakeDesc3965	FakeAnc3965	SIMULPF00001	223	227	242	208	19	15
8966	RV_pair3966	FakeDesc3966	FakeAnc3966	SIMULPF00001	472	452	504	420	32	52
8967	RV_pair3967	FakeDesc3967	FakeAnc3967	SIMULPF00001	105	113	122	96	17	9
8968	RV_pair3968	FakeDesc3968	FakeAnc3968	SIMULPF00001	223	228	248	203	25	20
8969	RV_pair3969	FakeDesc3969	FakeAnc3969	SIMULPF00001	151	144	157	138	6	13
8970	RV_pair3970	FakeDesc3970	FakeAnc3970	SIMULPF00001	138	133	144	127	6	11
8971	RV_pair3971	FakeDesc3971	FakeAnc3971	SIMULPF00001	17	17	18	16	1	1
8972	RV_pair3972	FakeDesc3972	FakeAnc3972	SIMULPF00001	143	150	158	135	15	8
8973	RV_pair3973	FakeDesc3973	FakeAnc3973	SIMULPF00001	134	141	147	128	13	6
8974	RV_pair3974	FakeDesc3974	FakeAnc3974	SIMULPF00001	98	101	107	92	9	6
8975	RV_pair3975	FakeDesc3975	FakeAnc3975	SIMULPF00001	110	109	116	103	6	7
8976	RV_pair3976	FakeDesc3976	FakeAnc3976	SIMULPF00001	879	881	969	791	90	88
8977	RV_pair3977	FakeDesc3977	FakeAnc3977	SIMULPF00001	132	134	142	124	10	8
8978	RV_pair3978	FakeDesc3978	FakeAnc3978	SIMULPF00001	138	137	152	123	14	15
8979	RV_pair3979	FakeDesc3979	FakeAnc3979	SIMULPF00001	176	178	193	161	17	15
8980	RV_pair3980	FakeDesc3980	FakeAnc3980	SIMULPF00001	113	118	125	106	12	7
8981	RV_pair3981	FakeDesc3981	FakeAnc3981	SIMULPF00001	17	16	18	15	1	2
8982	RV_pair3982	FakeDesc3982	FakeAnc3982	SIMULPF00001	539	524	581	482	42	57
8983	RV_pair3983	FakeDesc3983	FakeAnc3983	SIMULPF00001	56	57	62	51	6	5
8984	RV_pair3984	FakeDesc3984	FakeAnc3984	SIMULPF00001	95	92	101	86	6	9
8985	RV_pair3985	FakeDesc3985	FakeAnc3985	SIMULPF00001	37	44	45	36	8	1
8986	RV_pair3986	FakeDesc3986	FakeAnc3986	SIMULPF00001	549	549	602	496	53	53
8987	RV_pair3987	FakeDesc3987	FakeAnc3987	SIMULPF00001	158	142	167	133	9	25
8988	RV_pair3988	FakeDesc3988	FakeAnc3988	SIMULPF00001	220	241	248	213	28	7
8989	RV_pair3989	FakeDesc3989	FakeAnc3989	SIMULPF00001	384	392	419	357	35	27
8990	RV_pair3990	FakeDesc3990	FakeAnc3990	SIMULPF00001	602	604	655	551	53	51
8991	RV_pair3991	FakeDesc3991	FakeAnc3991	SIMULPF00001	559	549	603	505	44	54
8992	RV_pair3992	FakeDesc3992	FakeAnc3992	SIMULPF00001	316	307	344	279	28	37
8993	RV_pair3993	FakeDesc3993	FakeAnc3993	SIMULPF00001	130	124	138	116	8	14
8994	RV_pair3994	FakeDesc3994	FakeAnc3994	SIMULPF00001	230	220	243	207	13	23
8995	RV_pair3995	FakeDesc3995	FakeAnc3995	SIMULPF00001	266	280	298	248	32	18
8996	RV_pair3996	FakeDesc3996	FakeAnc3996	SIMULPF00001	18	17	20	15	2	3
8997	RV_pair3997	FakeDesc3997	FakeAnc3997	SIMULPF00001	41	44	48	37	7	4
8998	RV_pair3998	FakeDesc3998	FakeAnc3998	SIMULPF00001	174	171	185	160	11	14
8999	RV_pair3999	FakeDesc3999	FakeAnc3999	SIMULPF00001	174	181	191	164	17	10
9000	RV_pair4000	FakeDesc4000	FakeAnc4000	SIMULPF00001	108	110	116	102	8	6
9001	RV_pair4001	FakeDesc4001	FakeAnc4001	SIMULPF00001	30	31	34	27	4	3
9002	RV_pair4002	FakeDesc4002	FakeAnc4002	SIMULPF00001	37	44	45	36	8	1
9003	RV_pair4003	FakeDesc4003	FakeAnc4003	SIMULPF00001	83	79	86	76	3	7
9004	RV_pair4004	FakeDesc4004	FakeAnc4004	SIMULPF00001	92	88	101	79	9	13
9005	RV_pair4005	FakeDesc4005	FakeAnc4005	SIMULPF00001	113	118	126	105	13	8
9006	RV_pair4006	FakeDesc4006	FakeAnc4006	SIMULPF00001	27	27	31	23	4	4
9007	RV_pair4007	FakeDesc4007	FakeAnc4007	SIMULPF00001	655	644	720	579	65	76
9008	RV_pair4008	FakeDesc4008	FakeAnc4008	SIMULPF00001	192	182	206	168	14	24
9009	RV_pair4009	FakeDesc4009	FakeAnc4009	SIMULPF00001	45	42	49	38	4	7
9010	RV_pair4010	FakeDesc4010	FakeAnc4010	SIMULPF00001	52	56	61	47	9	5
9011	RV_pair4011	FakeDesc4011	FakeAnc4011	SIMULPF00001	378	379	409	348	31	30
9012	RV_pair4012	FakeDesc4012	FakeAnc4012	SIMULPF00001	352	339	381	310	29	42
9013	RV_pair4013	FakeDesc4013	FakeAnc4013	SIMULPF00001	245	250	271	224	26	21
9014	RV_pair4014	FakeDesc4014	FakeAnc4014	SIMULPF00001	176	171	184	163	8	13
9015	RV_pair4015	FakeDesc4015	FakeAnc4015	SIMULPF00001	72	83	90	65	18	7
9016	RV_pair4016	FakeDesc4016	FakeAnc4016	SIMULPF00001	362	397	419	340	57	22
9017	RV_pair4017	FakeDesc4017	FakeAnc4017	SIMULPF00001	157	151	171	137	14	20
9018	RV_pair4018	FakeDesc4018	FakeAnc4018	SIMULPF00001	13	16	16	13	3	0
9019	RV_pair4019	FakeDesc4019	FakeAnc4019	SIMULPF00001	18	18	19	17	1	1
9020	RV_pair4020	FakeDesc4020	FakeAnc4020	SIMULPF00001	5	5	5	5	0	0
9021	RV_pair4021	FakeDesc4021	FakeAnc4021	SIMULPF00001	169	171	181	159	12	10
9022	RV_pair4022	FakeDesc4022	FakeAnc4022	SIMULPF00001	289	299	322	266	33	23
9023	RV_pair4023	FakeDesc4023	FakeAnc4023	SIMULPF00001	310	312	349	273	39	37
9024	RV_pair4024	FakeDesc4024	FakeAnc4024	SIMULPF00001	13	17	17	13	4	0
9025	RV_pair4025	FakeDesc4025	FakeAnc4025	SIMULPF00001	573	566	632	507	59	66
9026	RV_pair4026	FakeDesc4026	FakeAnc4026	SIMULPF00001	116	109	118	107	2	9
9027	RV_pair4027	FakeDesc4027	FakeAnc4027	SIMULPF00001	86	87	90	83	4	3
9028	RV_pair4028	FakeDesc4028	FakeAnc4028	SIMULPF00001	141	142	152	131	11	10
9029	RV_pair4029	FakeDesc4029	FakeAnc4029	SIMULPF00001	597	600	648	549	51	48
9030	RV_pair4030	FakeDesc4030	FakeAnc4030	SIMULPF00001	98	92	103	87	5	11
9031	RV_pair4031	FakeDesc4031	FakeAnc4031	SIMULPF00001	184	164	191	157	7	27
9032	RV_pair4032	FakeDesc4032	FakeAnc4032	SIMULPF00001	390	404	433	361	43	29
9033	RV_pair4033	FakeDesc4033	FakeAnc4033	SIMULPF00001	219	214	239	194	20	25
9034	RV_pair4034	FakeDesc4034	FakeAnc4034	SIMULPF00001	106	102	118	90	12	16
9035	RV_pair4035	FakeDesc4035	FakeAnc4035	SIMULPF00001	523	524	576	471	53	52
9036	RV_pair4036	FakeDesc4036	FakeAnc4036	SIMULPF00001	137	141	152	126	15	11
9037	RV_pair4037	FakeDesc4037	FakeAnc4037	SIMULPF00001	108	117	129	96	21	12
9038	RV_pair4038	FakeDesc4038	FakeAnc4038	SIMULPF00001	160	146	167	139	7	21
9039	RV_pair4039	FakeDesc4039	FakeAnc4039	SIMULPF00001	5	6	6	5	1	0
9040	RV_pair4040	FakeDesc4040	FakeAnc4040	SIMULPF00001	391	389	423	357	32	34
9041	RV_pair4041	FakeDesc4041	FakeAnc4041	SIMULPF00001	659	633	718	574	59	85
9042	RV_pair4042	FakeDesc4042	FakeAnc4042	SIMULPF00001	391	383	428	346	37	45
9043	RV_pair4043	FakeDesc4043	FakeAnc4043	SIMULPF00001	144	151	165	130	21	14
9044	RV_pair4044	FakeDesc4044	FakeAnc4044	SIMULPF00001	53	55	60	48	7	5
9045	RV_pair4045	FakeDesc4045	FakeAnc4045	SIMULPF00001	62	65	71	56	9	6
9046	RV_pair4046	FakeDesc4046	FakeAnc4046	SIMULPF00001	258	273	298	233	40	25
9047	RV_pair4047	FakeDesc4047	FakeAnc4047	SIMULPF00001	508	512	560	460	52	48
9048	RV_pair4048	FakeDesc4048	FakeAnc4048	SIMULPF00001	449	438	493	394	44	55
9049	RV_pair4049	FakeDesc4049	FakeAnc4049	SIMULPF00001	70	73	79	64	9	6
9050	RV_pair4050	FakeDesc4050	FakeAnc4050	SIMULPF00001	109	115	131	93	22	16
9051	RV_pair4051	FakeDesc4051	FakeAnc4051	SIMULPF00001	331	331	366	296	35	35
9052	RV_pair4052	FakeDesc4052	FakeAnc4052	SIMULPF00001	58	61	64	55	6	3
9053	RV_pair4053	FakeDesc4053	FakeAnc4053	SIMULPF00001	112	110	123	99	11	13
9054	RV_pair4054	FakeDesc4054	FakeAnc4054	SIMULPF00001	91	86	99	78	8	13
9055	RV_pair4055	FakeDesc4055	FakeAnc4055	SIMULPF00001	606	590	646	550	40	56
9056	RV_pair4056	FakeDesc4056	FakeAnc4056	SIMULPF00001	148	143	161	130	13	18
9057	RV_pair4057	FakeDesc4057	FakeAnc4057	SIMULPF00001	415	409	444	380	29	35
9058	RV_pair4058	FakeDesc4058	FakeAnc4058	SIMULPF00001	205	198	219	184	14	21
9059	RV_pair4059	FakeDesc4059	FakeAnc4059	SIMULPF00001	395	382	427	350	32	45
9060	RV_pair4060	FakeDesc4060	FakeAnc4060	SIMULPF00001	373	361	400	334	27	39
9061	RV_pair4061	FakeDesc4061	FakeAnc4061	SIMULPF00001	111	102	114	99	3	12
9062	RV_pair4062	FakeDesc4062	FakeAnc4062	SIMULPF00001	238	244	268	214	30	24
9063	RV_pair4063	FakeDesc4063	FakeAnc4063	SIMULPF00001	16	17	21	12	5	4
9064	RV_pair4064	FakeDesc4064	FakeAnc4064	SIMULPF00001	386	382	417	351	31	35
9065	RV_pair4065	FakeDesc4065	FakeAnc4065	SIMULPF00001	277	268	302	243	25	34
9066	RV_pair4066	FakeDesc4066	FakeAnc4066	SIMULPF00001	640	622	689	573	49	67
9067	RV_pair4067	FakeDesc4067	FakeAnc4067	SIMULPF00001	59	62	66	55	7	4
9068	RV_pair4068	FakeDesc4068	FakeAnc4068	SIMULPF00001	188	197	206	179	18	9
9069	RV_pair4069	FakeDesc4069	FakeAnc4069	SIMULPF00001	58	52	61	49	3	9
9070	RV_pair4070	FakeDesc4070	FakeAnc4070	SIMULPF00001	356	365	393	328	37	28
9071	RV_pair4071	FakeDesc4071	FakeAnc4071	SIMULPF00001	335	330	367	298	32	37
9072	RV_pair4072	FakeDesc4072	FakeAnc4072	SIMULPF00001	264	265	288	241	24	23
9073	RV_pair4073	FakeDesc4073	FakeAnc4073	SIMULPF00001	365	373	404	334	39	31
9074	RV_pair4074	FakeDesc4074	FakeAnc4074	SIMULPF00001	88	86	94	80	6	8
9075	RV_pair4075	FakeDesc4075	FakeAnc4075	SIMULPF00001	117	111	125	103	8	14
9076	RV_pair4076	FakeDesc4076	FakeAnc4076	SIMULPF00001	5	4	5	4	0	1
9077	RV_pair4077	FakeDesc4077	FakeAnc4077	SIMULPF00001	474	477	525	426	51	48
9078	RV_pair4078	FakeDesc4078	FakeAnc4078	SIMULPF00001	63	63	69	57	6	6
9079	RV_pair4079	FakeDesc4079	FakeAnc4079	SIMULPF00001	340	345	370	315	30	25
9080	RV_pair4080	FakeDesc4080	FakeAnc4080	SIMULPF00001	172	172	188	156	16	16
9081	RV_pair4081	FakeDesc4081	FakeAnc4081	SIMULPF00001	8	8	8	8	0	0
9082	RV_pair4082	FakeDesc4082	FakeAnc4082	SIMULPF00001	246	242	265	223	19	23
9083	RV_pair4083	FakeDesc4083	FakeAnc4083	SIMULPF00001	498	506	547	457	49	41
9084	RV_pair4084	FakeDesc4084	FakeAnc4084	SIMULPF00001	252	240	265	227	13	25
9085	RV_pair4085	FakeDesc4085	FakeAnc4085	SIMULPF00001	212	208	224	196	12	16
9086	RV_pair4086	FakeDesc4086	FakeAnc4086	SIMULPF00001	239	241	261	219	22	20
9087	RV_pair4087	FakeDesc4087	FakeAnc4087	SIMULPF00001	552	580	616	516	64	36
9088	RV_pair4088	FakeDesc4088	FakeAnc4088	SIMULPF00001	118	118	129	107	11	11
9089	RV_pair4089	FakeDesc4089	FakeAnc4089	SIMULPF00001	100	107	109	98	9	2
9090	RV_pair4090	FakeDesc4090	FakeAnc4090	SIMULPF00001	284	277	298	263	14	21
9091	RV_pair4091	FakeDesc4091	FakeAnc4091	SIMULPF00001	156	156	169	143	13	13
9092	RV_pair4092	FakeDesc4092	FakeAnc4092	SIMULPF00001	577	561	610	528	33	49
9093	RV_pair4093	FakeDesc4093	FakeAnc4093	SIMULPF00001	145	131	153	123	8	22
9094	RV_pair4094	FakeDesc4094	FakeAnc4094	SIMULPF00001	40	43	45	38	5	2
9095	RV_pair4095	FakeDesc4095	FakeAnc4095	SIMULPF00001	505	525	558	472	53	33
9096	RV_pair4096	FakeDesc4096	FakeAnc4096	SIMULPF00001	197	198	214	181	17	16
9097	RV_pair4097	FakeDesc4097	FakeAnc4097	SIMULPF00001	355	340	379	316	24	39
9098	RV_pair4098	FakeDesc4098	FakeAnc4098	SIMULPF00001	192	181	210	163	18	29
9099	RV_pair4099	FakeDesc4099	FakeAnc4099	SIMULPF00001	557	562	611	508	54	49
9100	RV_pair4100	FakeDesc4100	FakeAnc4100	SIMULPF00001	200	199	216	183	16	17
9101	RV_pair4101	FakeDesc4101	FakeAnc4101	SIMULPF00001	19	20	20	19	1	0
9102	RV_pair4102	FakeDesc4102	FakeAnc4102	SIMULPF00001	148	144	161	131	13	17
9103	RV_pair4103	FakeDesc4103	FakeAnc4103	SIMULPF00001	587	576	641	522	54	65
9104	RV_pair4104	FakeDesc4104	FakeAnc4104	SIMULPF00001	399	401	437	363	38	36
9105	RV_pair4105	FakeDesc4105	FakeAnc4105	SIMULPF00001	308	307	334	281	26	27
9106	RV_pair4106	FakeDesc4106	FakeAnc4106	SIMULPF00001	249	255	285	219	36	30
9107	RV_pair4107	FakeDesc4107	FakeAnc4107	SIMULPF00001	68	71	75	64	7	4
9108	RV_pair4108	FakeDesc4108	FakeAnc4108	SIMULPF00001	111	101	120	92	9	19
9109	RV_pair4109	FakeDesc4109	FakeAnc4109	SIMULPF00001	325	313	340	298	15	27
9110	RV_pair4110	FakeDesc4110	FakeAnc4110	SIMULPF00001	260	265	290	235	30	25
9111	RV_pair4111	FakeDesc4111	FakeAnc4111	SIMULPF00001	30	29	33	26	3	4
9112	RV_pair4112	FakeDesc4112	FakeAnc4112	SIMULPF00001	114	110	123	101	9	13
9113	RV_pair4113	FakeDesc4113	FakeAnc4113	SIMULPF00001	430	433	471	392	41	38
9114	RV_pair4114	FakeDesc4114	FakeAnc4114	SIMULPF00001	13	15	15	13	2	0
9115	RV_pair4115	FakeDesc4115	FakeAnc4115	SIMULPF00001	142	148	166	124	24	18
9116	RV_pair4116	FakeDesc4116	FakeAnc4116	SIMULPF00001	585	574	637	522	52	63
9117	RV_pair4117	FakeDesc4117	FakeAnc4117	SIMULPF00001	375	387	404	358	29	17
9118	RV_pair4118	FakeDesc4118	FakeAnc4118	SIMULPF00001	428	406	453	381	25	47
9119	RV_pair4119	FakeDesc4119	FakeAnc4119	SIMULPF00001	602	610	661	551	59	51
9120	RV_pair4120	FakeDesc4120	FakeAnc4120	SIMULPF00001	11	12	12	11	1	0
9121	RV_pair4121	FakeDesc4121	FakeAnc4121	SIMULPF00001	70	71	79	62	9	8
9122	RV_pair4122	FakeDesc4122	FakeAnc4122	SIMULPF00001	44	46	50	40	6	4
9123	RV_pair4123	FakeDesc4123	FakeAnc4123	SIMULPF00001	336	343	377	302	41	34
9124	RV_pair4124	FakeDesc4124	FakeAnc4124	SIMULPF00001	331	320	352	299	21	32
9125	RV_pair4125	FakeDesc4125	FakeAnc4125	SIMULPF00001	40	38	45	33	5	7
9126	RV_pair4126	FakeDesc4126	FakeAnc4126	SIMULPF00001	34	35	36	33	2	1
9127	RV_pair4127	FakeDesc4127	FakeAnc4127	SIMULPF00001	55	58	61	52	6	3
9128	RV_pair4128	FakeDesc4128	FakeAnc4128	SIMULPF00001	178	172	192	158	14	20
9129	RV_pair4129	FakeDesc4129	FakeAnc4129	SIMULPF00001	201	208	222	187	21	14
9130	RV_pair4130	FakeDesc4130	FakeAnc4130	SIMULPF00001	64	61	68	57	4	7
9131	RV_pair4131	FakeDesc4131	FakeAnc4131	SIMULPF00001	225	207	240	192	15	33
9132	RV_pair4132	FakeDesc4132	FakeAnc4132	SIMULPF00001	30	27	32	25	2	5
9133	RV_pair4133	FakeDesc4133	FakeAnc4133	SIMULPF00001	36	35	41	30	5	6
9134	RV_pair4134	FakeDesc4134	FakeAnc4134	SIMULPF00001	361	359	405	315	44	46
9135	RV_pair4135	FakeDesc4135	FakeAnc4135	SIMULPF00001	189	192	207	174	18	15
9136	RV_pair4136	FakeDesc4136	FakeAnc4136	SIMULPF00001	17	19	19	17	2	0
9137	RV_pair4137	FakeDesc4137	FakeAnc4137	SIMULPF00001	69	72	79	62	10	7
9138	RV_pair4138	FakeDesc4138	FakeAnc4138	SIMULPF00001	351	352	381	322	30	29
9139	RV_pair4139	FakeDesc4139	FakeAnc4139	SIMULPF00001	339	363	394	308	55	31
9140	RV_pair4140	FakeDesc4140	FakeAnc4140	SIMULPF00001	180	185	193	172	13	8
9141	RV_pair4141	FakeDesc4141	FakeAnc4141	SIMULPF00001	74	74	77	71	3	3
9142	RV_pair4142	FakeDesc4142	FakeAnc4142	SIMULPF00001	263	253	283	233	20	30
9143	RV_pair4143	FakeDesc4143	FakeAnc4143	SIMULPF00001	253	250	271	232	18	21
9144	RV_pair4144	FakeDesc4144	FakeAnc4144	SIMULPF00001	230	212	242	200	12	30
9145	RV_pair4145	FakeDesc4145	FakeAnc4145	SIMULPF00001	218	225	247	196	29	22
9146	RV_pair4146	FakeDesc4146	FakeAnc4146	SIMULPF00001	426	408	465	369	39	57
9147	RV_pair4147	FakeDesc4147	FakeAnc4147	SIMULPF00001	359	383	404	338	45	21
9148	RV_pair4148	FakeDesc4148	FakeAnc4148	SIMULPF00001	124	128	139	113	15	11
9149	RV_pair4149	FakeDesc4149	FakeAnc4149	SIMULPF00001	117	118	124	111	7	6
9150	RV_pair4150	FakeDesc4150	FakeAnc4150	SIMULPF00001	102	100	110	92	8	10
9151	RV_pair4151	FakeDesc4151	FakeAnc4151	SIMULPF00001	120	124	131	113	11	7
9152	RV_pair4152	FakeDesc4152	FakeAnc4152	SIMULPF00001	115	116	127	104	12	11
9153	RV_pair4153	FakeDesc4153	FakeAnc4153	SIMULPF00001	267	262	291	238	24	29
9154	RV_pair4154	FakeDesc4154	FakeAnc4154	SIMULPF00001	57	58	62	53	5	4
9155	RV_pair4155	FakeDesc4155	FakeAnc4155	SIMULPF00001	437	442	485	394	48	43
9156	RV_pair4156	FakeDesc4156	FakeAnc4156	SIMULPF00001	255	260	278	237	23	18
9157	RV_pair4157	FakeDesc4157	FakeAnc4157	SIMULPF00001	196	201	219	178	23	18
9158	RV_pair4158	FakeDesc4158	FakeAnc4158	SIMULPF00001	486	494	545	435	59	51
9159	RV_pair4159	FakeDesc4159	FakeAnc4159	SIMULPF00001	710	691	766	635	56	75
9160	RV_pair4160	FakeDesc4160	FakeAnc4160	SIMULPF00001	176	177	188	165	12	11
9161	RV_pair4161	FakeDesc4161	FakeAnc4161	SIMULPF00001	222	217	252	187	30	35
9162	RV_pair4162	FakeDesc4162	FakeAnc4162	SIMULPF00001	152	149	159	142	7	10
9163	RV_pair4163	FakeDesc4163	FakeAnc4163	SIMULPF00001	87	86	95	78	8	9
9164	RV_pair4164	FakeDesc4164	FakeAnc4164	SIMULPF00001	326	316	361	281	35	45
9165	RV_pair4165	FakeDesc4165	FakeAnc4165	SIMULPF00001	689	680	743	626	54	63
9166	RV_pair4166	FakeDesc4166	FakeAnc4166	SIMULPF00001	198	197	215	180	17	18
9167	RV_pair4167	FakeDesc4167	FakeAnc4167	SIMULPF00001	7	7	8	6	1	1
9168	RV_pair4168	FakeDesc4168	FakeAnc4168	SIMULPF00001	14	13	14	13	0	1
9169	RV_pair4169	FakeDesc4169	FakeAnc4169	SIMULPF00001	62	65	68	59	6	3
9170	RV_pair4170	FakeDesc4170	FakeAnc4170	SIMULPF00001	29	29	32	26	3	3
9171	RV_pair4171	FakeDesc4171	FakeAnc4171	SIMULPF00001	565	560	616	509	51	56
9172	RV_pair4172	FakeDesc4172	FakeAnc4172	SIMULPF00001	1	1	1	1	0	0
9173	RV_pair4173	FakeDesc4173	FakeAnc4173	SIMULPF00001	157	154	174	137	17	20
9174	RV_pair4174	FakeDesc4174	FakeAnc4174	SIMULPF00001	2	2	2	2	0	0
9175	RV_pair4175	FakeDesc4175	FakeAnc4175	SIMULPF00001	463	475	514	424	51	39
9176	RV_pair4176	FakeDesc4176	FakeAnc4176	SIMULPF00001	157	162	172	147	15	10
9177	RV_pair4177	FakeDesc4177	FakeAnc4177	SIMULPF00001	108	115	121	102	13	6
9178	RV_pair4178	FakeDesc4178	FakeAnc4178	SIMULPF00001	102	97	108	91	6	11
9179	RV_pair4179	FakeDesc4179	FakeAnc4179	SIMULPF00001	25	22	25	22	0	3
9180	RV_pair4180	FakeDesc4180	FakeAnc4180	SIMULPF00001	86	89	96	79	10	7
9181	RV_pair4181	FakeDesc4181	FakeAnc4181	SIMULPF00001	107	107	114	100	7	7
9182	RV_pair4182	FakeDesc4182	FakeAnc4182	SIMULPF00001	378	369	409	338	31	40
9183	RV_pair4183	FakeDesc4183	FakeAnc4183	SIMULPF00001	239	245	263	221	24	18
9184	RV_pair4184	FakeDesc4184	FakeAnc4184	SIMULPF00001	493	485	537	441	44	52
9185	RV_pair4185	FakeDesc4185	FakeAnc4185	SIMULPF00001	503	484	538	449	35	54
9186	RV_pair4186	FakeDesc4186	FakeAnc4186	SIMULPF00001	39	35	39	35	0	4
9187	RV_pair4187	FakeDesc4187	FakeAnc4187	SIMULPF00001	15	14	15	14	0	1
9188	RV_pair4188	FakeDesc4188	FakeAnc4188	SIMULPF00001	82	76	86	72	4	10
9189	RV_pair4189	FakeDesc4189	FakeAnc4189	SIMULPF00001	3	2	3	2	0	1
9190	RV_pair4190	FakeDesc4190	FakeAnc4190	SIMULPF00001	442	431	481	392	39	50
9191	RV_pair4191	FakeDesc4191	FakeAnc4191	SIMULPF00001	295	292	323	264	28	31
9192	RV_pair4192	FakeDesc4192	FakeAnc4192	SIMULPF00001	464	467	505	426	41	38
9193	RV_pair4193	FakeDesc4193	FakeAnc4193	SIMULPF00001	357	360	390	327	33	30
9194	RV_pair4194	FakeDesc4194	FakeAnc4194	SIMULPF00001	278	274	304	248	26	30
9195	RV_pair4195	FakeDesc4195	FakeAnc4195	SIMULPF00001	27	21	27	21	0	6
9196	RV_pair4196	FakeDesc4196	FakeAnc4196	SIMULPF00001	870	866	939	797	69	73
9197	RV_pair4197	FakeDesc4197	FakeAnc4197	SIMULPF00001	348	351	387	312	39	36
9198	RV_pair4198	FakeDesc4198	FakeAnc4198	SIMULPF00001	499	518	552	465	53	34
9199	RV_pair4199	FakeDesc4199	FakeAnc4199	SIMULPF00001	95	103	109	89	14	6
9200	RV_pair4200	FakeDesc4200	FakeAnc4200	SIMULPF00001	79	72	81	70	2	9
9201	RV_pair4201	FakeDesc4201	FakeAnc4201	SIMULPF00001	3	2	3	2	0	1
9202	RV_pair4202	FakeDesc4202	FakeAnc4202	SIMULPF00001	69	73	78	64	9	5
9203	RV_pair4203	FakeDesc4203	FakeAnc4203	SIMULPF00001	240	240	255	225	15	15
9204	RV_pair4204	FakeDesc4204	FakeAnc4204	SIMULPF00001	118	112	122	108	4	10
9205	RV_pair4205	FakeDesc4205	FakeAnc4205	SIMULPF00001	29	31	31	29	2	0
9206	RV_pair4206	FakeDesc4206	FakeAnc4206	SIMULPF00001	40	34	43	31	3	9
9207	RV_pair4207	FakeDesc4207	FakeAnc4207	SIMULPF00001	51	54	57	48	6	3
9208	RV_pair4208	FakeDesc4208	FakeAnc4208	SIMULPF00001	7	6	7	6	0	1
9209	RV_pair4209	FakeDesc4209	FakeAnc4209	SIMULPF00001	891	893	972	812	81	79
9210	RV_pair4210	FakeDesc4210	FakeAnc4210	SIMULPF00001	45	47	52	40	7	5
9211	RV_pair4211	FakeDesc4211	FakeAnc4211	SIMULPF00001	257	258	283	232	26	25
9212	RV_pair4212	FakeDesc4212	FakeAnc4212	SIMULPF00001	170	177	192	155	22	15
9213	RV_pair4213	FakeDesc4213	FakeAnc4213	SIMULPF00001	364	382	412	334	48	30
9214	RV_pair4214	FakeDesc4214	FakeAnc4214	SIMULPF00001	126	114	135	105	9	21
9215	RV_pair4215	FakeDesc4215	FakeAnc4215	SIMULPF00001	747	742	805	684	58	63
9216	RV_pair4216	FakeDesc4216	FakeAnc4216	SIMULPF00001	416	413	449	380	33	36
9217	RV_pair4217	FakeDesc4217	FakeAnc4217	SIMULPF00001	92	90	98	84	6	8
9218	RV_pair4218	FakeDesc4218	FakeAnc4218	SIMULPF00001	207	214	226	195	19	12
9219	RV_pair4219	FakeDesc4219	FakeAnc4219	SIMULPF00001	57	54	59	52	2	5
9220	RV_pair4220	FakeDesc4220	FakeAnc4220	SIMULPF00001	63	63	71	55	8	8
9221	RV_pair4221	FakeDesc4221	FakeAnc4221	SIMULPF00001	259	264	290	233	31	26
9222	RV_pair4222	FakeDesc4222	FakeAnc4222	SIMULPF00001	75	76	83	68	8	7
9223	RV_pair4223	FakeDesc4223	FakeAnc4223	SIMULPF00001	346	347	375	318	29	28
9224	RV_pair4224	FakeDesc4224	FakeAnc4224	SIMULPF00001	490	483	544	429	54	61
9225	RV_pair4225	FakeDesc4225	FakeAnc4225	SIMULPF00001	198	198	221	175	23	23
9226	RV_pair4226	FakeDesc4226	FakeAnc4226	SIMULPF00001	112	116	127	101	15	11
9227	RV_pair4227	FakeDesc4227	FakeAnc4227	SIMULPF00001	140	134	150	124	10	16
9228	RV_pair4228	FakeDesc4228	FakeAnc4228	SIMULPF00001	58	55	64	49	6	9
9229	RV_pair4229	FakeDesc4229	FakeAnc4229	SIMULPF00001	10	12	12	10	2	0
9230	RV_pair4230	FakeDesc4230	FakeAnc4230	SIMULPF00001	145	151	156	140	11	5
9231	RV_pair4231	FakeDesc4231	FakeAnc4231	SIMULPF00001	45	41	45	41	0	4
9232	RV_pair4232	FakeDesc4232	FakeAnc4232	SIMULPF00001	442	433	477	398	35	44
9233	RV_pair4233	FakeDesc4233	FakeAnc4233	SIMULPF00001	211	198	218	191	7	20
9234	RV_pair4234	FakeDesc4234	FakeAnc4234	SIMULPF00001	128	121	131	118	3	10
9235	RV_pair4235	FakeDesc4235	FakeAnc4235	SIMULPF00001	118	107	125	100	7	18
9236	RV_pair4236	FakeDesc4236	FakeAnc4236	SIMULPF00001	55	49	57	47	2	8
9237	RV_pair4237	FakeDesc4237	FakeAnc4237	SIMULPF00001	539	534	581	492	42	47
9238	RV_pair4238	FakeDesc4238	FakeAnc4238	SIMULPF00001	790	813	871	732	81	58
9239	RV_pair4239	FakeDesc4239	FakeAnc4239	SIMULPF00001	241	232	259	214	18	27
9240	RV_pair4240	FakeDesc4240	FakeAnc4240	SIMULPF00001	196	202	220	178	24	18
9241	RV_pair4241	FakeDesc4241	FakeAnc4241	SIMULPF00001	97	94	108	83	11	14
9242	RV_pair4242	FakeDesc4242	FakeAnc4242	SIMULPF00001	58	55	61	52	3	6
9243	RV_pair4243	FakeDesc4243	FakeAnc4243	SIMULPF00001	39	38	42	35	3	4
9244	RV_pair4244	FakeDesc4244	FakeAnc4244	SIMULPF00001	208	210	231	187	23	21
9245	RV_pair4245	FakeDesc4245	FakeAnc4245	SIMULPF00001	82	85	92	75	10	7
9246	RV_pair4246	FakeDesc4246	FakeAnc4246	SIMULPF00001	42	44	48	38	6	4
9247	RV_pair4247	FakeDesc4247	FakeAnc4247	SIMULPF00001	3	3	3	3	0	0
9248	RV_pair4248	FakeDesc4248	FakeAnc4248	SIMULPF00001	66	68	72	62	6	4
9249	RV_pair4249	FakeDesc4249	FakeAnc4249	SIMULPF00001	45	45	47	43	2	2
9250	RV_pair4250	FakeDesc4250	FakeAnc4250	SIMULPF00001	245	239	254	230	9	15
9251	RV_pair4251	FakeDesc4251	FakeAnc4251	SIMULPF00001	34	37	38	33	4	1
9252	RV_pair4252	FakeDesc4252	FakeAnc4252	SIMULPF00001	585	594	645	534	60	51
9253	RV_pair4253	FakeDesc4253	FakeAnc4253	SIMULPF00001	14	12	14	12	0	2
9254	RV_pair4254	FakeDesc4254	FakeAnc4254	SIMULPF00001	66	66	71	61	5	5
9255	RV_pair4255	FakeDesc4255	FakeAnc4255	SIMULPF00001	159	158	181	136	22	23
9256	RV_pair4256	FakeDesc4256	FakeAnc4256	SIMULPF00001	44	41	48	37	4	7
9257	RV_pair4257	FakeDesc4257	FakeAnc4257	SIMULPF00001	250	257	285	222	35	28
9258	RV_pair4258	FakeDesc4258	FakeAnc4258	SIMULPF00001	34	35	37	32	3	2
9259	RV_pair4259	FakeDesc4259	FakeAnc4259	SIMULPF00001	513	496	558	451	45	62
9260	RV_pair4260	FakeDesc4260	FakeAnc4260	SIMULPF00001	51	52	55	48	4	3
9261	RV_pair4261	FakeDesc4261	FakeAnc4261	SIMULPF00001	4	7	7	4	3	0
9262	RV_pair4262	FakeDesc4262	FakeAnc4262	SIMULPF00001	12	11	13	10	1	2
9263	RV_pair4263	FakeDesc4263	FakeAnc4263	SIMULPF00001	66	70	74	62	8	4
9264	RV_pair4264	FakeDesc4264	FakeAnc4264	SIMULPF00001	84	90	98	76	14	8
9265	RV_pair4265	FakeDesc4265	FakeAnc4265	SIMULPF00001	188	183	202	169	14	19
9266	RV_pair4266	FakeDesc4266	FakeAnc4266	SIMULPF00001	362	388	414	336	52	26
9267	RV_pair4267	FakeDesc4267	FakeAnc4267	SIMULPF00001	195	194	215	174	20	21
9268	RV_pair4268	FakeDesc4268	FakeAnc4268	SIMULPF00001	416	420	448	388	32	28
9269	RV_pair4269	FakeDesc4269	FakeAnc4269	SIMULPF00001	103	95	111	87	8	16
9270	RV_pair4270	FakeDesc4270	FakeAnc4270	SIMULPF00001	211	200	227	184	16	27
9271	RV_pair4271	FakeDesc4271	FakeAnc4271	SIMULPF00001	210	204	233	181	23	29
9272	RV_pair4272	FakeDesc4272	FakeAnc4272	SIMULPF00001	717	717	791	643	74	74
9273	RV_pair4273	FakeDesc4273	FakeAnc4273	SIMULPF00001	21	25	26	20	5	1
9274	RV_pair4274	FakeDesc4274	FakeAnc4274	SIMULPF00001	206	209	227	188	21	18
9275	RV_pair4275	FakeDesc4275	FakeAnc4275	SIMULPF00001	834	822	898	758	64	76
9276	RV_pair4276	FakeDesc4276	FakeAnc4276	SIMULPF00001	247	245	274	218	27	29
9277	RV_pair4277	FakeDesc4277	FakeAnc4277	SIMULPF00001	473	479	521	431	48	42
9278	RV_pair4278	FakeDesc4278	FakeAnc4278	SIMULPF00001	78	73	82	69	4	9
9279	RV_pair4279	FakeDesc4279	FakeAnc4279	SIMULPF00001	117	121	127	111	10	6
9280	RV_pair4280	FakeDesc4280	FakeAnc4280	SIMULPF00001	312	314	344	282	32	30
9281	RV_pair4281	FakeDesc4281	FakeAnc4281	SIMULPF00001	24	25	25	24	1	0
9282	RV_pair4282	FakeDesc4282	FakeAnc4282	SIMULPF00001	197	200	216	181	19	16
9283	RV_pair4283	FakeDesc4283	FakeAnc4283	SIMULPF00001	32	30	34	28	2	4
9284	RV_pair4284	FakeDesc4284	FakeAnc4284	SIMULPF00001	522	546	583	485	61	37
9285	RV_pair4285	FakeDesc4285	FakeAnc4285	SIMULPF00001	116	121	133	104	17	12
9286	RV_pair4286	FakeDesc4286	FakeAnc4286	SIMULPF00001	31	32	34	29	3	2
9287	RV_pair4287	FakeDesc4287	FakeAnc4287	SIMULPF00001	92	91	101	82	9	10
9288	RV_pair4288	FakeDesc4288	FakeAnc4288	SIMULPF00001	305	301	330	276	25	29
9289	RV_pair4289	FakeDesc4289	FakeAnc4289	SIMULPF00001	311	324	344	291	33	20
9290	RV_pair4290	FakeDesc4290	FakeAnc4290	SIMULPF00001	110	111	119	102	9	8
9291	RV_pair4291	FakeDesc4291	FakeAnc4291	SIMULPF00001	611	604	674	541	63	70
9292	RV_pair4292	FakeDesc4292	FakeAnc4292	SIMULPF00001	266	280	298	248	32	18
9293	RV_pair4293	FakeDesc4293	FakeAnc4293	SIMULPF00001	184	178	199	163	15	21
9294	RV_pair4294	FakeDesc4294	FakeAnc4294	SIMULPF00001	22	18	22	18	0	4
9295	RV_pair4295	FakeDesc4295	FakeAnc4295	SIMULPF00001	103	104	111	96	8	7
9296	RV_pair4296	FakeDesc4296	FakeAnc4296	SIMULPF00001	14	14	15	13	1	1
9297	RV_pair4297	FakeDesc4297	FakeAnc4297	SIMULPF00001	129	130	147	112	18	17
9298	RV_pair4298	FakeDesc4298	FakeAnc4298	SIMULPF00001	16	21	22	15	6	1
9299	RV_pair4299	FakeDesc4299	FakeAnc4299	SIMULPF00001	133	135	145	123	12	10
9300	RV_pair4300	FakeDesc4300	FakeAnc4300	SIMULPF00001	422	411	454	379	32	43
9301	RV_pair4301	FakeDesc4301	FakeAnc4301	SIMULPF00001	560	574	626	508	66	52
9302	RV_pair4302	FakeDesc4302	FakeAnc4302	SIMULPF00001	200	181	205	176	5	24
9303	RV_pair4303	FakeDesc4303	FakeAnc4303	SIMULPF00001	646	654	708	592	62	54
9304	RV_pair4304	FakeDesc4304	FakeAnc4304	SIMULPF00001	48	55	59	44	11	4
9305	RV_pair4305	FakeDesc4305	FakeAnc4305	SIMULPF00001	6	6	6	6	0	0
9306	RV_pair4306	FakeDesc4306	FakeAnc4306	SIMULPF00001	229	233	249	213	20	16
9307	RV_pair4307	FakeDesc4307	FakeAnc4307	SIMULPF00001	13	12	13	12	0	1
9308	RV_pair4308	FakeDesc4308	FakeAnc4308	SIMULPF00001	242	244	263	223	21	19
9309	RV_pair4309	FakeDesc4309	FakeAnc4309	SIMULPF00001	86	86	95	77	9	9
9310	RV_pair4310	FakeDesc4310	FakeAnc4310	SIMULPF00001	377	376	413	340	36	37
9311	RV_pair4311	FakeDesc4311	FakeAnc4311	SIMULPF00001	577	572	631	518	54	59
9312	RV_pair4312	FakeDesc4312	FakeAnc4312	SIMULPF00001	93	92	103	82	10	11
9313	RV_pair4313	FakeDesc4313	FakeAnc4313	SIMULPF00001	3	3	3	3	0	0
9314	RV_pair4314	FakeDesc4314	FakeAnc4314	SIMULPF00001	4	4	4	4	0	0
9315	RV_pair4315	FakeDesc4315	FakeAnc4315	SIMULPF00001	428	430	473	385	45	43
9316	RV_pair4316	FakeDesc4316	FakeAnc4316	SIMULPF00001	659	659	725	593	66	66
9317	RV_pair4317	FakeDesc4317	FakeAnc4317	SIMULPF00001	119	116	130	105	11	14
9318	RV_pair4318	FakeDesc4318	FakeAnc4318	SIMULPF00001	658	654	716	596	58	62
9319	RV_pair4319	FakeDesc4319	FakeAnc4319	SIMULPF00001	104	109	114	99	10	5
9320	RV_pair4320	FakeDesc4320	FakeAnc4320	SIMULPF00001	46	43	48	41	2	5
9321	RV_pair4321	FakeDesc4321	FakeAnc4321	SIMULPF00001	71	77	82	66	11	5
9322	RV_pair4322	FakeDesc4322	FakeAnc4322	SIMULPF00001	113	119	128	104	15	9
9323	RV_pair4323	FakeDesc4323	FakeAnc4323	SIMULPF00001	18	18	19	17	1	1
9324	RV_pair4324	FakeDesc4324	FakeAnc4324	SIMULPF00001	1	1	1	1	0	0
9325	RV_pair4325	FakeDesc4325	FakeAnc4325	SIMULPF00001	127	127	141	113	14	14
9326	RV_pair4326	FakeDesc4326	FakeAnc4326	SIMULPF00001	20	21	23	18	3	2
9327	RV_pair4327	FakeDesc4327	FakeAnc4327	SIMULPF00001	273	263	292	244	19	29
9328	RV_pair4328	FakeDesc4328	FakeAnc4328	SIMULPF00001	574	574	634	514	60	60
9329	RV_pair4329	FakeDesc4329	FakeAnc4329	SIMULPF00001	187	197	214	170	27	17
9330	RV_pair4330	FakeDesc4330	FakeAnc4330	SIMULPF00001	316	318	344	290	28	26
9331	RV_pair4331	FakeDesc4331	FakeAnc4331	SIMULPF00001	15	18	18	15	3	0
9332	RV_pair4332	FakeDesc4332	FakeAnc4332	SIMULPF00001	548	565	621	492	73	56
9333	RV_pair4333	FakeDesc4333	FakeAnc4333	SIMULPF00001	543	524	588	479	45	64
9334	RV_pair4334	FakeDesc4334	FakeAnc4334	SIMULPF00001	26	23	26	23	0	3
9335	RV_pair4335	FakeDesc4335	FakeAnc4335	SIMULPF00001	52	44	53	43	1	9
9336	RV_pair4336	FakeDesc4336	FakeAnc4336	SIMULPF00001	180	182	192	170	12	10
9337	RV_pair4337	FakeDesc4337	FakeAnc4337	SIMULPF00001	35	32	37	30	2	5
9338	RV_pair4338	FakeDesc4338	FakeAnc4338	SIMULPF00001	81	100	101	80	20	1
9339	RV_pair4339	FakeDesc4339	FakeAnc4339	SIMULPF00001	628	637	698	567	70	61
9340	RV_pair4340	FakeDesc4340	FakeAnc4340	SIMULPF00001	367	357	397	327	30	40
9341	RV_pair4341	FakeDesc4341	FakeAnc4341	SIMULPF00001	418	417	458	377	40	41
9342	RV_pair4342	FakeDesc4342	FakeAnc4342	SIMULPF00001	46	52	56	42	10	4
9343	RV_pair4343	FakeDesc4343	FakeAnc4343	SIMULPF00001	187	193	206	174	19	13
9344	RV_pair4344	FakeDesc4344	FakeAnc4344	SIMULPF00001	85	74	88	71	3	14
9345	RV_pair4345	FakeDesc4345	FakeAnc4345	SIMULPF00001	343	336	374	305	31	38
9346	RV_pair4346	FakeDesc4346	FakeAnc4346	SIMULPF00001	114	114	121	107	7	7
9347	RV_pair4347	FakeDesc4347	FakeAnc4347	SIMULPF00001	864	866	946	784	82	80
9348	RV_pair4348	FakeDesc4348	FakeAnc4348	SIMULPF00001	198	196	210	184	12	14
9349	RV_pair4349	FakeDesc4349	FakeAnc4349	SIMULPF00001	229	228	246	211	17	18
9350	RV_pair4350	FakeDesc4350	FakeAnc4350	SIMULPF00001	70	72	75	67	5	3
9351	RV_pair4351	FakeDesc4351	FakeAnc4351	SIMULPF00001	359	375	399	335	40	24
9352	RV_pair4352	FakeDesc4352	FakeAnc4352	SIMULPF00001	554	561	600	515	46	39
9353	RV_pair4353	FakeDesc4353	FakeAnc4353	SIMULPF00001	240	232	257	215	17	25
9354	RV_pair4354	FakeDesc4354	FakeAnc4354	SIMULPF00001	375	391	427	339	52	36
9355	RV_pair4355	FakeDesc4355	FakeAnc4355	SIMULPF00001	334	334	363	305	29	29
9356	RV_pair4356	FakeDesc4356	FakeAnc4356	SIMULPF00001	53	55	61	47	8	6
9357	RV_pair4357	FakeDesc4357	FakeAnc4357	SIMULPF00001	98	99	102	95	4	3
9358	RV_pair4358	FakeDesc4358	FakeAnc4358	SIMULPF00001	301	306	331	276	30	25
9359	RV_pair4359	FakeDesc4359	FakeAnc4359	SIMULPF00001	10	14	14	10	4	0
9360	RV_pair4360	FakeDesc4360	FakeAnc4360	SIMULPF00001	42	46	49	39	7	3
9361	RV_pair4361	FakeDesc4361	FakeAnc4361	SIMULPF00001	185	175	201	159	16	26
9362	RV_pair4362	FakeDesc4362	FakeAnc4362	SIMULPF00001	72	72	80	64	8	8
9363	RV_pair4363	FakeDesc4363	FakeAnc4363	SIMULPF00001	158	166	174	150	16	8
9364	RV_pair4364	FakeDesc4364	FakeAnc4364	SIMULPF00001	833	851	932	752	99	81
9365	RV_pair4365	FakeDesc4365	FakeAnc4365	SIMULPF00001	84	81	95	70	11	14
9366	RV_pair4366	FakeDesc4366	FakeAnc4366	SIMULPF00001	117	127	133	111	16	6
9367	RV_pair4367	FakeDesc4367	FakeAnc4367	SIMULPF00001	277	283	310	250	33	27
9368	RV_pair4368	FakeDesc4368	FakeAnc4368	SIMULPF00001	700	696	775	621	75	79
9369	RV_pair4369	FakeDesc4369	FakeAnc4369	SIMULPF00001	299	310	329	280	30	19
9370	RV_pair4370	FakeDesc4370	FakeAnc4370	SIMULPF00001	25	25	28	22	3	3
9371	RV_pair4371	FakeDesc4371	FakeAnc4371	SIMULPF00001	362	372	412	322	50	40
9372	RV_pair4372	FakeDesc4372	FakeAnc4372	SIMULPF00001	88	87	99	76	11	12
9373	RV_pair4373	FakeDesc4373	FakeAnc4373	SIMULPF00001	91	87	96	82	5	9
9374	RV_pair4374	FakeDesc4374	FakeAnc4374	SIMULPF00001	7	9	9	7	2	0
9375	RV_pair4375	FakeDesc4375	FakeAnc4375	SIMULPF00001	93	94	105	82	12	11
9376	RV_pair4376	FakeDesc4376	FakeAnc4376	SIMULPF00001	88	83	94	77	6	11
9377	RV_pair4377	FakeDesc4377	FakeAnc4377	SIMULPF00001	435	442	477	400	42	35
9378	RV_pair4378	FakeDesc4378	FakeAnc4378	SIMULPF00001	233	223	243	213	10	20
9379	RV_pair4379	FakeDesc4379	FakeAnc4379	SIMULPF00001	16	13	16	13	0	3
9380	RV_pair4380	FakeDesc4380	FakeAnc4380	SIMULPF00001	260	255	285	230	25	30
9381	RV_pair4381	FakeDesc4381	FakeAnc4381	SIMULPF00001	9	9	9	9	0	0
9382	RV_pair4382	FakeDesc4382	FakeAnc4382	SIMULPF00001	99	98	107	90	8	9
9383	RV_pair4383	FakeDesc4383	FakeAnc4383	SIMULPF00001	205	205	228	182	23	23
9384	RV_pair4384	FakeDesc4384	FakeAnc4384	SIMULPF00001	140	149	160	129	20	11
9385	RV_pair4385	FakeDesc4385	FakeAnc4385	SIMULPF00001	149	137	161	125	12	24
9386	RV_pair4386	FakeDesc4386	FakeAnc4386	SIMULPF00001	198	197	216	179	18	19
9387	RV_pair4387	FakeDesc4387	FakeAnc4387	SIMULPF00001	211	215	228	198	17	13
9388	RV_pair4388	FakeDesc4388	FakeAnc4388	SIMULPF00001	11	10	12	9	1	2
9389	RV_pair4389	FakeDesc4389	FakeAnc4389	SIMULPF00001	440	435	487	388	47	52
9390	RV_pair4390	FakeDesc4390	FakeAnc4390	SIMULPF00001	179	173	199	153	20	26
9391	RV_pair4391	FakeDesc4391	FakeAnc4391	SIMULPF00001	108	105	119	94	11	14
9392	RV_pair4392	FakeDesc4392	FakeAnc4392	SIMULPF00001	441	463	489	415	48	26
9393	RV_pair4393	FakeDesc4393	FakeAnc4393	SIMULPF00001	384	371	412	343	28	41
9394	RV_pair4394	FakeDesc4394	FakeAnc4394	SIMULPF00001	368	369	402	335	34	33
9395	RV_pair4395	FakeDesc4395	FakeAnc4395	SIMULPF00001	247	228	261	214	14	33
9396	RV_pair4396	FakeDesc4396	FakeAnc4396	SIMULPF00001	99	108	113	94	14	5
9397	RV_pair4397	FakeDesc4397	FakeAnc4397	SIMULPF00001	77	75	78	74	1	3
9398	RV_pair4398	FakeDesc4398	FakeAnc4398	SIMULPF00001	253	260	277	236	24	17
9399	RV_pair4399	FakeDesc4399	FakeAnc4399	SIMULPF00001	238	251	274	215	36	23
9400	RV_pair4400	FakeDesc4400	FakeAnc4400	SIMULPF00001	313	299	334	278	21	35
9401	RV_pair4401	FakeDesc4401	FakeAnc4401	SIMULPF00001	141	133	150	124	9	17
9402	RV_pair4402	FakeDesc4402	FakeAnc4402	SIMULPF00001	78	75	83	70	5	8
9403	RV_pair4403	FakeDesc4403	FakeAnc4403	SIMULPF00001	349	337	381	305	32	44
9404	RV_pair4404	FakeDesc4404	FakeAnc4404	SIMULPF00001	225	219	240	204	15	21
9405	RV_pair4405	FakeDesc4405	FakeAnc4405	SIMULPF00001	117	112	128	101	11	16
9406	RV_pair4406	FakeDesc4406	FakeAnc4406	SIMULPF00001	220	219	239	200	19	20
9407	RV_pair4407	FakeDesc4407	FakeAnc4407	SIMULPF00001	328	343	367	304	39	24
9408	RV_pair4408	FakeDesc4408	FakeAnc4408	SIMULPF00001	392	370	418	344	26	48
9409	RV_pair4409	FakeDesc4409	FakeAnc4409	SIMULPF00001	49	58	62	45	13	4
9410	RV_pair4410	FakeDesc4410	FakeAnc4410	SIMULPF00001	232	224	249	207	17	25
9411	RV_pair4411	FakeDesc4411	FakeAnc4411	SIMULPF00001	277	281	314	244	37	33
9412	RV_pair4412	FakeDesc4412	FakeAnc4412	SIMULPF00001	59	58	65	52	6	7
9413	RV_pair4413	FakeDesc4413	FakeAnc4413	SIMULPF00001	271	264	292	243	21	28
9414	RV_pair4414	FakeDesc4414	FakeAnc4414	SIMULPF00001	56	53	59	50	3	6
9415	RV_pair4415	FakeDesc4415	FakeAnc4415	SIMULPF00001	88	86	96	78	8	10
9416	RV_pair4416	FakeDesc4416	FakeAnc4416	SIMULPF00001	324	352	376	300	52	24
9417	RV_pair4417	FakeDesc4417	FakeAnc4417	SIMULPF00001	43	45	48	40	5	3
9418	RV_pair4418	FakeDesc4418	FakeAnc4418	SIMULPF00001	443	441	480	404	37	39
9419	RV_pair4419	FakeDesc4419	FakeAnc4419	SIMULPF00001	773	771	837	707	64	66
9420	RV_pair4420	FakeDesc4420	FakeAnc4420	SIMULPF00001	424	404	459	369	35	55
9421	RV_pair4421	FakeDesc4421	FakeAnc4421	SIMULPF00001	573	566	635	504	62	69
9422	RV_pair4422	FakeDesc4422	FakeAnc4422	SIMULPF00001	70	66	76	60	6	10
9423	RV_pair4423	FakeDesc4423	FakeAnc4423	SIMULPF00001	295	292	319	268	24	27
9424	RV_pair4424	FakeDesc4424	FakeAnc4424	SIMULPF00001	28	31	31	28	3	0
9425	RV_pair4425	FakeDesc4425	FakeAnc4425	SIMULPF00001	47	52	53	46	6	1
9426	RV_pair4426	FakeDesc4426	FakeAnc4426	SIMULPF00001	190	193	206	177	16	13
9427	RV_pair4427	FakeDesc4427	FakeAnc4427	SIMULPF00001	111	107	118	100	7	11
9428	RV_pair4428	FakeDesc4428	FakeAnc4428	SIMULPF00001	159	162	177	144	18	15
9429	RV_pair4429	FakeDesc4429	FakeAnc4429	SIMULPF00001	117	115	125	107	8	10
9430	RV_pair4430	FakeDesc4430	FakeAnc4430	SIMULPF00001	98	111	115	94	17	4
9431	RV_pair4431	FakeDesc4431	FakeAnc4431	SIMULPF00001	18	18	19	17	1	1
9432	RV_pair4432	FakeDesc4432	FakeAnc4432	SIMULPF00001	405	397	432	370	27	35
9433	RV_pair4433	FakeDesc4433	FakeAnc4433	SIMULPF00001	69	66	73	62	4	7
9434	RV_pair4434	FakeDesc4434	FakeAnc4434	SIMULPF00001	90	89	97	82	7	8
9435	RV_pair4435	FakeDesc4435	FakeAnc4435	SIMULPF00001	352	344	374	322	22	30
9436	RV_pair4436	FakeDesc4436	FakeAnc4436	SIMULPF00001	26	22	26	22	0	4
9437	RV_pair4437	FakeDesc4437	FakeAnc4437	SIMULPF00001	362	359	405	316	43	46
9438	RV_pair4438	FakeDesc4438	FakeAnc4438	SIMULPF00001	178	177	191	164	13	14
9439	RV_pair4439	FakeDesc4439	FakeAnc4439	SIMULPF00001	404	428	460	372	56	32
9440	RV_pair4440	FakeDesc4440	FakeAnc4440	SIMULPF00001	46	42	47	41	1	5
9441	RV_pair4441	FakeDesc4441	FakeAnc4441	SIMULPF00001	222	215	245	192	23	30
9442	RV_pair4442	FakeDesc4442	FakeAnc4442	SIMULPF00001	266	298	312	252	46	14
9443	RV_pair4443	FakeDesc4443	FakeAnc4443	SIMULPF00001	214	218	236	196	22	18
9444	RV_pair4444	FakeDesc4444	FakeAnc4444	SIMULPF00001	135	142	149	128	14	7
9445	RV_pair4445	FakeDesc4445	FakeAnc4445	SIMULPF00001	27	25	29	23	2	4
9446	RV_pair4446	FakeDesc4446	FakeAnc4446	SIMULPF00001	350	343	384	309	34	41
9447	RV_pair4447	FakeDesc4447	FakeAnc4447	SIMULPF00001	119	114	127	106	8	13
9448	RV_pair4448	FakeDesc4448	FakeAnc4448	SIMULPF00001	72	72	78	66	6	6
9449	RV_pair4449	FakeDesc4449	FakeAnc4449	SIMULPF00001	275	286	302	259	27	16
9450	RV_pair4450	FakeDesc4450	FakeAnc4450	SIMULPF00001	75	69	80	64	5	11
9451	RV_pair4451	FakeDesc4451	FakeAnc4451	SIMULPF00001	8	7	10	5	2	3
9452	RV_pair4452	FakeDesc4452	FakeAnc4452	SIMULPF00001	315	313	339	289	24	26
9453	RV_pair4453	FakeDesc4453	FakeAnc4453	SIMULPF00001	312	329	353	288	41	24
9454	RV_pair4454	FakeDesc4454	FakeAnc4454	SIMULPF00001	346	331	378	299	32	47
9455	RV_pair4455	FakeDesc4455	FakeAnc4455	SIMULPF00001	523	510	568	465	45	58
9456	RV_pair4456	FakeDesc4456	FakeAnc4456	SIMULPF00001	86	84	94	76	8	10
9457	RV_pair4457	FakeDesc4457	FakeAnc4457	SIMULPF00001	61	62	68	55	7	6
9458	RV_pair4458	FakeDesc4458	FakeAnc4458	SIMULPF00001	347	335	378	304	31	43
9459	RV_pair4459	FakeDesc4459	FakeAnc4459	SIMULPF00001	203	195	220	178	17	25
9460	RV_pair4460	FakeDesc4460	FakeAnc4460	SIMULPF00001	466	444	498	412	32	54
9461	RV_pair4461	FakeDesc4461	FakeAnc4461	SIMULPF00001	395	390	428	357	33	38
9462	RV_pair4462	FakeDesc4462	FakeAnc4462	SIMULPF00001	253	246	271	228	18	25
9463	RV_pair4463	FakeDesc4463	FakeAnc4463	SIMULPF00001	127	130	135	122	8	5
9464	RV_pair4464	FakeDesc4464	FakeAnc4464	SIMULPF00001	160	172	185	147	25	13
9465	RV_pair4465	FakeDesc4465	FakeAnc4465	SIMULPF00001	158	161	176	143	18	15
9466	RV_pair4466	FakeDesc4466	FakeAnc4466	SIMULPF00001	171	164	177	158	6	13
9467	RV_pair4467	FakeDesc4467	FakeAnc4467	SIMULPF00001	42	44	47	39	5	3
9468	RV_pair4468	FakeDesc4468	FakeAnc4468	SIMULPF00001	23	23	28	18	5	5
9469	RV_pair4469	FakeDesc4469	FakeAnc4469	SIMULPF00001	2	2	2	2	0	0
9470	RV_pair4470	FakeDesc4470	FakeAnc4470	SIMULPF00001	165	165	177	153	12	12
9471	RV_pair4471	FakeDesc4471	FakeAnc4471	SIMULPF00001	681	681	751	611	70	70
9472	RV_pair4472	FakeDesc4472	FakeAnc4472	SIMULPF00001	52	51	57	46	5	6
9473	RV_pair4473	FakeDesc4473	FakeAnc4473	SIMULPF00001	294	283	314	263	20	31
9474	RV_pair4474	FakeDesc4474	FakeAnc4474	SIMULPF00001	105	108	113	100	8	5
9475	RV_pair4475	FakeDesc4475	FakeAnc4475	SIMULPF00001	126	116	134	108	8	18
9476	RV_pair4476	FakeDesc4476	FakeAnc4476	SIMULPF00001	30	30	30	30	0	0
9477	RV_pair4477	FakeDesc4477	FakeAnc4477	SIMULPF00001	99	107	111	95	12	4
9478	RV_pair4478	FakeDesc4478	FakeAnc4478	SIMULPF00001	78	85	91	72	13	6
9479	RV_pair4479	FakeDesc4479	FakeAnc4479	SIMULPF00001	352	353	385	320	33	32
9480	RV_pair4480	FakeDesc4480	FakeAnc4480	SIMULPF00001	588	586	646	528	58	60
9481	RV_pair4481	FakeDesc4481	FakeAnc4481	SIMULPF00001	112	122	125	109	13	3
9482	RV_pair4482	FakeDesc4482	FakeAnc4482	SIMULPF00001	267	257	288	236	21	31
9483	RV_pair4483	FakeDesc4483	FakeAnc4483	SIMULPF00001	53	45	53	45	0	8
9484	RV_pair4484	FakeDesc4484	FakeAnc4484	SIMULPF00001	406	425	454	377	48	29
9485	RV_pair4485	FakeDesc4485	FakeAnc4485	SIMULPF00001	135	133	148	120	13	15
9486	RV_pair4486	FakeDesc4486	FakeAnc4486	SIMULPF00001	249	265	277	237	28	12
9487	RV_pair4487	FakeDesc4487	FakeAnc4487	SIMULPF00001	89	91	101	79	12	10
9488	RV_pair4488	FakeDesc4488	FakeAnc4488	SIMULPF00001	334	321	361	294	27	40
9489	RV_pair4489	FakeDesc4489	FakeAnc4489	SIMULPF00001	297	308	333	272	36	25
9490	RV_pair4490	FakeDesc4490	FakeAnc4490	SIMULPF00001	69	64	71	62	2	7
9491	RV_pair4491	FakeDesc4491	FakeAnc4491	SIMULPF00001	306	297	337	266	31	40
9492	RV_pair4492	FakeDesc4492	FakeAnc4492	SIMULPF00001	3	3	3	3	0	0
9493	RV_pair4493	FakeDesc4493	FakeAnc4493	SIMULPF00001	274	273	303	244	29	30
9494	RV_pair4494	FakeDesc4494	FakeAnc4494	SIMULPF00001	105	106	113	98	8	7
9495	RV_pair4495	FakeDesc4495	FakeAnc4495	SIMULPF00001	163	165	181	147	18	16
9496	RV_pair4496	FakeDesc4496	FakeAnc4496	SIMULPF00001	10	13	15	8	5	2
9497	RV_pair4497	FakeDesc4497	FakeAnc4497	SIMULPF00001	3	3	3	3	0	0
9498	RV_pair4498	FakeDesc4498	FakeAnc4498	SIMULPF00001	836	811	908	739	72	97
9499	RV_pair4499	FakeDesc4499	FakeAnc4499	SIMULPF00001	225	217	244	198	19	27
9500	RV_pair4500	FakeDesc4500	FakeAnc4500	SIMULPF00001	45	45	50	40	5	5
9501	RV_pair4501	FakeDesc4501	FakeAnc4501	SIMULPF00001	215	214	233	196	18	19
9502	RV_pair4502	FakeDesc4502	FakeAnc4502	SIMULPF00001	129	138	147	120	18	9
9503	RV_pair4503	FakeDesc4503	FakeAnc4503	SIMULPF00001	62	62	70	54	8	8
9504	RV_pair4504	FakeDesc4504	FakeAnc4504	SIMULPF00001	140	136	144	132	4	8
9505	RV_pair4505	FakeDesc4505	FakeAnc4505	SIMULPF00001	13	12	14	11	1	2
9506	RV_pair4506	FakeDesc4506	FakeAnc4506	SIMULPF00001	222	248	260	210	38	12
9507	RV_pair4507	FakeDesc4507	FakeAnc4507	SIMULPF00001	90	91	98	83	8	7
9508	RV_pair4508	FakeDesc4508	FakeAnc4508	SIMULPF00001	54	56	59	51	5	3
9509	RV_pair4509	FakeDesc4509	FakeAnc4509	SIMULPF00001	98	98	104	92	6	6
9510	RV_pair4510	FakeDesc4510	FakeAnc4510	SIMULPF00001	155	160	173	142	18	13
9511	RV_pair4511	FakeDesc4511	FakeAnc4511	SIMULPF00001	170	173	191	152	21	18
9512	RV_pair4512	FakeDesc4512	FakeAnc4512	SIMULPF00001	47	49	58	38	11	9
9513	RV_pair4513	FakeDesc4513	FakeAnc4513	SIMULPF00001	121	128	137	112	16	9
9514	RV_pair4514	FakeDesc4514	FakeAnc4514	SIMULPF00001	246	262	283	225	37	21
9515	RV_pair4515	FakeDesc4515	FakeAnc4515	SIMULPF00001	335	344	380	299	45	36
9516	RV_pair4516	FakeDesc4516	FakeAnc4516	SIMULPF00001	108	115	124	99	16	9
9517	RV_pair4517	FakeDesc4517	FakeAnc4517	SIMULPF00001	318	305	343	280	25	38
9518	RV_pair4518	FakeDesc4518	FakeAnc4518	SIMULPF00001	9	9	9	9	0	0
9519	RV_pair4519	FakeDesc4519	FakeAnc4519	SIMULPF00001	14	10	15	9	1	5
9520	RV_pair4520	FakeDesc4520	FakeAnc4520	SIMULPF00001	144	157	163	138	19	6
9521	RV_pair4521	FakeDesc4521	FakeAnc4521	SIMULPF00001	17	21	22	16	5	1
9522	RV_pair4522	FakeDesc4522	FakeAnc4522	SIMULPF00001	449	471	509	411	60	38
9523	RV_pair4523	FakeDesc4523	FakeAnc4523	SIMULPF00001	343	358	388	313	45	30
9524	RV_pair4524	FakeDesc4524	FakeAnc4524	SIMULPF00001	231	235	258	208	27	23
9525	RV_pair4525	FakeDesc4525	FakeAnc4525	SIMULPF00001	608	614	675	547	67	61
9526	RV_pair4526	FakeDesc4526	FakeAnc4526	SIMULPF00001	1	1	1	1	0	0
9527	RV_pair4527	FakeDesc4527	FakeAnc4527	SIMULPF00001	160	160	179	141	19	19
9528	RV_pair4528	FakeDesc4528	FakeAnc4528	SIMULPF00001	112	113	124	101	12	11
9529	RV_pair4529	FakeDesc4529	FakeAnc4529	SIMULPF00001	96	90	99	87	3	9
9530	RV_pair4530	FakeDesc4530	FakeAnc4530	SIMULPF00001	644	637	700	581	56	63
9531	RV_pair4531	FakeDesc4531	FakeAnc4531	SIMULPF00001	264	273	299	238	35	26
9532	RV_pair4532	FakeDesc4532	FakeAnc4532	SIMULPF00001	2	3	3	2	1	0
9533	RV_pair4533	FakeDesc4533	FakeAnc4533	SIMULPF00001	246	258	274	230	28	16
9534	RV_pair4534	FakeDesc4534	FakeAnc4534	SIMULPF00001	250	250	269	231	19	19
9535	RV_pair4535	FakeDesc4535	FakeAnc4535	SIMULPF00001	278	270	295	253	17	25
9536	RV_pair4536	FakeDesc4536	FakeAnc4536	SIMULPF00001	523	510	562	471	39	52
9537	RV_pair4537	FakeDesc4537	FakeAnc4537	SIMULPF00001	340	331	376	295	36	45
9538	RV_pair4538	FakeDesc4538	FakeAnc4538	SIMULPF00001	611	594	665	540	54	71
9539	RV_pair4539	FakeDesc4539	FakeAnc4539	SIMULPF00001	135	138	146	127	11	8
9540	RV_pair4540	FakeDesc4540	FakeAnc4540	SIMULPF00001	359	367	397	329	38	30
9541	RV_pair4541	FakeDesc4541	FakeAnc4541	SIMULPF00001	334	318	355	297	21	37
9542	RV_pair4542	FakeDesc4542	FakeAnc4542	SIMULPF00001	10	11	11	10	1	0
9543	RV_pair4543	FakeDesc4543	FakeAnc4543	SIMULPF00001	196	187	207	176	11	20
9544	RV_pair4544	FakeDesc4544	FakeAnc4544	SIMULPF00001	155	166	180	141	25	14
9545	RV_pair4545	FakeDesc4545	FakeAnc4545	SIMULPF00001	647	648	708	587	61	60
9546	RV_pair4546	FakeDesc4546	FakeAnc4546	SIMULPF00001	19	21	21	19	2	0
9547	RV_pair4547	FakeDesc4547	FakeAnc4547	SIMULPF00001	407	411	449	369	42	38
9548	RV_pair4548	FakeDesc4548	FakeAnc4548	SIMULPF00001	90	97	102	85	12	5
9549	RV_pair4549	FakeDesc4549	FakeAnc4549	SIMULPF00001	196	205	221	180	25	16
9550	RV_pair4550	FakeDesc4550	FakeAnc4550	SIMULPF00001	258	258	277	239	19	19
9551	RV_pair4551	FakeDesc4551	FakeAnc4551	SIMULPF00001	222	233	248	207	26	15
9552	RV_pair4552	FakeDesc4552	FakeAnc4552	SIMULPF00001	483	503	547	439	64	44
9553	RV_pair4553	FakeDesc4553	FakeAnc4553	SIMULPF00001	24	21	25	20	1	4
9554	RV_pair4554	FakeDesc4554	FakeAnc4554	SIMULPF00001	88	91	97	82	9	6
9555	RV_pair4555	FakeDesc4555	FakeAnc4555	SIMULPF00001	9	11	11	9	2	0
9556	RV_pair4556	FakeDesc4556	FakeAnc4556	SIMULPF00001	605	603	673	535	68	70
9557	RV_pair4557	FakeDesc4557	FakeAnc4557	SIMULPF00001	74	77	84	67	10	7
9558	RV_pair4558	FakeDesc4558	FakeAnc4558	SIMULPF00001	189	196	208	177	19	12
9559	RV_pair4559	FakeDesc4559	FakeAnc4559	SIMULPF00001	127	118	132	113	5	14
9560	RV_pair4560	FakeDesc4560	FakeAnc4560	SIMULPF00001	8	8	9	7	1	1
9561	RV_pair4561	FakeDesc4561	FakeAnc4561	SIMULPF00001	372	376	406	342	34	30
9562	RV_pair4562	FakeDesc4562	FakeAnc4562	SIMULPF00001	300	289	327	262	27	38
9563	RV_pair4563	FakeDesc4563	FakeAnc4563	SIMULPF00001	2	2	2	2	0	0
9564	RV_pair4564	FakeDesc4564	FakeAnc4564	SIMULPF00001	62	65	69	58	7	4
9565	RV_pair4565	FakeDesc4565	FakeAnc4565	SIMULPF00001	61	68	70	59	9	2
9566	RV_pair4566	FakeDesc4566	FakeAnc4566	SIMULPF00001	133	137	142	128	9	5
9567	RV_pair4567	FakeDesc4567	FakeAnc4567	SIMULPF00001	227	218	242	203	15	24
9568	RV_pair4568	FakeDesc4568	FakeAnc4568	SIMULPF00001	328	302	351	279	23	49
9569	RV_pair4569	FakeDesc4569	FakeAnc4569	SIMULPF00001	149	157	172	134	23	15
9570	RV_pair4570	FakeDesc4570	FakeAnc4570	SIMULPF00001	502	470	544	428	42	74
9571	RV_pair4571	FakeDesc4571	FakeAnc4571	SIMULPF00001	299	307	330	276	31	23
9572	RV_pair4572	FakeDesc4572	FakeAnc4572	SIMULPF00001	91	96	98	89	7	2
9573	RV_pair4573	FakeDesc4573	FakeAnc4573	SIMULPF00001	416	427	457	386	41	30
9574	RV_pair4574	FakeDesc4574	FakeAnc4574	SIMULPF00001	176	177	193	160	17	16
9575	RV_pair4575	FakeDesc4575	FakeAnc4575	SIMULPF00001	161	153	169	145	8	16
9576	RV_pair4576	FakeDesc4576	FakeAnc4576	SIMULPF00001	690	690	756	624	66	66
9577	RV_pair4577	FakeDesc4577	FakeAnc4577	SIMULPF00001	180	175	199	156	19	24
9578	RV_pair4578	FakeDesc4578	FakeAnc4578	SIMULPF00001	137	135	148	124	11	13
9579	RV_pair4579	FakeDesc4579	FakeAnc4579	SIMULPF00001	149	139	164	124	15	25
9580	RV_pair4580	FakeDesc4580	FakeAnc4580	SIMULPF00001	212	223	236	199	24	13
9581	RV_pair4581	FakeDesc4581	FakeAnc4581	SIMULPF00001	183	187	209	161	26	22
9582	RV_pair4582	FakeDesc4582	FakeAnc4582	SIMULPF00001	351	352	388	315	37	36
9583	RV_pair4583	FakeDesc4583	FakeAnc4583	SIMULPF00001	339	340	377	302	38	37
9584	RV_pair4584	FakeDesc4584	FakeAnc4584	SIMULPF00001	131	134	144	121	13	10
9585	RV_pair4585	FakeDesc4585	FakeAnc4585	SIMULPF00001	6	8	8	6	2	0
9586	RV_pair4586	FakeDesc4586	FakeAnc4586	SIMULPF00001	427	420	466	381	39	46
9587	RV_pair4587	FakeDesc4587	FakeAnc4587	SIMULPF00001	194	197	208	183	14	11
9588	RV_pair4588	FakeDesc4588	FakeAnc4588	SIMULPF00001	284	285	305	264	21	20
9589	RV_pair4589	FakeDesc4589	FakeAnc4589	SIMULPF00001	726	692	782	636	56	90
9590	RV_pair4590	FakeDesc4590	FakeAnc4590	SIMULPF00001	237	235	260	212	23	25
9591	RV_pair4591	FakeDesc4591	FakeAnc4591	SIMULPF00001	26	22	27	21	1	5
9592	RV_pair4592	FakeDesc4592	FakeAnc4592	SIMULPF00001	24	24	27	21	3	3
9593	RV_pair4593	FakeDesc4593	FakeAnc4593	SIMULPF00001	66	64	74	56	8	10
9594	RV_pair4594	FakeDesc4594	FakeAnc4594	SIMULPF00001	93	94	100	87	7	6
9595	RV_pair4595	FakeDesc4595	FakeAnc4595	SIMULPF00001	178	175	199	154	21	24
9596	RV_pair4596	FakeDesc4596	FakeAnc4596	SIMULPF00001	48	50	53	45	5	3
9597	RV_pair4597	FakeDesc4597	FakeAnc4597	SIMULPF00001	275	259	295	239	20	36
9598	RV_pair4598	FakeDesc4598	FakeAnc4598	SIMULPF00001	42	42	46	38	4	4
9599	RV_pair4599	FakeDesc4599	FakeAnc4599	SIMULPF00001	94	102	106	90	12	4
9600	RV_pair4600	FakeDesc4600	FakeAnc4600	SIMULPF00001	155	152	169	138	14	17
9601	RV_pair4601	FakeDesc4601	FakeAnc4601	SIMULPF00001	92	101	112	81	20	11
9602	RV_pair4602	FakeDesc4602	FakeAnc4602	SIMULPF00001	519	523	566	476	47	43
9603	RV_pair4603	FakeDesc4603	FakeAnc4603	SIMULPF00001	291	290	326	255	35	36
9604	RV_pair4604	FakeDesc4604	FakeAnc4604	SIMULPF00001	38	40	43	35	5	3
9605	RV_pair4605	FakeDesc4605	FakeAnc4605	SIMULPF00001	688	677	744	621	56	67
9606	RV_pair4606	FakeDesc4606	FakeAnc4606	SIMULPF00001	298	307	333	272	35	26
9607	RV_pair4607	FakeDesc4607	FakeAnc4607	SIMULPF00001	87	89	92	84	5	3
9608	RV_pair4608	FakeDesc4608	FakeAnc4608	SIMULPF00001	212	218	231	199	19	13
9609	RV_pair4609	FakeDesc4609	FakeAnc4609	SIMULPF00001	475	479	522	432	47	43
9610	RV_pair4610	FakeDesc4610	FakeAnc4610	SIMULPF00001	18	18	18	18	0	0
9611	RV_pair4611	FakeDesc4611	FakeAnc4611	SIMULPF00001	61	59	68	52	7	9
9612	RV_pair4612	FakeDesc4612	FakeAnc4612	SIMULPF00001	21	19	21	19	0	2
9613	RV_pair4613	FakeDesc4613	FakeAnc4613	SIMULPF00001	143	153	163	133	20	10
9614	RV_pair4614	FakeDesc4614	FakeAnc4614	SIMULPF00001	138	142	155	125	17	13
9615	RV_pair4615	FakeDesc4615	FakeAnc4615	SIMULPF00001	35	30	37	28	2	7
9616	RV_pair4616	FakeDesc4616	FakeAnc4616	SIMULPF00001	69	73	77	65	8	4
9617	RV_pair4617	FakeDesc4617	FakeAnc4617	SIMULPF00001	405	417	446	376	41	29
9618	RV_pair4618	FakeDesc4618	FakeAnc4618	SIMULPF00001	291	291	322	260	31	31
9619	RV_pair4619	FakeDesc4619	FakeAnc4619	SIMULPF00001	272	276	296	252	24	20
9620	RV_pair4620	FakeDesc4620	FakeAnc4620	SIMULPF00001	108	103	115	96	7	12
9621	RV_pair4621	FakeDesc4621	FakeAnc4621	SIMULPF00001	117	118	127	108	10	9
9622	RV_pair4622	FakeDesc4622	FakeAnc4622	SIMULPF00001	27	26	31	22	4	5
9623	RV_pair4623	FakeDesc4623	FakeAnc4623	SIMULPF00001	134	141	149	126	15	8
9624	RV_pair4624	FakeDesc4624	FakeAnc4624	SIMULPF00001	370	361	395	336	25	34
9625	RV_pair4625	FakeDesc4625	FakeAnc4625	SIMULPF00001	95	81	100	76	5	19
9626	RV_pair4626	FakeDesc4626	FakeAnc4626	SIMULPF00001	54	55	58	51	4	3
9627	RV_pair4627	FakeDesc4627	FakeAnc4627	SIMULPF00001	175	175	193	157	18	18
9628	RV_pair4628	FakeDesc4628	FakeAnc4628	SIMULPF00001	104	105	112	97	8	7
9629	RV_pair4629	FakeDesc4629	FakeAnc4629	SIMULPF00001	75	80	83	72	8	3
9630	RV_pair4630	FakeDesc4630	FakeAnc4630	SIMULPF00001	260	260	284	236	24	24
9631	RV_pair4631	FakeDesc4631	FakeAnc4631	SIMULPF00001	130	132	142	120	12	10
9632	RV_pair4632	FakeDesc4632	FakeAnc4632	SIMULPF00001	382	377	422	337	40	45
9633	RV_pair4633	FakeDesc4633	FakeAnc4633	SIMULPF00001	380	370	418	332	38	48
9634	RV_pair4634	FakeDesc4634	FakeAnc4634	SIMULPF00001	192	198	215	175	23	17
9635	RV_pair4635	FakeDesc4635	FakeAnc4635	SIMULPF00001	724	738	806	656	82	68
9636	RV_pair4636	FakeDesc4636	FakeAnc4636	SIMULPF00001	209	213	225	197	16	12
9637	RV_pair4637	FakeDesc4637	FakeAnc4637	SIMULPF00001	34	30	35	29	1	5
9638	RV_pair4638	FakeDesc4638	FakeAnc4638	SIMULPF00001	524	538	573	489	49	35
9639	RV_pair4639	FakeDesc4639	FakeAnc4639	SIMULPF00001	347	342	377	312	30	35
9640	RV_pair4640	FakeDesc4640	FakeAnc4640	SIMULPF00001	217	228	251	194	34	23
9641	RV_pair4641	FakeDesc4641	FakeAnc4641	SIMULPF00001	141	144	151	134	10	7
9642	RV_pair4642	FakeDesc4642	FakeAnc4642	SIMULPF00001	29	31	33	27	4	2
9643	RV_pair4643	FakeDesc4643	FakeAnc4643	SIMULPF00001	112	118	126	104	14	8
9644	RV_pair4644	FakeDesc4644	FakeAnc4644	SIMULPF00001	78	74	86	66	8	12
9645	RV_pair4645	FakeDesc4645	FakeAnc4645	SIMULPF00001	351	361	395	317	44	34
9646	RV_pair4646	FakeDesc4646	FakeAnc4646	SIMULPF00001	183	184	198	169	15	14
9647	RV_pair4647	FakeDesc4647	FakeAnc4647	SIMULPF00001	406	398	441	363	35	43
9648	RV_pair4648	FakeDesc4648	FakeAnc4648	SIMULPF00001	230	229	248	211	18	19
9649	RV_pair4649	FakeDesc4649	FakeAnc4649	SIMULPF00001	7	4	7	4	0	3
9650	RV_pair4650	FakeDesc4650	FakeAnc4650	SIMULPF00001	318	323	349	292	31	26
9651	RV_pair4651	FakeDesc4651	FakeAnc4651	SIMULPF00001	71	72	78	65	7	6
9652	RV_pair4652	FakeDesc4652	FakeAnc4652	SIMULPF00001	407	408	442	373	35	34
9653	RV_pair4653	FakeDesc4653	FakeAnc4653	SIMULPF00001	472	466	513	425	41	47
9654	RV_pair4654	FakeDesc4654	FakeAnc4654	SIMULPF00001	460	461	504	417	44	43
9655	RV_pair4655	FakeDesc4655	FakeAnc4655	SIMULPF00001	162	167	178	151	16	11
9656	RV_pair4656	FakeDesc4656	FakeAnc4656	SIMULPF00001	9	9	9	9	0	0
9657	RV_pair4657	FakeDesc4657	FakeAnc4657	SIMULPF00001	28	27	31	24	3	4
9658	RV_pair4658	FakeDesc4658	FakeAnc4658	SIMULPF00001	230	251	266	215	36	15
9659	RV_pair4659	FakeDesc4659	FakeAnc4659	SIMULPF00001	4	5	5	4	1	0
9660	RV_pair4660	FakeDesc4660	FakeAnc4660	SIMULPF00001	40	43	45	38	5	2
9661	RV_pair4661	FakeDesc4661	FakeAnc4661	SIMULPF00001	73	73	77	69	4	4
9662	RV_pair4662	FakeDesc4662	FakeAnc4662	SIMULPF00001	176	183	201	158	25	18
9663	RV_pair4663	FakeDesc4663	FakeAnc4663	SIMULPF00001	89	94	101	82	12	7
9664	RV_pair4664	FakeDesc4664	FakeAnc4664	SIMULPF00001	160	160	173	147	13	13
9665	RV_pair4665	FakeDesc4665	FakeAnc4665	SIMULPF00001	25	26	26	25	1	0
9666	RV_pair4666	FakeDesc4666	FakeAnc4666	SIMULPF00001	94	95	100	89	6	5
9667	RV_pair4667	FakeDesc4667	FakeAnc4667	SIMULPF00001	14	16	17	13	3	1
9668	RV_pair4668	FakeDesc4668	FakeAnc4668	SIMULPF00001	3	3	3	3	0	0
9669	RV_pair4669	FakeDesc4669	FakeAnc4669	SIMULPF00001	31	24	31	24	0	7
9670	RV_pair4670	FakeDesc4670	FakeAnc4670	SIMULPF00001	460	448	491	417	31	43
9671	RV_pair4671	FakeDesc4671	FakeAnc4671	SIMULPF00001	207	214	230	191	23	16
9672	RV_pair4672	FakeDesc4672	FakeAnc4672	SIMULPF00001	147	145	157	135	10	12
9673	RV_pair4673	FakeDesc4673	FakeAnc4673	SIMULPF00001	275	273	300	248	25	27
9674	RV_pair4674	FakeDesc4674	FakeAnc4674	SIMULPF00001	32	28	32	28	0	4
9675	RV_pair4675	FakeDesc4675	FakeAnc4675	SIMULPF00001	102	98	110	90	8	12
9676	RV_pair4676	FakeDesc4676	FakeAnc4676	SIMULPF00001	25	26	27	24	2	1
9677	RV_pair4677	FakeDesc4677	FakeAnc4677	SIMULPF00001	63	60	68	55	5	8
9678	RV_pair4678	FakeDesc4678	FakeAnc4678	SIMULPF00001	136	129	143	122	7	14
9679	RV_pair4679	FakeDesc4679	FakeAnc4679	SIMULPF00001	179	184	200	163	21	16
9680	RV_pair4680	FakeDesc4680	FakeAnc4680	SIMULPF00001	219	219	233	205	14	14
9681	RV_pair4681	FakeDesc4681	FakeAnc4681	SIMULPF00001	159	175	186	148	27	11
9682	RV_pair4682	FakeDesc4682	FakeAnc4682	SIMULPF00001	272	272	299	245	27	27
9683	RV_pair4683	FakeDesc4683	FakeAnc4683	SIMULPF00001	276	268	300	244	24	32
9684	RV_pair4684	FakeDesc4684	FakeAnc4684	SIMULPF00001	550	537	603	484	53	66
9685	RV_pair4685	FakeDesc4685	FakeAnc4685	SIMULPF00001	119	113	126	106	7	13
9686	RV_pair4686	FakeDesc4686	FakeAnc4686	SIMULPF00001	447	431	482	396	35	51
9687	RV_pair4687	FakeDesc4687	FakeAnc4687	SIMULPF00001	222	230	244	208	22	14
9688	RV_pair4688	FakeDesc4688	FakeAnc4688	SIMULPF00001	152	147	163	136	11	16
9689	RV_pair4689	FakeDesc4689	FakeAnc4689	SIMULPF00001	88	92	98	82	10	6
9690	RV_pair4690	FakeDesc4690	FakeAnc4690	SIMULPF00001	159	155	167	147	8	12
9691	RV_pair4691	FakeDesc4691	FakeAnc4691	SIMULPF00001	277	287	303	261	26	16
9692	RV_pair4692	FakeDesc4692	FakeAnc4692	SIMULPF00001	439	447	492	394	53	45
9693	RV_pair4693	FakeDesc4693	FakeAnc4693	SIMULPF00001	169	185	195	159	26	10
9694	RV_pair4694	FakeDesc4694	FakeAnc4694	SIMULPF00001	170	172	193	149	23	21
9695	RV_pair4695	FakeDesc4695	FakeAnc4695	SIMULPF00001	608	581	656	533	48	75
9696	RV_pair4696	FakeDesc4696	FakeAnc4696	SIMULPF00001	35	37	39	33	4	2
9697	RV_pair4697	FakeDesc4697	FakeAnc4697	SIMULPF00001	29	31	31	29	2	0
9698	RV_pair4698	FakeDesc4698	FakeAnc4698	SIMULPF00001	215	221	239	197	24	18
9699	RV_pair4699	FakeDesc4699	FakeAnc4699	SIMULPF00001	120	117	128	109	8	11
9700	RV_pair4700	FakeDesc4700	FakeAnc4700	SIMULPF00001	322	331	358	295	36	27
9701	RV_pair4701	FakeDesc4701	FakeAnc4701	SIMULPF00001	78	88	93	73	15	5
9702	RV_pair4702	FakeDesc4702	FakeAnc4702	SIMULPF00001	94	99	104	89	10	5
9703	RV_pair4703	FakeDesc4703	FakeAnc4703	SIMULPF00001	96	98	110	84	14	12
9704	RV_pair4704	FakeDesc4704	FakeAnc4704	SIMULPF00001	802	797	868	731	66	71
9705	RV_pair4705	FakeDesc4705	FakeAnc4705	SIMULPF00001	234	238	251	221	17	13
9706	RV_pair4706	FakeDesc4706	FakeAnc4706	SIMULPF00001	485	481	521	445	36	40
9707	RV_pair4707	FakeDesc4707	FakeAnc4707	SIMULPF00001	152	164	174	142	22	10
9708	RV_pair4708	FakeDesc4708	FakeAnc4708	SIMULPF00001	27	28	31	24	4	3
9709	RV_pair4709	FakeDesc4709	FakeAnc4709	SIMULPF00001	433	425	464	394	31	39
9710	RV_pair4710	FakeDesc4710	FakeAnc4710	SIMULPF00001	436	417	471	382	35	54
9711	RV_pair4711	FakeDesc4711	FakeAnc4711	SIMULPF00001	117	112	128	101	11	16
9712	RV_pair4712	FakeDesc4712	FakeAnc4712	SIMULPF00001	30	31	32	29	2	1
9713	RV_pair4713	FakeDesc4713	FakeAnc4713	SIMULPF00001	33	35	37	31	4	2
9714	RV_pair4714	FakeDesc4714	FakeAnc4714	SIMULPF00001	47	41	50	38	3	9
9715	RV_pair4715	FakeDesc4715	FakeAnc4715	SIMULPF00001	56	49	58	47	2	9
9716	RV_pair4716	FakeDesc4716	FakeAnc4716	SIMULPF00001	6	7	7	6	1	0
9717	RV_pair4717	FakeDesc4717	FakeAnc4717	SIMULPF00001	49	53	57	45	8	4
9718	RV_pair4718	FakeDesc4718	FakeAnc4718	SIMULPF00001	486	471	523	434	37	52
9719	RV_pair4719	FakeDesc4719	FakeAnc4719	SIMULPF00001	529	521	575	475	46	54
9720	RV_pair4720	FakeDesc4720	FakeAnc4720	SIMULPF00001	23	19	24	18	1	5
9721	RV_pair4721	FakeDesc4721	FakeAnc4721	SIMULPF00001	63	57	66	54	3	9
9722	RV_pair4722	FakeDesc4722	FakeAnc4722	SIMULPF00001	73	74	81	66	8	7
9723	RV_pair4723	FakeDesc4723	FakeAnc4723	SIMULPF00001	180	183	202	161	22	19
9724	RV_pair4724	FakeDesc4724	FakeAnc4724	SIMULPF00001	217	197	229	185	12	32
9725	RV_pair4725	FakeDesc4725	FakeAnc4725	SIMULPF00001	21	21	26	16	5	5
9726	RV_pair4726	FakeDesc4726	FakeAnc4726	SIMULPF00001	39	42	45	36	6	3
9727	RV_pair4727	FakeDesc4727	FakeAnc4727	SIMULPF00001	66	64	71	59	5	7
9728	RV_pair4728	FakeDesc4728	FakeAnc4728	SIMULPF00001	9	5	10	4	1	5
9729	RV_pair4729	FakeDesc4729	FakeAnc4729	SIMULPF00001	392	392	421	363	29	29
9730	RV_pair4730	FakeDesc4730	FakeAnc4730	SIMULPF00001	114	105	121	98	7	16
9731	RV_pair4731	FakeDesc4731	FakeAnc4731	SIMULPF00001	146	151	163	134	17	12
9732	RV_pair4732	FakeDesc4732	FakeAnc4732	SIMULPF00001	78	79	90	67	12	11
9733	RV_pair4733	FakeDesc4733	FakeAnc4733	SIMULPF00001	350	359	395	314	45	36
9734	RV_pair4734	FakeDesc4734	FakeAnc4734	SIMULPF00001	340	330	367	303	27	37
9735	RV_pair4735	FakeDesc4735	FakeAnc4735	SIMULPF00001	562	556	614	504	52	58
9736	RV_pair4736	FakeDesc4736	FakeAnc4736	SIMULPF00001	65	66	73	58	8	7
9737	RV_pair4737	FakeDesc4737	FakeAnc4737	SIMULPF00001	14	14	16	12	2	2
9738	RV_pair4738	FakeDesc4738	FakeAnc4738	SIMULPF00001	104	99	108	95	4	9
9739	RV_pair4739	FakeDesc4739	FakeAnc4739	SIMULPF00001	215	207	232	190	17	25
9740	RV_pair4740	FakeDesc4740	FakeAnc4740	SIMULPF00001	144	145	159	130	15	14
9741	RV_pair4741	FakeDesc4741	FakeAnc4741	SIMULPF00001	11	9	11	9	0	2
9742	RV_pair4742	FakeDesc4742	FakeAnc4742	SIMULPF00001	114	115	121	108	7	6
9743	RV_pair4743	FakeDesc4743	FakeAnc4743	SIMULPF00001	106	96	111	91	5	15
9744	RV_pair4744	FakeDesc4744	FakeAnc4744	SIMULPF00001	520	519	570	469	50	51
9745	RV_pair4745	FakeDesc4745	FakeAnc4745	SIMULPF00001	127	126	140	113	13	14
9746	RV_pair4746	FakeDesc4746	FakeAnc4746	SIMULPF00001	86	88	96	78	10	8
9747	RV_pair4747	FakeDesc4747	FakeAnc4747	SIMULPF00001	190	189	209	170	19	20
9748	RV_pair4748	FakeDesc4748	FakeAnc4748	SIMULPF00001	369	373	405	337	36	32
9749	RV_pair4749	FakeDesc4749	FakeAnc4749	SIMULPF00001	180	185	197	168	17	12
9750	RV_pair4750	FakeDesc4750	FakeAnc4750	SIMULPF00001	19	21	21	19	2	0
9751	RV_pair4751	FakeDesc4751	FakeAnc4751	SIMULPF00001	11	8	11	8	0	3
9752	RV_pair4752	FakeDesc4752	FakeAnc4752	SIMULPF00001	275	276	299	252	24	23
9753	RV_pair4753	FakeDesc4753	FakeAnc4753	SIMULPF00001	431	430	468	393	37	38
9754	RV_pair4754	FakeDesc4754	FakeAnc4754	SIMULPF00001	328	326	358	296	30	32
9755	RV_pair4755	FakeDesc4755	FakeAnc4755	SIMULPF00001	468	460	507	421	39	47
9756	RV_pair4756	FakeDesc4756	FakeAnc4756	SIMULPF00001	226	251	262	215	36	11
9757	RV_pair4757	FakeDesc4757	FakeAnc4757	SIMULPF00001	53	53	58	48	5	5
9758	RV_pair4758	FakeDesc4758	FakeAnc4758	SIMULPF00001	190	209	224	175	34	15
9759	RV_pair4759	FakeDesc4759	FakeAnc4759	SIMULPF00001	46	46	50	42	4	4
9760	RV_pair4760	FakeDesc4760	FakeAnc4760	SIMULPF00001	125	123	130	118	5	7
9761	RV_pair4761	FakeDesc4761	FakeAnc4761	SIMULPF00001	12	11	12	11	0	1
9762	RV_pair4762	FakeDesc4762	FakeAnc4762	SIMULPF00001	51	46	52	45	1	6
9763	RV_pair4763	FakeDesc4763	FakeAnc4763	SIMULPF00001	107	110	117	100	10	7
9764	RV_pair4764	FakeDesc4764	FakeAnc4764	SIMULPF00001	740	730	803	667	63	73
9765	RV_pair4765	FakeDesc4765	FakeAnc4765	SIMULPF00001	366	359	394	331	28	35
9766	RV_pair4766	FakeDesc4766	FakeAnc4766	SIMULPF00001	10	10	10	10	0	0
9767	RV_pair4767	FakeDesc4767	FakeAnc4767	SIMULPF00001	44	44	45	43	1	1
9768	RV_pair4768	FakeDesc4768	FakeAnc4768	SIMULPF00001	390	389	435	344	45	46
9769	RV_pair4769	FakeDesc4769	FakeAnc4769	SIMULPF00001	221	213	245	189	24	32
9770	RV_pair4770	FakeDesc4770	FakeAnc4770	SIMULPF00001	456	439	488	407	32	49
9771	RV_pair4771	FakeDesc4771	FakeAnc4771	SIMULPF00001	236	236	254	218	18	18
9772	RV_pair4772	FakeDesc4772	FakeAnc4772	SIMULPF00001	23	24	25	22	2	1
9773	RV_pair4773	FakeDesc4773	FakeAnc4773	SIMULPF00001	463	471	503	431	40	32
9774	RV_pair4774	FakeDesc4774	FakeAnc4774	SIMULPF00001	442	460	491	411	49	31
9775	RV_pair4775	FakeDesc4775	FakeAnc4775	SIMULPF00001	63	60	67	56	4	7
9776	RV_pair4776	FakeDesc4776	FakeAnc4776	SIMULPF00001	302	313	337	278	35	24
9777	RV_pair4777	FakeDesc4777	FakeAnc4777	SIMULPF00001	102	101	110	93	8	9
9778	RV_pair4778	FakeDesc4778	FakeAnc4778	SIMULPF00001	303	296	320	279	17	24
9779	RV_pair4779	FakeDesc4779	FakeAnc4779	SIMULPF00001	10	10	11	9	1	1
9780	RV_pair4780	FakeDesc4780	FakeAnc4780	SIMULPF00001	437	426	480	383	43	54
9781	RV_pair4781	FakeDesc4781	FakeAnc4781	SIMULPF00001	498	498	542	454	44	44
9782	RV_pair4782	FakeDesc4782	FakeAnc4782	SIMULPF00001	134	144	156	122	22	12
9783	RV_pair4783	FakeDesc4783	FakeAnc4783	SIMULPF00001	104	100	111	93	7	11
9784	RV_pair4784	FakeDesc4784	FakeAnc4784	SIMULPF00001	528	519	571	476	43	52
9785	RV_pair4785	FakeDesc4785	FakeAnc4785	SIMULPF00001	203	192	217	178	14	25
9786	RV_pair4786	FakeDesc4786	FakeAnc4786	SIMULPF00001	24	24	27	21	3	3
9787	RV_pair4787	FakeDesc4787	FakeAnc4787	SIMULPF00001	384	369	413	340	29	44
9788	RV_pair4788	FakeDesc4788	FakeAnc4788	SIMULPF00001	76	69	83	62	7	14
9789	RV_pair4789	FakeDesc4789	FakeAnc4789	SIMULPF00001	105	97	114	88	9	17
9790	RV_pair4790	FakeDesc4790	FakeAnc4790	SIMULPF00001	206	205	232	179	26	27
9791	RV_pair4791	FakeDesc4791	FakeAnc4791	SIMULPF00001	20	20	20	20	0	0
9792	RV_pair4792	FakeDesc4792	FakeAnc4792	SIMULPF00001	68	75	80	63	12	5
9793	RV_pair4793	FakeDesc4793	FakeAnc4793	SIMULPF00001	198	189	218	169	20	29
9794	RV_pair4794	FakeDesc4794	FakeAnc4794	SIMULPF00001	21	21	22	20	1	1
9795	RV_pair4795	FakeDesc4795	FakeAnc4795	SIMULPF00001	169	165	177	157	8	12
9796	RV_pair4796	FakeDesc4796	FakeAnc4796	SIMULPF00001	211	214	237	188	26	23
9797	RV_pair4797	FakeDesc4797	FakeAnc4797	SIMULPF00001	61	62	70	53	9	8
9798	RV_pair4798	FakeDesc4798	FakeAnc4798	SIMULPF00001	237	243	268	212	31	25
9799	RV_pair4799	FakeDesc4799	FakeAnc4799	SIMULPF00001	458	468	506	420	48	38
9800	RV_pair4800	FakeDesc4800	FakeAnc4800	SIMULPF00001	239	228	257	210	18	29
9801	RV_pair4801	FakeDesc4801	FakeAnc4801	SIMULPF00001	137	144	156	125	19	12
9802	RV_pair4802	FakeDesc4802	FakeAnc4802	SIMULPF00001	299	288	318	269	19	30
9803	RV_pair4803	FakeDesc4803	FakeAnc4803	SIMULPF00001	239	242	261	220	22	19
9804	RV_pair4804	FakeDesc4804	FakeAnc4804	SIMULPF00001	352	372	402	322	50	30
9805	RV_pair4805	FakeDesc4805	FakeAnc4805	SIMULPF00001	246	241	265	222	19	24
9806	RV_pair4806	FakeDesc4806	FakeAnc4806	SIMULPF00001	149	159	176	132	27	17
9807	RV_pair4807	FakeDesc4807	FakeAnc4807	SIMULPF00001	93	89	98	84	5	9
9808	RV_pair4808	FakeDesc4808	FakeAnc4808	SIMULPF00001	214	216	238	192	24	22
9809	RV_pair4809	FakeDesc4809	FakeAnc4809	SIMULPF00001	566	556	620	502	54	64
9810	RV_pair4810	FakeDesc4810	FakeAnc4810	SIMULPF00001	203	203	221	185	18	18
9811	RV_pair4811	FakeDesc4811	FakeAnc4811	SIMULPF00001	195	185	214	166	19	29
9812	RV_pair4812	FakeDesc4812	FakeAnc4812	SIMULPF00001	38	41	42	37	4	1
9813	RV_pair4813	FakeDesc4813	FakeAnc4813	SIMULPF00001	186	191	212	165	26	21
9814	RV_pair4814	FakeDesc4814	FakeAnc4814	SIMULPF00001	522	525	571	476	49	46
9815	RV_pair4815	FakeDesc4815	FakeAnc4815	SIMULPF00001	256	243	274	225	18	31
9816	RV_pair4816	FakeDesc4816	FakeAnc4816	SIMULPF00001	82	82	89	75	7	7
9817	RV_pair4817	FakeDesc4817	FakeAnc4817	SIMULPF00001	844	844	912	776	68	68
9818	RV_pair4818	FakeDesc4818	FakeAnc4818	SIMULPF00001	168	172	187	153	19	15
9819	RV_pair4819	FakeDesc4819	FakeAnc4819	SIMULPF00001	7	7	8	6	1	1
9820	RV_pair4820	FakeDesc4820	FakeAnc4820	SIMULPF00001	107	100	117	90	10	17
9821	RV_pair4821	FakeDesc4821	FakeAnc4821	SIMULPF00001	49	45	51	43	2	6
9822	RV_pair4822	FakeDesc4822	FakeAnc4822	SIMULPF00001	45	44	47	42	2	3
9823	RV_pair4823	FakeDesc4823	FakeAnc4823	SIMULPF00001	378	369	414	333	36	45
9824	RV_pair4824	FakeDesc4824	FakeAnc4824	SIMULPF00001	359	358	391	326	32	33
9825	RV_pair4825	FakeDesc4825	FakeAnc4825	SIMULPF00001	205	195	221	179	16	26
9826	RV_pair4826	FakeDesc4826	FakeAnc4826	SIMULPF00001	239	241	270	210	31	29
9827	RV_pair4827	FakeDesc4827	FakeAnc4827	SIMULPF00001	324	321	352	293	28	31
9828	RV_pair4828	FakeDesc4828	FakeAnc4828	SIMULPF00001	563	569	612	520	49	43
9829	RV_pair4829	FakeDesc4829	FakeAnc4829	SIMULPF00001	47	46	52	41	5	6
9830	RV_pair4830	FakeDesc4830	FakeAnc4830	SIMULPF00001	139	136	146	129	7	10
9831	RV_pair4831	FakeDesc4831	FakeAnc4831	SIMULPF00001	102	105	113	94	11	8
9832	RV_pair4832	FakeDesc4832	FakeAnc4832	SIMULPF00001	166	166	187	145	21	21
9833	RV_pair4833	FakeDesc4833	FakeAnc4833	SIMULPF00001	61	61	70	52	9	9
9834	RV_pair4834	FakeDesc4834	FakeAnc4834	SIMULPF00001	343	357	387	313	44	30
9835	RV_pair4835	FakeDesc4835	FakeAnc4835	SIMULPF00001	309	303	327	285	18	24
9836	RV_pair4836	FakeDesc4836	FakeAnc4836	SIMULPF00001	139	140	149	130	10	9
9837	RV_pair4837	FakeDesc4837	FakeAnc4837	SIMULPF00001	53	52	55	50	2	3
9838	RV_pair4838	FakeDesc4838	FakeAnc4838	SIMULPF00001	696	694	763	627	67	69
9839	RV_pair4839	FakeDesc4839	FakeAnc4839	SIMULPF00001	312	313	342	283	30	29
9840	RV_pair4840	FakeDesc4840	FakeAnc4840	SIMULPF00001	115	108	123	100	8	15
9841	RV_pair4841	FakeDesc4841	FakeAnc4841	SIMULPF00001	13	13	13	13	0	0
9842	RV_pair4842	FakeDesc4842	FakeAnc4842	SIMULPF00001	150	160	166	144	16	6
9843	RV_pair4843	FakeDesc4843	FakeAnc4843	SIMULPF00001	33	33	35	31	2	2
9844	RV_pair4844	FakeDesc4844	FakeAnc4844	SIMULPF00001	346	346	379	313	33	33
9845	RV_pair4845	FakeDesc4845	FakeAnc4845	SIMULPF00001	245	236	263	218	18	27
9846	RV_pair4846	FakeDesc4846	FakeAnc4846	SIMULPF00001	310	318	343	285	33	25
9847	RV_pair4847	FakeDesc4847	FakeAnc4847	SIMULPF00001	35	32	35	32	0	3
9848	RV_pair4848	FakeDesc4848	FakeAnc4848	SIMULPF00001	24	22	25	21	1	3
9849	RV_pair4849	FakeDesc4849	FakeAnc4849	SIMULPF00001	185	187	201	171	16	14
9850	RV_pair4850	FakeDesc4850	FakeAnc4850	SIMULPF00001	49	45	51	43	2	6
9851	RV_pair4851	FakeDesc4851	FakeAnc4851	SIMULPF00001	101	107	116	92	15	9
9852	RV_pair4852	FakeDesc4852	FakeAnc4852	SIMULPF00001	359	367	394	332	35	27
9853	RV_pair4853	FakeDesc4853	FakeAnc4853	SIMULPF00001	706	677	763	620	57	86
9854	RV_pair4854	FakeDesc4854	FakeAnc4854	SIMULPF00001	195	209	220	184	25	11
9855	RV_pair4855	FakeDesc4855	FakeAnc4855	SIMULPF00001	215	197	226	186	11	29
9856	RV_pair4856	FakeDesc4856	FakeAnc4856	SIMULPF00001	21	22	23	20	2	1
9857	RV_pair4857	FakeDesc4857	FakeAnc4857	SIMULPF00001	44	44	46	42	2	2
9858	RV_pair4858	FakeDesc4858	FakeAnc4858	SIMULPF00001	29	27	29	27	0	2
9859	RV_pair4859	FakeDesc4859	FakeAnc4859	SIMULPF00001	383	395	424	354	41	29
9860	RV_pair4860	FakeDesc4860	FakeAnc4860	SIMULPF00001	466	463	506	423	40	43
9861	RV_pair4861	FakeDesc4861	FakeAnc4861	SIMULPF00001	74	90	93	71	19	3
9862	RV_pair4862	FakeDesc4862	FakeAnc4862	SIMULPF00001	44	45	48	41	4	3
9863	RV_pair4863	FakeDesc4863	FakeAnc4863	SIMULPF00001	280	288	312	256	32	24
9864	RV_pair4864	FakeDesc4864	FakeAnc4864	SIMULPF00001	337	323	369	291	32	46
9865	RV_pair4865	FakeDesc4865	FakeAnc4865	SIMULPF00001	21	21	22	20	1	1
9866	RV_pair4866	FakeDesc4866	FakeAnc4866	SIMULPF00001	156	151	162	145	6	11
9867	RV_pair4867	FakeDesc4867	FakeAnc4867	SIMULPF00001	85	78	90	73	5	12
9868	RV_pair4868	FakeDesc4868	FakeAnc4868	SIMULPF00001	236	242	261	217	25	19
9869	RV_pair4869	FakeDesc4869	FakeAnc4869	SIMULPF00001	113	115	131	97	18	16
9870	RV_pair4870	FakeDesc4870	FakeAnc4870	SIMULPF00001	385	386	425	346	40	39
9871	RV_pair4871	FakeDesc4871	FakeAnc4871	SIMULPF00001	260	272	292	240	32	20
9872	RV_pair4872	FakeDesc4872	FakeAnc4872	SIMULPF00001	399	382	417	364	18	35
9873	RV_pair4873	FakeDesc4873	FakeAnc4873	SIMULPF00001	524	521	582	463	58	61
9874	RV_pair4874	FakeDesc4874	FakeAnc4874	SIMULPF00001	206	196	220	182	14	24
9875	RV_pair4875	FakeDesc4875	FakeAnc4875	SIMULPF00001	418	420	454	384	36	34
9876	RV_pair4876	FakeDesc4876	FakeAnc4876	SIMULPF00001	193	197	210	180	17	13
9877	RV_pair4877	FakeDesc4877	FakeAnc4877	SIMULPF00001	576	581	617	540	41	36
9878	RV_pair4878	FakeDesc4878	FakeAnc4878	SIMULPF00001	80	81	90	71	10	9
9879	RV_pair4879	FakeDesc4879	FakeAnc4879	SIMULPF00001	440	458	501	397	61	43
9880	RV_pair4880	FakeDesc4880	FakeAnc4880	SIMULPF00001	80	77	84	73	4	7
9881	RV_pair4881	FakeDesc4881	FakeAnc4881	SIMULPF00001	76	78	86	68	10	8
9882	RV_pair4882	FakeDesc4882	FakeAnc4882	SIMULPF00001	592	598	655	535	63	57
9883	RV_pair4883	FakeDesc4883	FakeAnc4883	SIMULPF00001	434	437	472	399	38	35
9884	RV_pair4884	FakeDesc4884	FakeAnc4884	SIMULPF00001	278	274	294	258	16	20
9885	RV_pair4885	FakeDesc4885	FakeAnc4885	SIMULPF00001	157	162	182	137	25	20
9886	RV_pair4886	FakeDesc4886	FakeAnc4886	SIMULPF00001	498	488	532	454	34	44
9887	RV_pair4887	FakeDesc4887	FakeAnc4887	SIMULPF00001	32	31	32	31	0	1
9888	RV_pair4888	FakeDesc4888	FakeAnc4888	SIMULPF00001	258	249	283	224	25	34
9889	RV_pair4889	FakeDesc4889	FakeAnc4889	SIMULPF00001	15	19	20	14	5	1
9890	RV_pair4890	FakeDesc4890	FakeAnc4890	SIMULPF00001	349	362	386	325	37	24
9891	RV_pair4891	FakeDesc4891	FakeAnc4891	SIMULPF00001	50	51	58	43	8	7
9892	RV_pair4892	FakeDesc4892	FakeAnc4892	SIMULPF00001	82	80	91	71	9	11
9893	RV_pair4893	FakeDesc4893	FakeAnc4893	SIMULPF00001	579	577	642	514	63	65
9894	RV_pair4894	FakeDesc4894	FakeAnc4894	SIMULPF00001	124	124	133	115	9	9
9895	RV_pair4895	FakeDesc4895	FakeAnc4895	SIMULPF00001	15	14	15	14	0	1
9896	RV_pair4896	FakeDesc4896	FakeAnc4896	SIMULPF00001	382	393	422	353	40	29
9897	RV_pair4897	FakeDesc4897	FakeAnc4897	SIMULPF00001	14	15	15	14	1	0
9898	RV_pair4898	FakeDesc4898	FakeAnc4898	SIMULPF00001	151	149	164	136	13	15
9899	RV_pair4899	FakeDesc4899	FakeAnc4899	SIMULPF00001	382	377	418	341	36	41
9900	RV_pair4900	FakeDesc4900	FakeAnc4900	SIMULPF00001	259	255	279	235	20	24
9901	RV_pair4901	FakeDesc4901	FakeAnc4901	SIMULPF00001	182	174	201	155	19	27
9902	RV_pair4902	FakeDesc4902	FakeAnc4902	SIMULPF00001	253	256	278	231	25	22
9903	RV_pair4903	FakeDesc4903	FakeAnc4903	SIMULPF00001	432	431	469	394	37	38
9904	RV_pair4904	FakeDesc4904	FakeAnc4904	SIMULPF00001	1	3	3	1	2	0
9905	RV_pair4905	FakeDesc4905	FakeAnc4905	SIMULPF00001	7	8	8	7	1	0
9906	RV_pair4906	FakeDesc4906	FakeAnc4906	SIMULPF00001	535	534	593	476	58	59
9907	RV_pair4907	FakeDesc4907	FakeAnc4907	SIMULPF00001	197	200	222	175	25	22
9908	RV_pair4908	FakeDesc4908	FakeAnc4908	SIMULPF00001	71	66	74	63	3	8
9909	RV_pair4909	FakeDesc4909	FakeAnc4909	SIMULPF00001	171	178	192	157	21	14
9910	RV_pair4910	FakeDesc4910	FakeAnc4910	SIMULPF00001	403	409	452	360	49	43
9911	RV_pair4911	FakeDesc4911	FakeAnc4911	SIMULPF00001	402	399	437	364	35	38
9912	RV_pair4912	FakeDesc4912	FakeAnc4912	SIMULPF00001	117	119	125	111	8	6
9913	RV_pair4913	FakeDesc4913	FakeAnc4913	SIMULPF00001	238	228	255	211	17	27
9914	RV_pair4914	FakeDesc4914	FakeAnc4914	SIMULPF00001	630	621	694	557	64	73
9915	RV_pair4915	FakeDesc4915	FakeAnc4915	SIMULPF00001	336	348	376	308	40	28
9916	RV_pair4916	FakeDesc4916	FakeAnc4916	SIMULPF00001	87	91	94	84	7	3
9917	RV_pair4917	FakeDesc4917	FakeAnc4917	SIMULPF00001	72	72	78	66	6	6
9918	RV_pair4918	FakeDesc4918	FakeAnc4918	SIMULPF00001	76	67	79	64	3	12
9919	RV_pair4919	FakeDesc4919	FakeAnc4919	SIMULPF00001	385	377	425	337	40	48
9920	RV_pair4920	FakeDesc4920	FakeAnc4920	SIMULPF00001	274	262	292	244	18	30
9921	RV_pair4921	FakeDesc4921	FakeAnc4921	SIMULPF00001	125	125	138	112	13	13
9922	RV_pair4922	FakeDesc4922	FakeAnc4922	SIMULPF00001	480	482	522	440	42	40
9923	RV_pair4923	FakeDesc4923	FakeAnc4923	SIMULPF00001	23	24	24	23	1	0
9924	RV_pair4924	FakeDesc4924	FakeAnc4924	SIMULPF00001	58	55	61	52	3	6
9925	RV_pair4925	FakeDesc4925	FakeAnc4925	SIMULPF00001	379	397	432	344	53	35
9926	RV_pair4926	FakeDesc4926	FakeAnc4926	SIMULPF00001	16	16	19	13	3	3
9927	RV_pair4927	FakeDesc4927	FakeAnc4927	SIMULPF00001	577	575	632	520	55	57
9928	RV_pair4928	FakeDesc4928	FakeAnc4928	SIMULPF00001	162	168	179	151	17	11
9929	RV_pair4929	FakeDesc4929	FakeAnc4929	SIMULPF00001	187	196	211	172	24	15
9930	RV_pair4930	FakeDesc4930	FakeAnc4930	SIMULPF00001	277	281	308	250	31	27
9931	RV_pair4931	FakeDesc4931	FakeAnc4931	SIMULPF00001	487	492	533	446	46	41
9932	RV_pair4932	FakeDesc4932	FakeAnc4932	SIMULPF00001	54	50	58	46	4	8
9933	RV_pair4933	FakeDesc4933	FakeAnc4933	SIMULPF00001	758	771	835	694	77	64
9934	RV_pair4934	FakeDesc4934	FakeAnc4934	SIMULPF00001	82	90	93	79	11	3
9935	RV_pair4935	FakeDesc4935	FakeAnc4935	SIMULPF00001	11	8	11	8	0	3
9936	RV_pair4936	FakeDesc4936	FakeAnc4936	SIMULPF00001	783	774	848	709	65	74
9937	RV_pair4937	FakeDesc4937	FakeAnc4937	SIMULPF00001	168	165	185	148	17	20
9938	RV_pair4938	FakeDesc4938	FakeAnc4938	SIMULPF00001	232	229	255	206	23	26
9939	RV_pair4939	FakeDesc4939	FakeAnc4939	SIMULPF00001	61	63	69	55	8	6
9940	RV_pair4940	FakeDesc4940	FakeAnc4940	SIMULPF00001	270	260	287	243	17	27
9941	RV_pair4941	FakeDesc4941	FakeAnc4941	SIMULPF00001	135	135	148	122	13	13
9942	RV_pair4942	FakeDesc4942	FakeAnc4942	SIMULPF00001	266	290	301	255	35	11
9943	RV_pair4943	FakeDesc4943	FakeAnc4943	SIMULPF00001	66	65	70	61	4	5
9944	RV_pair4944	FakeDesc4944	FakeAnc4944	SIMULPF00001	608	610	666	552	58	56
9945	RV_pair4945	FakeDesc4945	FakeAnc4945	SIMULPF00001	263	263	292	234	29	29
9946	RV_pair4946	FakeDesc4946	FakeAnc4946	SIMULPF00001	191	193	212	172	21	19
9947	RV_pair4947	FakeDesc4947	FakeAnc4947	SIMULPF00001	74	71	75	70	1	4
9948	RV_pair4948	FakeDesc4948	FakeAnc4948	SIMULPF00001	409	416	451	374	42	35
9949	RV_pair4949	FakeDesc4949	FakeAnc4949	SIMULPF00001	167	166	175	158	8	9
9950	RV_pair4950	FakeDesc4950	FakeAnc4950	SIMULPF00001	217	219	232	204	15	13
9951	RV_pair4951	FakeDesc4951	FakeAnc4951	SIMULPF00001	682	698	759	621	77	61
9952	RV_pair4952	FakeDesc4952	FakeAnc4952	SIMULPF00001	99	95	105	89	6	10
9953	RV_pair4953	FakeDesc4953	FakeAnc4953	SIMULPF00001	61	62	66	57	5	4
9954	RV_pair4954	FakeDesc4954	FakeAnc4954	SIMULPF00001	26	24	27	23	1	3
9955	RV_pair4955	FakeDesc4955	FakeAnc4955	SIMULPF00001	113	109	126	96	13	17
9956	RV_pair4956	FakeDesc4956	FakeAnc4956	SIMULPF00001	164	164	177	151	13	13
9957	RV_pair4957	FakeDesc4957	FakeAnc4957	SIMULPF00001	47	47	52	42	5	5
9958	RV_pair4958	FakeDesc4958	FakeAnc4958	SIMULPF00001	205	211	220	196	15	9
9959	RV_pair4959	FakeDesc4959	FakeAnc4959	SIMULPF00001	132	162	166	128	34	4
9960	RV_pair4960	FakeDesc4960	FakeAnc4960	SIMULPF00001	308	309	350	267	42	41
9961	RV_pair4961	FakeDesc4961	FakeAnc4961	SIMULPF00001	269	263	288	244	19	25
9962	RV_pair4962	FakeDesc4962	FakeAnc4962	SIMULPF00001	210	211	232	189	22	21
9963	RV_pair4963	FakeDesc4963	FakeAnc4963	SIMULPF00001	38	34	39	33	1	5
9964	RV_pair4964	FakeDesc4964	FakeAnc4964	SIMULPF00001	166	164	181	149	15	17
9965	RV_pair4965	FakeDesc4965	FakeAnc4965	SIMULPF00001	13	17	17	13	4	0
9966	RV_pair4966	FakeDesc4966	FakeAnc4966	SIMULPF00001	585	583	640	528	55	57
9967	RV_pair4967	FakeDesc4967	FakeAnc4967	SIMULPF00001	96	94	108	82	12	14
9968	RV_pair4968	FakeDesc4968	FakeAnc4968	SIMULPF00001	204	206	224	186	20	18
9969	RV_pair4969	FakeDesc4969	FakeAnc4969	SIMULPF00001	6	4	6	4	0	2
9970	RV_pair4970	FakeDesc4970	FakeAnc4970	SIMULPF00001	198	188	213	173	15	25
9971	RV_pair4971	FakeDesc4971	FakeAnc4971	SIMULPF00001	616	596	662	550	46	66
9972	RV_pair4972	FakeDesc4972	FakeAnc4972	SIMULPF00001	703	707	769	641	66	62
9973	RV_pair4973	FakeDesc4973	FakeAnc4973	SIMULPF00001	49	55	61	43	12	6
9974	RV_pair4974	FakeDesc4974	FakeAnc4974	SIMULPF00001	89	90	96	83	7	6
9975	RV_pair4975	FakeDesc4975	FakeAnc4975	SIMULPF00001	6	7	7	6	1	0
9976	RV_pair4976	FakeDesc4976	FakeAnc4976	SIMULPF00001	45	44	46	43	1	2
9977	RV_pair4977	FakeDesc4977	FakeAnc4977	SIMULPF00001	146	148	162	132	16	14
9978	RV_pair4978	FakeDesc4978	FakeAnc4978	SIMULPF00001	839	806	906	739	67	100
9979	RV_pair4979	FakeDesc4979	FakeAnc4979	SIMULPF00001	295	285	316	264	21	31
9980	RV_pair4980	FakeDesc4980	FakeAnc4980	SIMULPF00001	7	7	7	7	0	0
9981	RV_pair4981	FakeDesc4981	FakeAnc4981	SIMULPF00001	703	739	793	649	90	54
9982	RV_pair4982	FakeDesc4982	FakeAnc4982	SIMULPF00001	147	136	147	136	0	11
9983	RV_pair4983	FakeDesc4983	FakeAnc4983	SIMULPF00001	152	164	170	146	18	6
9984	RV_pair4984	FakeDesc4984	FakeAnc4984	SIMULPF00001	257	251	274	234	17	23
9985	RV_pair4985	FakeDesc4985	FakeAnc4985	SIMULPF00001	368	364	393	339	25	29
9986	RV_pair4986	FakeDesc4986	FakeAnc4986	SIMULPF00001	52	57	60	49	8	3
9987	RV_pair4987	FakeDesc4987	FakeAnc4987	SIMULPF00001	55	50	56	49	1	6
9988	RV_pair4988	FakeDesc4988	FakeAnc4988	SIMULPF00001	250	234	265	219	15	31
9989	RV_pair4989	FakeDesc4989	FakeAnc4989	SIMULPF00001	152	153	165	140	13	12
9990	RV_pair4990	FakeDesc4990	FakeAnc4990	SIMULPF00001	83	80	90	73	7	10
9991	RV_pair4991	FakeDesc4991	FakeAnc4991	SIMULPF00001	340	320	366	294	26	46
9992	RV_pair4992	FakeDesc4992	FakeAnc4992	SIMULPF00001	172	161	185	148	13	24
9993	RV_pair4993	FakeDesc4993	FakeAnc4993	SIMULPF00001	167	165	191	141	24	26
9994	RV_pair4994	FakeDesc4994	FakeAnc4994	SIMULPF00001	397	403	438	362	41	35
9995	RV_pair4995	FakeDesc4995	FakeAnc4995	SIMULPF00001	375	391	420	346	45	29
9996	RV_pair4996	FakeDesc4996	FakeAnc4996	SIMULPF00001	57	55	60	52	3	5
9997	RV_pair4997	FakeDesc4997	FakeAnc4997	SIMULPF00001	794	787	859	722	65	72
9998	RV_pair4998	FakeDesc4998	FakeAnc4998	SIMULPF00001	72	75	80	67	8	5
9999	RV_pair4999	FakeDesc4999	FakeAnc4999	SIMULPF00001	254	246	268	232	14	22
